a	ɛ
a	ʌ
a	ɛ ɪ
abbeville	æ b ɪ v ɪ l
abbey	æ b ɪ
aberdeenshire	æ b ɝ d ɪ n ʃ ɝ
aberration	ɛ b ɝ eɪ ʃ ə n
aboard	ə b ɔ t
abs	æ b s
absence	æ p s ə n s
absorption	ə b s ɔ ɹ p ʃ ə n
abstained	ə p s t eɪ n d
abstract	æ p s t ɹ æ k t
acclaim	ə k l eɪ n
accompanied	ə k ʌ m b ə n i d
accompanies	ə k ʌ m p ə n i ʃ
according	ə ɡ ɔ d ɪ ŋ
accountant	ə ɡ aʊ n d ə n t
accra	æ k ɝ ə
accuracy	ɛ k j ɝ ə s i
ace	eɪ z
aces	eɪ s ɪ s
acidic	ə s ɪ t ɪ k
acids	æ s ɪ t s
acknowledge	ɛ k n ɑ l ɪ dʒ
acolytes	ɛ k ə l aɪ t s
acquaintances	ə k w eɪ n t ə n s ɪ s
acquire	ə k w aɪ ɹ
acquisition	æ k w ə ʃ ɪ ʃ ə n
act	ɛ k t
action	æ k s ə n
action	ɛ k ʃ ə n
action	ɛ k s ə n
actions	æ k ʃ ə n s
actions	æ k s ə n z
activism	æ k t ɪ v ɪ z ə n
activities	æ k t ɪ v ɪ t ɪ z
activities	æ k t ɪ v ɪ t i s
activities	æ k t ɪ v ə t i s
actor	æ k d ɝ
actor	ɛ k t ɝ
actors	æ k d ɝ z
add	æ t
adding	æ d ɪ n
addison	ɛ d ɪ s ə n
addition	ə d ɪ s ə n
addresses	ə d ɹ ɛ s ɪ s
addressing	æ d ɹ ɛ s ɪ n
addressing	æ d ɹ ɛ s ɪ ŋ
adds	æ d s
adenine	æ d ə n ɪ ŋ
admired	æ d m aɪ ɝ d
advisory	æ d v aɪ s ɝ i
advocate	æ d v ə ɡ ə t
aesthetic	ɪ s θ ɛ t ɪ k
affairs	ə f ɛ ɹ s
afghan	æ f k ə n
afghanistan	æ v ɡ æ n ɪ s t æ n
africa	ɛ f ɹ ɪ k ə
africa's	æ f ɹ ɪ k ə s
african	ɛ f ɹ ɪ k ə n
after	æ f d ɝ
against	ə ɡ æ n s t
agencies	eɪ dʒ ə n s i s
agency's	eɪ dʒ ə n s ɪ z
agenda	ə dʒ ɛ n t ə
ages	eɪ dʒ ɪ s
agrees	ə ɡ ɹ i s
agrees	ə k ɹ ɪ s
agricole	æ k ɹ ɪ k oʊ l
agriculture	æ ɡ ɹ i k ʌ l tʃ ɝ
ailerons	eɪ l ɹ ɑ n z
air	æ
air	æ ɹ
airconditioning	æ ɹ k ə n d ɪ ʃ ə n ɪ ŋ
aircraft	æ ɹ k ɹ æ f t
airfield	æ ɹ f i l d
airfields	ɛ ɹ f i l d z
airplane	æ ɹ p l eɪ n
airport	æ ɹ p ɔ ɹ t
alba	æ l p ə
alberta	æ l b ɝ d ə
album	æ l b ə n
album	æ l p ə m
album's	æ l b ə n z
albums	æ l p ə m z
alchemy	æ l ɡ ə m i
alchemy	ɛ l k ə m i
aleksander	æ l ə ɡ z æ n d ɝ
alex	ɛ l ɪ k s
alexander	æ l ə ɡ z æ n d ɹ
alexander	æ l ə ɡ s æ n d ɝ
algebra	æ l dʒ i b ɹ ə
alice	æ l i s
alison	ɛ l ɪ s ə n
alistair	æ l ɪ s t ɝ
alive	ə l aɪ f
alkenes	æ l k ɪ n z
allegations	ɛ l ə ɡ eɪ ʃ ə n z
allele	ə l ɪ l
allen	ɛ l ə n
alley	æ l ɪ
alley	ɛ l i
alliance	ə l aɪ ə n z
allocation	æ l ə ɡ eɪ ʃ ə n
alma	ɛ l m ə
along	ə l ɑ n
also	ɔ l z oʊ
although	ɔ l θ oʊ
always	ɔ l w eɪ s
alyssa	ə l i ʃ ə
am	æ n
ambassador	æ m b æ s ə t ɝ
amberjacks	æ m b ɝ dʒ æ k s
ambitions	æ m b ɪ ʃ ə n s
ambrose	æ m b ɹ oʊ s
america's	ə m ɛ ɹ ɪ k ə s
american	ə m ɛ ɹ ɪ k ə n
american	ə m ɛ ɹ ɪ ɡ ə n
amityville	ɛ m ɪ t i v ɪ l
ammi	ɛ m i
amnesty	æ n n ɪ s t ɪ
among	ə m ʌ n
ampex	æ m p æ k s
amphibious	æ m f ɪ b i ə z
amusements	ə m j u s m ə n t s
amusing	ə m j u s ɪ ŋ
an	æ m
an	ə m
an	ɛ n
analyses	ə n æ l ɪ s ɪ s
analyses	æ n æ l ɪ s ɪ s
analyzes	æ n ə l aɪ z ɪ s
anchor	æ n k ə
anchor	æ n k ɝ
and	ə n t
and	ɛ n t
and	ɛ n d
and	æ n t
andes	æ n d ɪ s
andreotti	æ n d ɹ i ɑ t i
andretti	æ n d ɹ ɛ t i
andrews	æ n d ɹ u s
andria	æ n d ɹ i ə
anesthesia	æ n ə s θ ɪ ʃ ə
angeles	æ n dʒ ə l i s
angeles	æ n dʒ ə l i z
angels	æ n dʒ ə l s
angie	ɛ n dʒ i
anglican	æ n ɡ l ɪ k ə n
angola	æ n ɡ oʊ l ə
angus	æ n ɡ ə z
animal	æ n i m ə l
animals	æ n i m ə l z
animals	æ n ə m ə l s
animism	æ n ə n ɪ z ə m
ankers	æ ŋ ɡ ɝ z
ann	ɛ n
annie	æ m i
annoyance	ə n ɔɪ ə n z
another	æ n ʌ ð ɝ
answer	æ n s ə
ant	æ n d
antal	æ n d ə l
anthem	æ n θ ə n
anthologies	æ n θ ɑ l ə dʒ i s
antipas	æ n d ɪ p ə s
antique	æ n t ɪ k
anything	æ n i θ ɪ ŋ
anywhere	ɛ n i w ɛ ɹ
apartment	ə b ɑ ɹ t m ə n t
apes	eɪ b z
apostles	ə b ɑ s ə l z
appeal	ə p ɪ l
appearance	ə p ɪ ɹ ə n z
appearances	ə p ɪ ɹ ə n s ɪ s
appears	ə b ɪ ɹ z
appended	ə b ɛ n d ɪ d
applause	ə p l ɔ s
apple	æ b ə l
apple's	æ p ə l s
application	æ p l ə ɡ eɪ ʃ ə n
applications	æ p l ə k eɪ ʃ ə n s
appreciation	ə p ɹ i s i eɪ ʃ ə n
approaches	ə p ɹ oʊ tʃ ɪ s
aquatic	ə k w ɛ t ɪ k
aqueduct	ɛ k w i d ʌ k t
aquitania	ɛ k w ə t eɪ n i ə
arbitrary	ɑ ɹ b ɪ t ɹ ɛ ɹ i
architect	ɑ ɹ k ə d ɛ k t
architectures	ɑ ɹ k ə t ɛ k tʃ ɝ s
arctic	ɑ ɹ t ɪ k
are	ɹ
are	æ ɹ
are	ɑ ɝ
are	ɛ ɝ
are	ʌ ɹ
area's	ɛ ɹ i ə z
areas	ɛ ɹ i ə s
argentina	ɑ ɹ dʒ ə n d i n ə
argentine	ɑ ɹ dʒ ə n d i n
aristocratic	ɹ ɪ s t ə k ɹ æ t ɪ k
arizona	æ ɹ ɪ z oʊ n ə
armed	ɑ n t
arms	ɑ n z
army	ʌ m i
arno's	ɑ ɹ n oʊ s
arose	ɝ oʊ s
arras	ɛ ɹ ə s
arriving	ɹ aɪ v ɪ ŋ
arrows	ɛ ɹ oʊ z
art	ɑ d
art	ɑ ɹ d
arteries	ɑ ɹ t ɹ i z
artifacts	ɑ ɹ t ə f ɛ k t s
artist's	ɑ ɹ t ə s t s
aryan	æ ɹ i ə n
as	ə z
as	ɛ s
as	ə ʃ
as	æ ʃ
ascend	ə s ɛ n t
ashes	æ ʃ ɪ s
ashes	æ s ə s
asia	eɪ ʃ ə
asian	eɪ ʃ ə n
asian	eɪ z ə n
asians	eɪ ʃ ə n z
asides	ə s aɪ t s
asner	ɛ s n ɝ
asper	æ s b ɝ
aspiring	ə s p aɪ ɝ ɪ ŋ
assam	æ s æ n
assigned	ə z aɪ n d
associate	ə s oʊ s i ə t
associated	ə s oʊ ʃ i eɪ t ə d
association	ə s oʊ s i eɪ ʃ ə n
association	ə ʃ oʊ ʃ i eɪ ʃ ə n
association	ə s oʊ ʃ i eɪ s ə n
assumed	ə z u m d
assuming	ə z u m ɪ ŋ
asteroid	æ s t ɹ ɔɪ d
asteroid	æ s t ɹ ɔɪ t
asteroids	æ s t ɹ ɔɪ d z
aston	æ ʃ t ə n
astrophysics	æ s t ɹ oʊ f ɪ z ɪ k s
at	æ d
at	ɛ t
athens	ɛ θ ə n s
atlanta	æ t l æ n d ə
atlantic	æ d l æ n t ɪ k
atonement	ə d oʊ n m ə n t
attack	ə d æ k
attacked	ə d æ k d
attacks	ə d æ k s
attained	ə d eɪ n d
attend	ə d ɛ n d
attendance	ə d ɛ n d ə n s
attended	ə d ɛ n d ɪ d
attention	ə d ɛ n ʃ ə n
attested	ə d ɛ s t ɪ d
attests	ə d ɛ s
attica	ɛ t ɪ k ə
attorney	ə d ɝ n i
auburn	ɔ b ɝ n
audience	ɔ d i ə n z
auger	ɔ k ɝ
augsburg	ɔ ɡ s b ɝ ɡ
austin	ɔ ʃ t ə n
australia's	ɔ s t ɹ eɪ l j ə s
authors	ɔ ð ə z
auto	ɔ d oʊ
avenues	æ v ə n u s
average	ɛ v ɹ ɪ dʒ
average	æ v ɹ i dʒ
averaged	æ v ɝ ɪ dʒ d
averages	æ v ɹ ɪ dʒ ɪ s
avis	eɪ v i s
award	ə w ɔ t
award	ə w ɔ ɹ t
awards	ə w ɔ ɹ d s
awful	ɔ f u l
axe	ɛ k s
axel	ɛ ɡ z ə l
axes	æ k s ɪ s
axes	æ k s ə s
ayr	æ
bach	b ɛ tʃ
bachelor	b æ tʃ ə l ɝ
back	b ɛ k
back	b ɛ ɡ
backed	b ɛ k t
backed	b æ k d
backing	b æ k ɪ n
bad	b æ t
badminton	b æ d m ɪ n d ə n
bagpipes	b æ k p aɪ p s
bags	b æ ɡ s
baked	b eɪ ɡ d
baked	b eɪ k d
baker's	b eɪ k ɝ s
bakeries	b eɪ k ɹ i z
bakken	b ɛ k ə n
balinese	b ɛ l ɪ n i z
balinese	b æ l ɪ m i z
ballet	b æ l i
balustrades	b ɛ l ə s t ɹ eɪ d z
ban	b ɛ n
bananas	b ə n ɑ n ə s
bananas	b ə n æ n ə s
bands	b æ n t s
bang	b æ n
bank	b æ n k
bank's	b æ ŋ k z
banker	b æ n k ɝ
banking	b æ ŋ k ɪ n
bankrupt	b æ ŋ ɡ ɹ ə p t
bankrupt	b æ n k ɹ ə p t
bantam	b æ n d ə m
baptist	b æ p t ə s
baptist	b æ p t ɪ ʃ t
baptized	b æ p t aɪ s t
bar	b ʌ
barbecues	b ɑ ɹ b ɪ k j u s
bare	b æ ɹ
barksian	b ɑ k s i ə n
baron's	b æ ɹ ə n z
barren	b ɛ ɹ ə n
barrett	b ɛ ɹ ɪ t
barrier	b æ ɹ i ɝ
barron	b æ ɹ ə n
barry	b ɛ ɹ i
barrys	b ɛ ɹ i z
bars	b ɑ ɹ s
bart	b ɑ d
base	b eɪ z
based	b eɪ z d
based	b eɪ s d
based	p eɪ s t
bases	b eɪ s ə s
bash	b æ s
basil	b æ s ə l
basin	b eɪ z ə n
basing	b eɪ z ɪ ŋ
basingstoke	b eɪ s ɪ n s t oʊ k
basis	b eɪ s ə z
basque	b ɛ s k
bassett	b ɛ z ɪ t
bat	b æ d
bat's	b æ d z
bates	b eɪ d z
batman	b ɛ t m ə n
batna	b ɛ t n ə
bats	b æ d z
batteries	b æ t ɹ i z
battery	b æ t ɹ ɪ
battery	b ɛ t ɹ i
battery	b æ t ɝ ɪ
battle	b æ d ə l
battle	b ɛ t ə l
battles	b ɛ t ə l z
baum	b aʊ n
bays	b eɪ s
bayside	b eɪ s aɪ t
be	p ɪ
beach	b ɪ tʃ
beaches	b i tʃ ɪ s
beacon	b ɪ k ə n
beale	b ɪ l
beam	b i n
beams	b i n z
bean	b i ŋ
beans	b ɪ n z
bear	b ɛ
bear	b æ
beasley	b i s l i
beast	b ɪ s t
beat	b ɪ t
beat	b i d
beatles	b i d ə l z
beatrice	b ɪ t ɹ ɪ s
beatty	b i d i
became	b i k eɪ m
became	b ɪ k eɪ n
became	b ɪ ɡ eɪ m
because	b ɪ k ɔ s
becca	b æ k ə
become	b i k ʌ m
become	b ɪ k ʌ n
become	b ɪ ɡ ʌ m
bedminster	b ɛ t m ɪ n s t ɝ
beds	b ɛ d s
beds	b ɛ t s
beer	b i
beer	b i ɹ
bees	b i s
beetles	b ɪ t ə l z
beetles	b i t ə l s
before	b i f ɔ
beg's	b ɛ ɡ s
began	b i ɡ æ n
beggs	b ɛ k s
begins	b i ɡ ɪ n s
beheaded	b ɪ h æ d ɪ d
being	b i n
being	b ɪ n
being	b ɪ ŋ
being	b i ɪ n
belafonte	b æ l ə f ɑ n t i
belay	b i l eɪ
belfort	b ɛ l f ɝ d
beliefs	b ɪ l i v z
beliefs	b ɪ l ɪ f s
beliefs	b ɪ l i v s
believers	b ɪ l i v ɝ s
bells	b ɛ l s
beloit	b ɛ l ɔɪ d
bendigo	b ɛ n d i ɡ oʊ
bends	b ɛ n t s
bene	b ɪ n
benefited	b ɛ n ə f ɪ t ɪ t
benetton	b æ n ə d ə n
bengal	b ɛ n ɡ ə l
bengal	b æ n ɡ ə l
bengal	b æ ŋ ɡ ə l
benghazi	b æ ŋ ɡ ɑ z i
benson's	b æ n s ə n z
berate	b ɪ ɹ eɪ d
berk	b ɝ ɡ
berkeley	b ɝ k l ɪ
berlin	b ɝ l ɪ ŋ
bernd	b ɝ n d
bernini	b ɝ n ɪ n i
berryman	b ɛ ɹ i m ə n
bessie	b ɛ z i
bethea	b ɛ θ i ə
bethlehem	b ɛ θ l ə h æ m
bettini	b ɛ t i m i
betty	b ɛ d i
between	b i t w ɪ n
beveridge	b ɛ v ɹ ɪ dʒ
beware	b i w ɛ ɹ
bhutanese	b u d ə n i s
biblical	b ɪ p l i k ə l
bid	b i t
bids	b ɪ d s
big	b ɪ k
bike	b aɪ ɡ
billed	b ɪ l t
billing	b ɪ l ɪ n
bills	b ɪ l s
binnie	b i n i
bird	b ɝ t
birds	b ɝ d s
biz	b ɪ s
black	b l æ ɡ
blackburn	p l æ k b ɝ n
bladder	b l ɛ d ɝ
blade	p l eɪ d
blast	b l æ ʃ t
blazer	b l eɪ s ɝ
bless	b l æ s
blessed	b l ɛ s d
bloc	p l ʌ k
blockbuster	b l ɑ k b ʌ s t ɝ
blog	b l ɑ k
blood	b l ʌ t
blossom	b l ɑ s ə n
blows	b l oʊ s
blues	b l u s
blunts	b l ɑ n d z
boat	b oʊ d
boating	b oʊ d ɪ ŋ
boats	b oʊ d z
boats	b oʊ d s
bobbing	b ɑ b ɪ n
bobcats	b ɑ b k æ t s
bodybuilder	b ɑ d i b ɪ l d ɝ
boleyn	b oʊ l i n
bones	b oʊ n s
booger	b u ɡ ɝ
book	b u k
booker's	b u k ɝ s
booklet	b u k l ɪ t
boot	b ʊ d
boots	b u d s
booty	b u d i
borders	b ɔ d ə s
boschert	b ɔ s ɝ d
bosnian	b ɔ s n i ə n
bottom	b ɑ d ə n
boulevard	b ʊ l ə v ɑ d
boundaries	b aʊ n d ɝ i z
boxes	b ɑ k s ɪ s
boxes	b ɑ k s ə s
boxing	b ɑ k s ɪ n
boys	b ɔɪ s
bozeman	b oʊ s m ə n
bracken's	b ɹ ɛ k ə n z
brackets	b ɹ æ k ə t s
brad	b ɹ ɛ d
brader	b ɹ æ d ɝ
bradley	b ɹ ɛ d l i
braidwood	p ɹ eɪ d w ʊ d
brammer	b ɹ æ n ɝ
branched	b ɹ æ n tʃ d
brandes	b ɹ æ n d ɪ s
brantley	b ɹ æ n d l i
brazilian	b ɹ ə s ɪ l i ə n
bread	b ɹ ɛ t
break	p ɹ eɪ k
breast	b ɹ ɛ ʃ t
breathing	b ɹ i θ ɪ ŋ
breathing	b ɹ ɪ ð ɪ ŋ
breathing	b ɹ ɪ θ ɪ ŋ
breeding	b ɹ ɪ d ɪ ŋ
breeds	b ɹ ɪ d z
breeds	b ɹ i d s
brent	b ɹ ɛ n d
brethren	b ɹ ɛ θ ɹ ə n
bride's	b ɹ aɪ d s
bridges	b ɹ ɪ dʒ ɪ s
brief	p ɹ i f
briefly	b ɹ ɪ f l i
brigadier	p ɹ ɪ ɡ ə d ɪ ɹ
briggs	b ɹ ɪ ɡ s
brigham	b ɹ i ɡ ə m
brisbane	b ɹ ɪ s b eɪ n
brisbane	b ɹ ɪ s p ə n
brisbane	b ɹ ɪ s p eɪ n
brisbane	b ɹ ɪ s b ə n
brisbane's	b ɹ ɪ s b eɪ n z
britain	p ɹ ɪ t ə n
british	b ɹ ɪ t ɪ s
british	b ɹ ɪ d i ʃ
britney	b ɹ ɪ t n ɪ
broadcasters	b ɹ ɔ d k æ s t ɝ z
broderick	b ɹ ɑ d ɝ ɪ k
brodsky	b ɹ ɑ d s k i
broncos	b ɹ ɑ ŋ k oʊ s
bronze	b ɹ ɑ n s
brook	b ɹ u k
brooke	b ɹ u k
brooklyn	b ɹ u k l ɪ n
brooks	b ɹ u k s
brooks's	b ɹ u k s
brooksville	b ɹ ʊ k s v ɪ l
broth	p ɹ ɔ θ
brothers	b ɹ ʌ ð ɝ s
brownlee	b ɹ aʊ n l ɪ
bruce	p ɹ u z
bruemmer	b ɹ u m ɝ
brunswick	b ɹ ʌ n s w ɪ k
brush	b ɹ ʌ s
bucknell	b ɑ k n ə l
bud	b ʌ t
buddha's	b u d ə s
buddhism	b u d ɪ z ə n
buddhism	b u d ɪ s ə m
buddhist	b ʊ d ə s t
buddies	b ɑ d i z
buddy	b ɑ d i
budget	b ɑ dʒ ɪ t
buds	b ʌ t s
buffy	b ɑ f i
bugs	b ɑ k s
build	b ɪ l t
building	b ɪ l d ɪ n
building	b ɪ l d i ŋ
buildings	b ɪ l d ɪ ŋ s
built	b ɪ l d
builtin	b ɪ l d ɪ ŋ
builtin	b ɪ l d ɪ n
bulldogs	b ʊ l d ɔ ɡ s
bullen	b u l ə n
bulls	b ʊ l s
bung	b ɑ n
bunker	b ɑ ŋ k ɝ
bunkered	b ʌ ŋ ɡ ɝ d
burgos	b ɝ ɡ oʊ s
buried	b æ ɹ i d
burma's	b ɝ m ə s
burmese	b ɝ n i z
burnt	b ɝ n d
burroughs	b ɝ oʊ s
burrows	b ɝ oʊ s
burt	b ɝ d
burton	b ɝ d ə n
bus	b ɔ z
busch	b u ʃ
buses	b ʌ s ɪ s
buses	b ɑ s ɪ s
bushings	p ʊ ʃ ɪ n z
business	b ɪ s n ɪ s
business	b ɪ s n ə s
business	b ɪ s m ə s
businesses	b ɪ s n ɪ s ɪ z
businesses	b ɪ z n ɪ s ɪ s
businesses	b ɪ s n ɪ s ɪ s
bussing	b ʌ z ɪ ŋ
but	b ɑ t
butcher	b u tʃ ɝ
butler	b ɑ t l ɝ
butt	b ɑ t
buttery	b ʌ t ɹ i
button	b ɑ t ə n
bux	b ɑ k s
buzz	b ʌ s
buzzed	b ʌ s t
byes	b aɪ s
bylsma	b ɪ l z m ə
caan	ɡ ɑ n
cabbage	ɡ æ b ɪ dʒ
cabin	ɡ æ b ə n
cabooses	k ə b u z ɪ z
cackling	ɡ æ k l ɪ ŋ
cadillac	ɡ æ d ɪ l æ k
cadillacs	k æ d ə l æ ɡ z
cadmium	ɡ æ d m i ə m
caesar	s i s ɝ
caffeine	k æ f ɪ n
cage	ɡ eɪ dʒ
cain	ɡ eɪ n
calcium	ɡ æ l s i ə m
calendar	ɡ æ l ə n d ɝ
calgary	ɡ æ l ɡ ɝ i
california	k æ l ɪ f ɔ ɹ n i ə
california	k æ l ə f ɔ ɹ n j ə
caliper	ɡ æ l ɪ b ɝ
call	ɡ ɔ l
calling	ɡ ɔ l ɪ ŋ
calls	k ɔ l s
calm	k ɑ n
calm	k ʌ m
calorie	ɡ æ l ɝ i
calvary	ɡ æ l v ɝ i
calvert	ɡ æ l v ɝ d
cam	k æ n
camden	k æ m t ə n
came	ɡ eɪ m
camera's	k æ m ɝ ə s
cameras	k æ m ɝ ə s
cameras	k æ m ɹ ə s
cameras	ɡ æ m ɝ ə z
cameron	k æ m ɹ ə n
cameron	ɡ æ m ɝ ə n
cameroon	ɡ æ m ɝ u n
camonica	k ɑ m oʊ n ɪ k ə
camp	ɡ æ m p
campaign	ɡ æ m p eɪ n
campbell	ɡ æ m b ə l
campbell	k æ m p ə l
campbell	ɡ æ m p ə l
campers	ɡ æ m p ɝ s
campi	ɡ æ m p i
camping	k æ m b ɪ ŋ
camping	k æ m p ɪ n
camping	ɡ æ m p ɪ ŋ
campo	ɡ æ m p oʊ
camps	ɡ æ m p s
campus	ɡ æ m p ə s
campuses	k æ m p ə s ɪ s
campuses	ɡ æ m p ə s ɪ s
cams	ɡ æ m s
can	ɡ æ n
can	ɡ ə n
canada's	ɡ æ n ə d ə z
canals	k ə n ɛ l z
cancer	ɡ æ n s ɝ
candidate	ɡ æ n i d ɪ d
candido	k æ n d ɪ d oʊ
candy	ɡ æ n t i
candy	k ɛ n d i
candy	ɡ æ n d i
cannabis	ɡ æ n ə p ə s
canned	ɡ æ n d
cannes	ɡ æ n
cannes	ɡ æ n z
canning	k æ n ɪ n
canning	ɡ æ n ɪ ŋ
cannon	ɡ æ n ə n
canon	ɡ æ n ə n
canopy	ɡ æ n ə b i
cant	k æ m t
canterbury	ɡ æ n d ə b ɝ i
canterbury	k æ n t ə b ɝ i
canton	ɡ æ n t ə n
canton	ɡ æ n d ə n
cantonese	ɡ æ n t ə n i z
cantons	k æ n t ə n s
cantoris	ɡ æ n t ɔ ɹ i s
canvas	ɡ æ n v ə s
canyon	ɡ æ n j ə n
cap	ɡ æ p
cap	ɡ æ b
cape	ɡ eɪ p
capital	ɡ æ p ɪ t ə l
capitals	k æ p ə t ə l s
capitals	k æ b ə t ə l z
capitol	k æ p i t ə l
capra	ɡ æ p ɹ ə
caps	ɡ æ p s
capstone	ɡ æ p s t oʊ n
capsule	ɡ æ b s ə l
capt	ɡ æ p t
captain	ɡ æ p t ə n
captains	k æ p t ə n s
captains	ɡ æ p t ə n z
caption	ɡ æ p ʃ ə n
capture	ɡ æ p tʃ ɝ
car	ɡ ɑ
car	ɡ ɑ ɹ
car	k ʌ
carbon	k ɑ p ə n
card	ɡ ɑ ɹ d
card	ɡ ɑ d
cardinal	ɡ ɑ ɹ d ə n ə l
cardinals	ɡ ɑ ɹ d ə n ə l z
cards	ɡ ɑ ɹ d z
cards	k ɑ ɹ d s
care	k ɛ
care	k æ ɹ
care	k æ
care	ɡ ɛ
career	k ɝ i ɹ
career	k ɝ i ɝ
careers	k ɝ i ɹ z
careful	k æ f ə l
careful	k æ ɹ f ə l
carefully	ɡ æ f ə l i
carey's	ɡ æ ɹ i z
cargo	ɡ ɑ ɹ ɡ oʊ
caring	ɡ æ ɹ ɪ ŋ
caring	k æ ɹ ɪ ŋ
carlos	k ɑ ɹ l oʊ z
carmel	k ɑ ɹ m ə l
carnage	k ɑ ɹ m ɪ dʒ
carol	ɡ ɛ ɹ ə l
caroline	k ɛ ɹ ə l i n
caroline	k ɛ ɹ ə l ɪ n
caroline	ɡ ɛ ɹ ə l i n
carre	k ɑ ɹ
carrey	k ɛ ɹ i
carrey	ɡ æ ɹ i
carrie	k æ ɹ i
carried	k æ ɹ i d
carried	k ɛ ɹ ɪ d
carried	ɡ æ ɹ i d
carried	k æ ɹ ɪ d
carries	k æ ɹ i z
carroll's	k ɛ ɹ ə l z
carry	k ɛ ɹ i
carry	ɡ æ ɹ i
carry	k ɛ ɹ ɪ
carrying	ɡ ɛ ɹ i ɪ ŋ
cars	k ɑ s
cars	ɡ ɑ z
cars	ɡ ɑ ɹ z
cars	k ʌ s
cars	k ɑ ɹ s
cars	ɡ ɑ s
cartesian	k ɑ ɹ d ɪ ʃ ə n
carts	k ɑ d z
cary	k æ ɹ i
casco	ɡ æ s k oʊ
case	ɡ eɪ s
case	k eɪ z
case	ɡ eɪ z
cases	k eɪ s ɪ s
cases	ɡ eɪ s ɪ s
casey	ɡ eɪ s i
cash	ɡ æ s
cash	ɡ æ ʃ
caspar	ɡ æ s b ɝ
casper	ɡ æ s b ɝ
caspian	ɡ æ s p i ə n
casque	ɡ æ s k
cassel	ɡ æ s ə l
cassidy	ɡ æ s ə t i
cast	k æ ʃ t
cast	ɡ æ s t
cast	ɡ ɑ s t
cast	ɡ ɛ s t
cast	ɡ æ ʃ t
caste	ɡ æ s t
castle	ɡ æ s ə l
castle	ɡ ɛ s ə l
castle's	ɡ æ s ə l z
castles	ɡ æ s ə l z
castor	ɡ æ s t ɝ
castro	ɡ æ s t ɹ oʊ
caswell	ɡ æ s w ɛ l
cat	ɡ æ t
cat	k æ d
cat	ɡ æ d
catalan	ɡ æ t ə l ə n
catalysis	k æ t ə l ɪ z ɪ z
catch	ɡ æ t s
catch	ɡ æ tʃ
catchment	ɡ æ tʃ m ə n t
catering	ɡ eɪ d ɝ ɪ ŋ
catherine	k æ θ ɹ i n
catherine	k æ θ ɝ i n
catkins	ɡ æ t k ɪ n z
cats	ɡ æ t s
cats	k æ d z
catskill	ɡ æ t s k ɪ l
cattle	ɡ æ t ə l
caught	ɡ ɔ d
caught	k ɔ d
cause	k ɔ s
cause	k ɑ s
cause	ɡ ɔ z
caused	k ɔ s t
caused	k ɔ z t
caused	k ɑ s t
causes	k ɔ s ɪ z
causes	k ɔ s ɪ s
causes	k ɔ z ɪ s
causeways	k ɔ s w eɪ z
causing	k ɔ s ɪ n
caustics	ɡ ɑ s t ɪ k s
cave	ɡ eɪ v
cease	s i z
ceased	s i z t
ceased	s i z d
cedar	s ɪ d ɝ
cells	s ɛ l s
censors	s æ n s ɝ s
census	s ɛ n ʃ ə s
census	s ɛ n s ə z
center	s æ n t ɝ
center	s ɛ n d ɝ
center	s ɛ n t ɹ
centre	s ɛ n t ɹ
centre	s ɛ n d ɝ
certain	s ɝ d ə n
certainly	s ɝ d ə n l i
chains	tʃ eɪ n s
chairman	tʃ æ ɹ m ə n
chairmanship	tʃ æ ɹ m ə n ʃ ɪ p
chalet	ʃ ɛ l eɪ
cham	ɡ æ m
championship	tʃ æ m p i ə n ʃ i p
championships	tʃ æ n p i ə n ʃ ɪ p s
chancellor	tʃ æ n s l ɝ
chances	tʃ æ n s ɪ s
changes	tʃ eɪ n dʒ ɪ s
chapels	tʃ æ p ə l s
chapters	tʃ æ p t ɝ s
character	k æ ɹ ə k t ɝ
character's	k æ ɹ ə k t ɝ z
characteristic	k ɛ ɹ ə k t ɹ ɪ s t ɪ k
characteristics	k ɛ ɹ ə k t ɹ ɪ s t ɪ k s
characters	k æ ɹ ə k t ɝ z
characters	k ɛ ɹ ə k t ə s
charge	tʃ ʌ dʒ
charges	tʃ ɑ dʒ ɪ s
charges	tʃ ɑ ɹ dʒ ɪ s
charity	tʃ æ ɹ ɪ t i
charles	tʃ ɑ l s
chase	tʃ eɪ z
chassis	tʃ ɛ s ɪ s
chassis	tʃ ɛ s ɪ
cheam	tʃ ɪ m
cheers	tʃ i ɹ z
cheese	tʃ i s
chemical	k æ m ɪ k ə l
chic	tʃ i k
chiefs	tʃ i f z
chinese	tʃ aɪ n i s
chinook	tʃ ɪ n ʊ k
chinos	tʃ ɪ n oʊ s
chit	tʃ i t
choice	tʃ ɔɪ z
choir	k w aɪ ɹ
chose	tʃ oʊ s
chosen	tʃ oʊ s ə n
christa	k ɹ ɪ s t ə
churches	tʃ ɝ tʃ ɪ s
cigarettes	s ɪ ɡ ɹ ɛ t s
cigarettes	s ɪ k ɝ ɛ t s
cindy	s ɪ n d ɪ
cinema	s ɪ n i m ə
cinema's	s ɪ n ə m ə s
circles	s ɝ k ə l s
circuit	s ɝ k i t
cities	s ɪ t ɪ z
citizen	s ɪ t i z ə n
citizens	s ɪ t i z ə n z
citizens	s ɪ t ɪ s ə n s
citizenship	s ɪ t ɪ ʒ ə n ʃ ɪ p
city	s ɪ d i
city	s ɪ t ɪ
city	s i t i
city	s ɪ d ɪ
clan	ɡ l æ n
clandestine	k l æ n d ɛ s t i n
claps	k l æ b z
claremont	k l æ ɹ m ɑ n t
clarified	k l æ ɹ ə f aɪ d
clarity	k l ɛ ɹ ɪ t i
clarrie	k l ɛ ɹ i
clash	k l æ s
clashed	k l æ s t
class	k l ʌ s
class	ɡ l ɑ s
class	ɡ l æ s
classes	k l æ s ɪ s
classes	ɡ l æ s ɪ s
classes	k l æ s ə s
clause	k l ɔ s
clauses	k l ɔ s ɪ s
claw	ɡ l ɔ
claws	k l ɔ s
clay	ɡ l eɪ
clayton	ɡ l eɪ t ə n
clean	k l ɪ m
clearances	k l ɪ ɹ ə n s ɪ s
clematis	k l æ m ə t ɪ s
clerk	k l ʌ k
clerk	k l ʌ ɡ
cliff	ɡ l i f
clinics	k l i n ɪ k s
clinton	k l ɪ n d ə n
clinton	k l ɪ ŋ t ə n
close	k l oʊ s
closed	k l oʊ s t
closed	k l oʊ z t
closed	k l oʊ s d
closely	k l oʊ z l i
closest	k l oʊ z ə s t
closing	k l oʊ z ɪ n
closure	k l oʊ ʃ ɝ
closure	k l oʊ z ɝ
closure	ɡ l oʊ ʃ ɝ
clothes	k l oʊ s
clothing	k l oʊ θ ɪ ŋ
clown	ɡ l aʊ n
club	k l ʌ p
club's	k l ʌ b s
club's	ɡ l ʌ b z
clubs	k l ʌ b s
coaches	ɡ oʊ tʃ ɪ s
coal	ɡ oʊ l
coarse	k ɔ z
coast	k oʊ ʃ t
coat	k oʊ d
coat	ɡ oʊ d
cobb's	ɡ ɑ b z
code	k oʊ t
code	ɡ oʊ d
codes	k oʊ t s
coed	ɡ oʊ ɛ t
coffins	k ɔ f i n z
cogswell	k ɑ ɡ z w ɛ l
cohesion	k oʊ h i z ə n
cohesion	k oʊ h ɪ ʃ ə n
coin	ɡ ɔɪ n
coins	k ɔɪ n s
cold	k oʊ l t
cold	ɡ oʊ l d
colden	ɡ oʊ l d ə n
cole	ɡ oʊ l
coleman	ɡ oʊ l m ə n
collaboration	k ə l æ b ɹ eɪ ʃ ə n
collar	k ʌ l ɝ
college	ɡ ɑ l ɪ dʒ
collins	k ɑ l i n z
collision	k ə l ɪ ʃ ə n
collisions	k ə l ɪ ʃ ə n z
collusion	k ə l u ʃ ə n
colonies	k ɑ l ə n i s
colonized	k ɑ l ə m aɪ z d
color	k ɑ l ɝ
colorful	k ɑ l ɝ f ə l
colors	k ʌ l ə s
colour	k ɑ l ɝ
colours	k ʌ l ɝ s
colours	k ɑ l ɝ s
colours	ɡ ʌ l ɝ z
colt	k oʊ l d
columba's	k oʊ l ʌ m b ə s
columns	k ɑ l ə m s
columns	k ɑ l ə n z
columns	ɡ ɑ l ə n z
comas	k oʊ m ə s
combinations	k ɑ m b ə n eɪ ʃ ə n s
comcast	k ɑ n k æ s t
come	ɡ ʌ m
come	k ɑ m
comeback	k ɑ m b æ k
comedy	k ɑ n ə d i
comes	k ʌ m s
comes	ɡ ʌ n z
coming	k ɑ m ɪ ŋ
comma	ɡ ɑ m ə
commanding	k ə m æ n d ɪ n
commenced	k ə m æ n s t
commentators	k ɑ m ə n d eɪ t ɝ z
commentators	k ɑ m ə n t eɪ t ɝ s
commissioners	k ə m ɪ ʃ ə n ɝ s
committee	k ə m ɪ d i
committees	ɡ ə m ɪ t i z
common	ɡ ɑ m ə n
communities	k ə m j u n ə t ɪ s
companies	k ʌ m p ə n i s
companions	k ə m p æ n j ə n s
company	k ʌ m b ə n i
company	ɡ ʌ m b ə n i
company	k ɑ m b ə n i
company's	k ɑ m p ə n i z
compare	k ə m p æ ɹ
compare	k ə m p æ
compares	k ə m p ɛ ɹ s
comparison	k ə m p æ ɹ ə z ə n
comparisons	k ə m p ɛ ɹ ə z ə n z
comparisons	k ə m p ɛ ɹ ə ʃ ə n z
compartment	k ə m b ɑ ɹ d m ə n t
competed	k ə m p ɪ t ɪ d
competes	k ə m b i t s
competing	k ə m b i t ɪ ŋ
competitions	k ʌ m p ə t ɪ ʃ ə n z
compilation	k ɑ m b ə l eɪ ʃ ə n
compiles	k ə m b aɪ l z
complementary	k ɑ m p l ə m ɛ n t ɹ i
completing	k ə m p l ɪ t ɪ ŋ
complexes	k ɑ m p l ɛ k s ə s
complimentary	k ɑ m p l ə m ɛ n t ɹ i
compose	k ə m p oʊ s
composed	k ə m p oʊ z t
composer	k ə m p oʊ s ɝ
composers	k ə m p oʊ s ɝ z
composers	k ə m p oʊ s ɝ s
composes	k ə m p oʊ s ɪ s
compositions	k ɑ m p ə z ɪ ʃ ə n s
compositions	k ɑ m p ə ʒ ɪ ʃ ə n z
compound	k ə m b aʊ n d
comprehensive	k ɑ m p ɹ ɪ h ɛ n ʃ ɪ v
compulsion	k ə m b ʌ l ʃ ə n
computers	k ə m p j u t ə s
conclusions	k ə n k l u ʃ ə n z
concrete	k ɑ ŋ k ɹ i t
conditions	k ə n d ɪ ʃ ə n s
condon	k ʌ n d ə n
cone	k oʊ m
cones	ɡ oʊ n z
conference's	k ɑ n f ɹ ə n s ɪ z
conferences	k ɑ n f ɹ ə n s ɪ s
confines	k ə n f aɪ n s
confucian	k ə n f j u ʒ ə n
confused	k ə n f j u ʒ d
confused	k ə n f j u s t
confusion	k ə n f j u ʃ ə n
congratulate	k ə ŋ ɡ ɹ æ tʃ ə l eɪ t
congregation	k ɑ n ɡ ɹ ə ɡ eɪ ʃ ə n
congregational	k ɑ n ɡ ɹ ə ɡ eɪ ʃ ə n ə l
congress	k ɑ n ɡ ɹ ə s
congressional	k ə ŋ ɡ ɹ ɛ ʃ ə n ə l
congressman	k ɑ n ɡ ɹ ə s m ə n
connecticut	k ə n æ t ɪ ɡ ə t
connecting	k ə n ɛ k t ɪ n
connecting	ɡ ə n ɛ k t ɪ ŋ
connotation	k ɑ n ə d eɪ ʃ ə n
conquered	k ɑ n k ɝ d
conscientious	k ɑ n s i ɛ n ʃ ə s
consequences	k ɑ n s ə k w ə n s ɪ s
conservative	k ə n z ɝ v ə t ɪ v
conserve	k ə n z ɝ v
considered	k ə n s ɪ t ɝ d
considered	k ə n s i d ɝ d
conspiring	k ə n s p aɪ ɹ ɪ ŋ
constitution	k ɑ n s t ə d u ʃ ə n
construct	k ə n ʃ t ɹ ʌ k t
construction	k ə n s t ɹ ʌ k s ə n
consumed	k ə n z u m d
consumer	k ə n s u m ə
contact	k ɑ n d æ k t
contain	k ə n d eɪ n
contains	k ə n d eɪ n z
contains	k ə n d eɪ n s
context	k ɑ n d ɛ k s t
contingencies	k ə n t ɪ n dʒ ə n s ɪ z
continues	k ə n t ɪ n j u s
contrast	k ə n t ɹ æ s t
contrasting	k ə n t ɹ æ s t ɪ n
controversial	k ɑ n t ɹ ə v ɝ s ə l
controversies	k ɑ n t ɹ ə v ɝ s ɪ z
conventions	k ə n v ɛ n ʃ ə n s
conversation	k ɑ n v ɝ z eɪ ʃ ə n
conversions	k ə n v ɝ ʃ ə n z
cook	k u k
cooke	k u k
cooker	k u k ɝ
cooking	k u k ɪ ŋ
cooling	k u l ɪ n
cope's	k oʊ b s
copies	k ɑ p i s
copyrighted	k ɑ p ɪ ɹ aɪ t ɪ d
coral	ɡ ɔ ɹ ə l
cordless	k ɔ ɹ d l ə s
corporation	k ɔ ɹ p ɝ eɪ s ə n
corps	k ɔ ɹ s
corps	k ɔ s
corps	ɡ ɔ
corpse	k ɔ ɹ b s
corpses	k ɔ ɹ p s ɪ s
corr	k ɔ ɹ
corridor	k ɔ ɹ ɪ d ɝ
corroded	k ɹ oʊ d ɪ d
corrosion	k ɝ oʊ ʃ ə n
cosmetic	k ɑ s m ɛ t ɪ k
cosmetics	k ɑ s m æ t ɪ k s
cosmic	k ɑ s m ɪ k
cosmopolitan	k ɑ s m ə b ɑ l ə t ə n
cosmos	k ɑ s m oʊ s
cost	ɡ ɑ s t
costas	k ɔ ʃ t ə s
costs	ɡ ɔ s t s
cotton	k ɔ d ə n
could	ɡ ʊ d
count	k aʊ n d
counties	k aʊ n t i s
countries	k ʌ n t ɹ i s
countries	k ʌ n t ɹ ɪ z
countries	k ɑ n t ɹ i z
country	k ɑ n t ɹ i
country	k ɑ n t ɹ ɪ
country	k ʌ n d ɹ i
country's	k ɑ n t ɹ i z
country's	k ʌ n t ɹ i s
countryside	k ʌ n t ɹ i s aɪ t
county	ɡ aʊ n t i
county	k aʊ n d i
county	ɡ aʊ n d ɪ
coupling	k ɑ p l ɪ ŋ
course	k ɔ z
course	k ɔ ɹ z
courses	k ɔ z ɪ z
courses	k ɔ s ɪ s
courses	k ɔ ɹ s ə s
courses	k ɔ ɹ s ɪ s
court	k ɔ d
court	k ɔ ɹ d
court	ɡ ɔ t
courtiers	k ɔ t i ə z
courtland	k ɔ ɹ t l æ n d
cousin	k ʌ s ə n
cousin	k ɑ s ə n
cove	ɡ oʊ v
cove	k oʊ f
cover	k ɑ v ɝ
cover	ɡ ʌ v ɝ
coverage	k ʌ v ɝ ɪ dʒ
covered	ɡ ʌ v ɝ d
covers	ɡ ʌ v ɝ z
covers	k ʌ v ɝ s
crab	ɡ ɹ æ b
crabs	ɡ ɹ æ b z
cracked	k ɹ æ ɡ d
crafted	k ɹ æ f t ɪ d
crafts	k ɹ æ f s
crags	k ɹ æ k s
craig	k ɹ æ k
craig	k ɹ æ ɡ
cranium	ɡ ɹ eɪ n i ə m
crankshaft	k ɹ æ ŋ k ʃ æ f t
crater	ɡ ɹ eɪ t ɝ
crater	k ɹ eɪ d ɝ
crates	k ɹ eɪ d z
crazy	k ɹ eɪ s i
cream	ɡ ɹ i m
creamy	k ɹ i n i
created	ɡ ɹ i eɪ t ɪ d
created	k ɹ i eɪ d ɪ d
creators	k ɹ i eɪ t ɝ s
creatures	k ɹ i tʃ ɝ s
credibility	k ɹ ɛ d ə b ɪ l ɪ t i
creed	k ɹ ɪ d
creek	ɡ ɹ i k
creeps	k ɹ ɪ b z
creon's	k ɹ ɪ ə n z
crest	k ɝ ɛ s t
crewmember	k ɹ u m ɛ m b ɝ
cricketer	k ɹ ɪ k ɪ t ɝ
criterion	k ɹ aɪ t ɪ ɹ i ə m
critical	k ɹ ɪ d ɪ k ə l
criticism	k ɹ ɪ t ɪ s ɪ s ə m
criticisms	k ɹ ɪ t ɪ z ɪ z ə m z
critique	k ɹ ɪ t ɪ k
croker	ɡ ɹ oʊ ɡ ɝ
crook	k ɹ u k
crop	ɡ ɹ ɑ p
crop	ɡ ɹ ɑ b
cropped	k ɹ ɑ p d
crosby	k ɹ ɔ s b i
crosby	ɡ ɹ ɔ z b i
cross	ɡ ɹ ɔ s
crossbills	k ɹ ɔ s b i l z
crossed	ɡ ɹ ɔ s t
crosses	ɡ ɹ ʌ s ɪ z
crossings	k ɹ ɔ z ɪ ŋ z
crowley's	k ɹ aʊ l i s
cruces	k ɹ u s ɪ s
cruise	k ɹ u s
crumpler	ɡ ɹ ʌ m p l ɝ
crushed	k ɹ ʌ s t
crutches	k ɹ ʌ tʃ ɪ s
crux	ɡ ɹ ʌ k s
cruz	k ɹ u s
cry	ɡ ɹ aɪ
cryin	k ɹ aɪ ɪ ŋ
cub	k ʌ p
cubans	k j u b ə n s
cubs	k ʌ p z
cuisine	k w ɪ s ɪ n
cuisine	k w i z i n
culberson	k ɑ l b ɝ s ə n
cullen	k ɑ l ə m
cullen	k ɑ l ə n
cultivation	k ɑ l t ɪ v eɪ ʃ ə n
cultures	k ʌ l tʃ ɝ s
cummings	k ʌ m ɪ n z
cup	k ʌ b
cup	k ɑ p
cup	ɡ ʌ p
cups	k ʌ b z
cups	k ʌ p z
cups	k ɑ p s
cure	k j u ɹ
curly	ɡ ɝ l i
currencies	k ɝ ə n s ɪ z
current	ɡ ɝ ə n t
curtain	ɡ ɝ t ə n
curtis	k ɝ t i s
curtiss	ɡ ɝ t ɪ s
custom	k ɑ s t ə m
customers	k ʌ s t ə m ə s
cut	ɡ ɑ t
cut	k ɑ t
cut	ɡ ʌ t
cuthbert	k ɑ θ b ɝ t
cuts	k ʌ d z
cutter	k ɑ t ə
cutter's	k ɑ t ɝ z
cutting	k ɑ t ɪ ŋ
cyme	s aɪ n
czar	s ɑ ɹ
czars	s ɑ ɹ z
daglish	d æ ɡ l i ʃ
daisy	d eɪ s i
dakota	d ə k oʊ d ə
dam	d æ n
damaging	d æ m ɪ dʒ ɪ n
dampers	d æ m p ɝ s
dance	d æ n z
dances	d æ n s ɪ s
dangerous	d eɪ n dʒ ɝ ə z
danville	d ɛ n v ɪ l
daring	d æ ɹ ɪ ŋ
darius	d ɛ ɹ i ə s
darkness	d ɑ ɡ m ə s
darren	d ɛ ɹ ə n
darryl	d æ ɹ ə l
data	d eɪ d ə
data	d ɛ t ə
dates	d eɪ d s
daughters	d ɔ t ɝ s
daughters	d ɑ t ɝ z
david	d eɪ v ɪ t
davies	d eɪ v i s
davies	d eɪ v ɪ s
davis	d eɪ v i s
davis	d eɪ v ɪ z
davy	d eɪ v ɪ
daws	d ɔ s
day	t eɪ
days	d eɪ s
dead	d ɛ t
dead	d æ t
deadpan	d ɛ d b æ n
deal	t i l
dean	d ɪ n
debut	d ɛ p j u
decades	d ɛ k eɪ d s
deceased	d ɪ s i z t
decentralized	d i s ɛ n t ɹ ə l aɪ z d
decided	d ɪ z aɪ d ɪ d
decision	d ɪ s ɪ ʃ ə n
decision	d ɪ s ɪ s ə n
decision	d ɪ s i ʒ ə n
decision	d ɪ s ɪ z ə n
decision	d ɪ z ɪ ʒ ə n
decisions	d ɪ s ɪ ʃ ə n z
decrease	d ɪ k ɹ i s
decrease	d ɪ k ɹ i z
decreased	d ɪ k ɹ i s t
decreased	d ɪ k ɹ ɪ ʃ t
decreasing	d ɪ k ɹ i z ɪ ŋ
dedicated	d ɛ d ə ɡ eɪ t ɪ d
deep	t i p
deep	d ɪ p
deep	d i b
deeply	d ɪ p l i
deer	d i ə
defenses	d ɪ f ɛ n s ɪ s
definite	d ɛ f ə n i t
deformation	d i f ɔ ɹ m eɪ ʃ ə n
degenerate	d i dʒ ɛ n ɝ eɪ t
degrade	d i ɡ ɹ eɪ d
degraded	d ɪ ɡ ɹ eɪ t ɪ d
degrees	d ɪ ɡ ɹ i s
degrees	d ɪ k ɹ i z
degrees	d ɪ ɡ ɹ ɪ s
deity	d i ɪ d i
deletion	d ɪ l ɪ ʃ ə n
delmas	d ɛ l m ə s
delphine	d ɛ l f ɪ n
delta	d ɛ l d ə
demise	d ɪ m aɪ s
demiurge	d ɛ m i ɝ dʒ
dene's	d ɪ n z
denied	d ɪ n aɪ t
dennis	d ɛ n i s
dennis	d æ n i s
dennison	d ɛ n i s ə n
denny	d æ n i
dense	t æ n z
dental	d ɛ n d ə l
dented	d ɛ n d ɪ d
dentition	d ɛ n d ɪ ʃ ə n
department	d ɪ b ɑ t m ə n t
depend	d ɪ b ɛ n d
dependent	d ɪ p ɛ n d ə n d
depicts	t ɪ p ɪ k s
depletion	d ɪ p l ɪ ʃ ə n
depopulated	d i p ɑ p j ə l eɪ t ɪ d
deportation	d ɪ p ɔ ɹ t eɪ ʃ ə n
deposed	d ɪ p oʊ z t
deposed	d i p oʊ z d
deposits	d ɪ b ɑ s ɪ t s
depot	d ɪ p oʊ
derail	d i ɹ eɪ l
derby	d ʌ b i
descendant	d ɪ s ɛ n t ə n t
descended	d ɪ z ɛ n d ə d
desert	d ɪ s ɝ t
deserted	d ɪ s ɝ t ɪ d
design	d ɪ s aɪ n
designated	d ɛ s ɪ ɡ n eɪ t ɪ d
designed	d ɪ s aɪ n d
designer	d ɪ s aɪ n ɝ
designs	d ɪ s aɪ n z
designs	d ɪ z aɪ n s
desired	d ɪ s aɪ ɝ d
despite	d ɪ s p aɪ d
detached	d ɪ d æ tʃ t
detaches	d i t æ tʃ ɪ z
detail	d ɪ d eɪ l
detail	d ɪ t eɪ l
detailed	d i t eɪ l d
detailing	d i t eɪ l ɪ ŋ
details	d i t eɪ l s
details	d i d eɪ l z
detained	d i t eɪ n d
detected	d ɪ d ɛ k t ɪ d
detection	d ɪ d ɛ k ʃ ə n
detentions	d ɪ t ɛ n ʃ ə n s
deter	d i t ɝ
determines	d ɪ d ɝ m ə n z
detractors	d i d ɝ ɛ k t ɝ s
detroit	d ɪ t ɹ ɔɪ t
detroit	d ɪ t ɹ ɔɪ d
developed	d ɪ v ɛ l ə p d
devices	d i v aɪ s ɪ z
devices	d ɪ v aɪ z ɪ z
devlin	d æ v l ɪ n
devon	d ɪ v ə n
dewey's	d u i s
dhaka	t ɑ k ə
dhaka	t æ ɡ ə
diagnosed	d aɪ ə ɡ n oʊ z d
dick	d ɪ ɡ
dickens	d i k ə n z
did	d ɪ t
did	d i d
dies	d aɪ s
differences	d ɪ f ɹ ə n s ɪ s
differences	d ɪ f ɝ ə n s ɪ s
differentiated	d ɪ f ɹ ɛ n ʃ i eɪ t ɪ d
differentiation	d ɪ f ɝ ɛ n s i eɪ ʃ ə n
differently	d ɪ f ɝ ə n t l i
differing	d ɪ f ɝ ɪ n
difficulties	d ɪ f ə k ə l t i s
dig	t ɪ k
dip	d i p
directorial	d ɝ ɛ k t ɔ ɹ i ə l
dirt	d ɝ d
disa	d ɪ z ə
disaster	d ɪ s æ s t ɝ
disbanding	d ɪ s p æ n d ɪ ŋ
discarded	d ɪ s k ɑ ɹ t ɪ d
disciplines	d ɪ s ə p l ə n s
disclosure	d ɪ s k l oʊ ʃ ɝ
discoveries	d ɪ s k ʌ v ɹ i z
discusses	d ɪ s k ʌ s ɪ s
discussions	d ɪ s k ʌ ʃ ə n s
disease	d ɪ s i s
disease	d ɪ s i z
disease	d ɪ z i s
disease	d ɪ s ɪ s
disease	d i z ɪ z
diseases	d ɪ s ɪ s ə z
dishes	d ɪ ʃ ə s
dishes	d ɪ ʃ ɪ s
disillusioned	d ɪ s ɪ l u ʃ ə n d
dismal	t ɪ s m ə l
dismissed	d ɪ s m i s t
disney	d ɪ s n i
disney	d ɪ s n ɪ
disney's	d ɪ s n i z
disney's	d ɪ s n ɪ s
dispatches	d ɪ s p æ tʃ ɪ s
dispersion	d ɪ s p ɝ ʃ ə n
displays	d ɪ s p l eɪ s
displeased	d ɪ s p l i z t
disposed	d ɪ s p oʊ z t
dissenting	d ɪ s ɛ n d ɪ ŋ
dissenting	d ɪ z ɛ n t ɪ ŋ
dissociation	d ɪ s oʊ ʃ i eɪ ʃ ə n
distances	d ɪ s t ə n s ɪ s
disused	d ɪ s j u z t
diverse	d ɪ v ɝ z
diversion	d aɪ v ɝ ʃ ə n
diving	d aɪ v ɪ n
division	d ɪ v ɪ ʃ ə n
division's	d ɪ v ɪ ʃ ə n z
divisional	d ɪ v ɪ ʃ ə n ə l
divisions	d ɪ v ɪ ʃ ə n z
divisions	d ɪ v ɪ z ə n z
divisions	d ɪ v ɪ ʒ ə n s
dizziness	d ɪ s i n ə s
docking	d ʌ k ɪ ŋ
doctorate	d ɑ k t ɹ ə t
does	d ʌ s
does	d ɪ s
doesn't	d ʌ s ə n
doesn't	d ʌ s ə n t
dog	d ɔ k
dogs	d ɔ k s
dogs	d ɔ k z
dogs	d ɔ ɡ s
doing	t u ɪ ŋ
dollars	d ɔ l ɝ s
dominated	d ʌ m ə n eɪ t ɪ d
dominoes	d ɑ m ə n oʊ s
donate	t oʊ n eɪ d
donkey	d ɑ n k i
doomsday	d u m s t eɪ
door	t ɔ
door	t ɔ ɹ
doris	d ɔ ɹ ə z
dorsally	d ɔ ɹ s ə l i
dose	d oʊ z
doses	d oʊ s ə s
doty	d oʊ d i
doubles	d ʌ b ə l s
douglass	d ɑ ɡ l ə s
downtown	d aʊ n d aʊ n
dozen	d ʌ s ə n
dozens	d ʌ s ə n z
drag	d ɹ æ k
drainage	t ɹ eɪ n ɪ dʒ
drains	t ɹ eɪ n z
drake	d ɹ eɪ ɡ
drama	t ɹ ɑ m ə
dramatically	d ɹ ə m æ t ɪ k ə l i
drawn	t ɹ ɔ n
dream	d ɹ ɪ m
dreman	d ɹ ɪ m ə n
dresden	d ɹ ɛ s d ə n
dresser's	d ɹ ɛ s ɝ s
dressings	t ɹ ɛ s ɪ ŋ z
drexler	d ɹ æ k s l ɝ
dried	t ɹ aɪ d
drinkable	d ɹ ɪ ŋ k ə b ə l
drippings	d ɹ ɪ b ɪ n z
drive	t ɹ aɪ v
drop	d ɹ ɑ b
dropped	d ɹ ɑ b d
dropped	d ɹ ɑ p d
drought	t ɹ aʊ t
drug	d ɹ ʌ k
drugs	d ɹ ʌ k s
drummer	t ɹ ʌ m ɝ
drums	d ɹ ʌ m s
drunk	t ɹ ʌ ŋ k
dry	t ɹ aɪ
dubbing	d ʌ b ɪ n
dubs	d ɑ b s
dumas	d u m ə s
duncan	d ʌ n k ə n
dundas	d ʌ n d ə s
dundrum	d ʌ n t ɹ ə m
dunton	d ʌ n d ə n
during	d u ɹ ɪ ŋ
during	d ɝ ɪ n
during	d ʊ ɹ ɪ n
duties	d u d i z
dutifully	d u t ɪ f ə l i
duval	d u v ɛ l
dyck	d aɪ ɡ
dying	d aɪ ɪ n
e	ɪ
each	ɪ tʃ
each	ɪ t s
ealing	ɪ l ɪ ŋ
early	ɹ l i
earphones	ɪ ɹ f oʊ n z
earthenware	ɝ ð ə n w ɛ ɹ
ease	i s
eased	i s t
easier	i s i ɝ
easily	i z i l i
easily	i s ə l i
easily	ɪ s ɪ l i
east	i ʃ t
east	ɪ s t
eastern	ɪ s t ə n
eastern	ɪ s t ɝ n
easton	i ʃ t ə n
eastward	i s t w ɝ t
easy	i s i
eat	i d
eat	ɪ t
eaten	i d ə n
eaters	i d ɝ z
eating	ɪ d ɪ n
ebenezer	æ b ɪ n ɪ z ɝ
economic	ɪ k ə n ɑ m ɪ k
economics	ɪ k ə n ɑ m ɪ k s
ed	ɛ t
eddy	æ d i
edges	ɛ dʒ ɪ s
edict	ɪ d ɪ k t
edited	æ d ɪ t ɪ d
editor	æ d ɪ t ɝ
editor	ɛ d ɪ d ə
editor	ɛ d ɪ d ɝ
editors	ɛ d i t ɝ s
edo	ɪ d oʊ
edson	æ d s ə n
edward	æ d w ɝ d
eels	ɪ l z
eger	æ ɡ ɝ
egg	ɛ k
eggs	ɛ k s
ego	i k oʊ
egypt	ɪ dʒ ɪ p t
egyptian	i dʒ ɪ p ʃ ə n
egyptians	i dʒ ɪ p ʃ ə n z
eh	æ
eid	i t
eight	eɪ d
eisen	aɪ s ə n
eisner	aɪ z n ɝ
either	ɪ ð ɝ
elba	æ l b ə
elbrus	ɛ l b ɹ ə s
election	ɪ l ɛ k s ə n
elections	ɪ l ɛ k ʃ ə n s
elections	ɪ l ɛ k s ə n s
electorate	ɪ l ɛ k t ɹ ɪ d
electronically	ɪ l ɛ k t ɹ ɑ n ɪ k ə l i
electrons	ɪ l ɛ k t ɹ ɑ n z
elegance	ɛ l ɪ ɡ ə n z
elementary	ɛ l ə m ɛ n t ɹ i
elementary	ɛ l ə m ɛ n t ɝ i
elementary	æ l ə m ɛ n t ɹ i
elision	ɪ l i z ə n
elision	ɪ l ɪ ʃ ə n
elite	ɛ l ɪ t
eliza	ɪ l ɪ s ə
eliza	ɪ l i s ə
elizabeth	ɪ l ɪ s ə b ɛ θ
ellen	æ l ə n
ellice	ɛ l i z
ellipses	ɪ l ɪ p s ɪ s
ellsworth	ɛ l s w ɝ θ
elmslie	ɛ l m s l i
ely	ɪ l i
em	æ n
embarked	ɛ m b ɑ ɹ k d
embedding	æ m b ɛ d ɪ ŋ
embree	æ m b ɹ i
emerged	ɪ m ɝ dʒ t
emigrated	ɛ m ə ɡ ɹ eɪ t ɪ t
emil	ɛ m ɪ l
emissions	ɪ m ɪ ʃ ə n s
emits	ɪ m ɪ t z
empathy	æ m p ə θ i
emperor	ɛ m p ɝ ə
emphasised	ɛ m f ə s aɪ z t
empire	æ m b aɪ ɝ
emplaced	ɪ n p l eɪ s t
empty	ɛ n t i
encompasses	ɛ n k ɑ m p ə s ɪ z
encrypted	ɪ n k ɹ ɪ p t ɪ d
end	æ n d
end	ɛ n t
endangered	æ n d eɪ n dʒ ɝ d
ended	æ n d ɪ d
ended	æ n d ɪ t
endemic	æ n d ɛ m ɪ k
ending	æ n d ɪ ŋ
endorse	æ n d ɔ ɹ s
ends	æ n d z
enduring	ɪ n d ʊ ɹ ɪ ŋ
enemies	ɛ n ə m ɪ z
enemy	æ n ə m i
energy	æ n ə dʒ i
energy	æ n ɝ dʒ i
energy	ɛ n ɝ dʒ ɪ
enforcement	æ n f ɔ ɹ s m ə n t
engel	æ ŋ ɡ ə l
engelman	æ ŋ ɡ ə l m ə n
english	ɪ ŋ ɡ l ɪ s
enhanced	ɛ n h æ n s d
enhancement	æ n h æ n s m ə n t
enhances	æ n h æ n s ɪ z
enharmonic	æ n h ɑ ɹ m ɑ n ɪ k
enid	ɪ n ɪ d
enlisted	æ n l ɪ s t ɪ d
enniscorthy	æ n ɪ s k ɔ ɹ θ i
ensuing	æ n ʃ u ɪ ŋ
ensured	ɪ n ʃ ʊ ɹ d
enter	ɛ n d ɝ
entered	ɛ n d ɝ d
entering	ɛ n t ɹ ɪ ŋ
entering	ɛ n d ɝ ɪ ŋ
entering	æ n t ɹ ɪ ŋ
enters	ɛ n d ɝ z
entitled	æ n t aɪ t ə l d
entomology	æ n t ə m ɑ l ə dʒ i
entrance	æ n t ɹ ə n s
entries	æ n t ɹ i z
entry	ɛ n d ɹ i
entry	æ n t ɹ i
enzyme	ɛ n s aɪ m
epic	æ p ɪ k
episode	ɛ p ə z oʊ d
epoxy	ɪ b ɑ k s i
epsilon	æ p s ə l ɑ n
epsom	æ b s ə n
equations	ɪ k w eɪ ʃ ə n z
equator	i k w eɪ t ɝ
era	ɪ ɹ ə
erased	ɪ ɹ eɪ s t
erasmus	ɪ ɹ æ s m ə s
ere	ɛ ɝ
ericka	ɛ ɹ ɪ k ə
erosion	ɪ ɹ oʊ ʃ ə n
error	ɛ ɹ
error	ɛ ɝ
erupted	ɪ ɹ ʌ p t ɪ d
erupting	ɪ ɹ ʌ p t ɪ ŋ
eruptions	ɪ ɹ ʌ p ʃ ə n z
eschew	s
essays	ɛ s eɪ s
essential	ɪ s ɛ n tʃ ə l
essentially	ɛ s ɛ n s ə l i
established	ɪ s t æ p l ɪ ʃ t
esther	ɛ s θ ɝ
estrogen	ɪ s t ɹ ə dʒ ə n
etchings	ɛ tʃ ɪ ŋ s
ethiopia	ɪ θ i oʊ p i ə
ethiopian	ɪ θ i oʊ p i ə n
ethiopians	ɪ θ i oʊ p i ə n z
eugene	j u dʒ ɪ n
eureka	j u ɹ ɪ k ə
european	j u ɹ ə p i ə n
evaluation	i v æ l j u eɪ ʃ ə n
evangelized	ɪ v æ n dʒ ə l aɪ z d
even	ɪ v ə n
evenings	i v n ɪ ŋ s
eventually	i v ɛ n tʃ u l i
ever	æ v ɝ
everett	æ v ɝ ə t
every	æ v ɹ i
everywhere	ɛ v ɹ i w ɛ ɹ
evidence	ɛ v i d ə n s
example	ɪ ɡ z æ m b ə l
example	ɪ k s æ m p ə l
examples	ɪ ɡ z æ m b ə l s
exams	ɪ ɡ z æ m s
exceed	ɪ ɡ s i d
exceedingly	ɪ ɡ s ɪ d ɪ ŋ l i
except	æ k s ɛ p t
exceptions	ɪ k s ɛ p ʃ ə n s
excesses	ɛ k s ɛ s ɪ s
excise	ɛ ɡ z aɪ z
excite	ɪ k s aɪ d
excited	ɪ ɡ z aɪ t ɪ d
excitement	ɪ ɡ z aɪ t m ə n t
exclusion	ɪ k s k l u ʃ ə n
exclusively	ɪ k s k l u z ɪ v l i
excuses	ɪ k s k j u z ɪ s
executed	ɛ ɡ z ə k j u t ɪ d
executes	ɛ ɡ z ə k j u t s
executive	ɪ ɡ z ɛ k j u t ɪ v
executive	ɪ k z ɛ k j ə t ɪ v
exempt	ɪ ɡ s ɛ m p t
exempted	ɪ k z ɛ m p t ɪ d
exemptions	ɪ k s ɛ m p ʃ ə n z
exeter	ɛ ɡ z ɪ t ɝ
exhaustive	ɪ ɡ s ɔ s t ɪ v
exhibit	ɪ k z ɪ b ɪ t
exhibit	ɪ k s ɪ b ɪ t
exhibited	ɪ k s ɪ b ɪ t ɪ d
exhibition	ɛ k z ə b ɪ ʃ ə n
exhibitions	ɛ k z ə b ɪ ʃ ə n z
exhibitors	ɪ k s ɪ b ə t ɝ z
exile	ɛ k s aɪ l
exiles	ɛ k z aɪ l z
exist	ɪ ɡ s ɪ s t
exist	ɪ k s ɪ s t
existing	ɪ ɡ s ɪ s t ɪ ŋ
exit	ɛ ɡ s ɪ t
expand	ɪ k s p ɛ n d
expanded	ɪ k s p ɛ n d ɪ d
expansions	ɪ k s p æ n ʃ ə n s
expansive	ɪ k s p ɛ n s ɪ v
expenditure	ɪ k s p ɛ n d i tʃ ɝ
expenditures	ɪ k s p ɛ n d ɪ tʃ ɝ z
expensive	æ k s p ɛ n s ɪ v
expensive	ɪ k s p æ n s ɪ v
experience	ɪ k s p i ɹ i ə n s
experiences	ɪ k s p i ɹ i ə n s ɪ z
explodes	ɪ k s p l oʊ d s
explodes	ɪ k s p l oʊ t s
explosion	ɪ k s p l oʊ ʃ ə n
explosive	ɪ k s p l oʊ z ɪ v
exports	ɪ k s p ɔ ɹ t z
expose	ɪ k s p oʊ s
exposure	ɪ k s p oʊ ʃ ɝ
expresses	ɪ k s p ɹ ɛ s ɪ s
extensive	ɪ k s t ɛ n s ɪ f
eyes	aɪ s
ezekiel	ɪ z ɪ k ɪ l
face	f eɪ z
faced	f eɪ z d
faces	f eɪ s ɪ s
facial	f eɪ s ə l
facilities	f ə s ɪ l ə t ɪ z
facilities	f ə s ɪ l ə t i s
faction	f ɛ k ʃ ə n
faction	f æ k s ə n
factor	f ɛ k t ɝ
factories	f æ k t ɝ i s
fails	f eɪ l s
fair	f æ ɹ
fair	f æ
fair	v æ
fairfax	f æ ɹ f æ k s
fairly	f æ ɹ l i
fake	f eɪ ɡ
faked	f eɪ ɡ d
falls	f ɔ l s
false	f ɔ l z
families	f æ m l ɪ s
fang	f æ n
fans	f æ n s
fans	f ɛ n z
fantasies	f æ n t ə s ɪ z
fantastic	f æ n d æ s t ɪ k
fascia	f æ s i ə
fascicles	f æ s ɪ k ə l z
fashion	f ɛ ʃ ə n
fat	f æ d
fatality	f ə d æ l ə t i
fatality	f ə t æ l ə t i
fathers	f ɑ ð ə s
favorite	f eɪ v ɝ ə t
fax	f ɛ k s
fear	f i ɹ
fears	f ɪ ɹ s
feasible	f i s ə b ə l
feasible	f ɪ s ə b ə l
feat	f ɪ t
features	f i tʃ ɝ s
fed	f ɛ t
fed	f æ d
federal	f ɛ t ɹ ə l
federalists	f ɛ d ɹ ə l ɪ s
feeds	f ɪ d s
feel	f ɪ l
feeney	f i m i
feet	f i d
felix	f ɪ l ɪ k s
fell	f æ l
feminist	f ɛ m ə n ɪ ʃ t
fence	f æ n z
fencing	f æ n s ɪ ŋ
fens	f ɛ n s
fens	f æ n z
ferry	f æ ɹ i
fetish	f æ t ɪ ʃ
fetters	f ɛ t ɝ s
feuds	f j u d s
fibrous	f aɪ b ɝ ə s
fiedler's	f ɪ d l ɝ z
field	f i l t
field	f ɪ l d
fielding	f ɪ l d ɪ ŋ
fife	f aɪ v
fifties	f ɪ f t i s
fight	f aɪ d
fighter	f aɪ d ɝ
fighters	f aɪ t ɝ s
fighting	f aɪ d ɪ n
figure	f ɪ ɡ ɝ
figure	f ɪ k ɝ
figures	f ɪ ɡ ə s
figurines	f ɪ ɡ j ɝ ɪ n z
fiji	f ɪ dʒ ɪ
fill	f i l
film	f ɪ l n
filming	f ɪ l m ɪ n
finals	f aɪ n ə l s
fingerings	f ɪ ŋ ɡ ɹ ɪ ŋ z
finishing	f ɪ n ɪ ʃ ɪ n
finns	f ɪ n s
fireman	f aɪ ɝ m ə n
firemen	f aɪ ɝ m ə n
firewood	f aɪ ɝ w ʊ d
fireworks	f aɪ ɝ w ɝ k s
firing	f aɪ ɝ ɪ ŋ
firmans	f ɝ m ə n s
first	f ɝ ʃ t
fish	f ɪ s
fished	f ɪ s t
fishers	f ɪ ʃ ɝ s
fishes	f ɪ ʃ ɪ s
fishing	f ɪ ʃ ɪ n
fishing	f i s ɪ n
fiti	f i d i
fitness	f ɪ t m ə s
flag	f l æ k
flagg	f l æ k
flags	f l æ k s
flagstone	f l æ k s t oʊ n
flash	f l ɛ ʃ
flatbush	f l æ d b ʊ ʃ
fleas	f l i s
fleet	f l i d
flex	f l æ k s
flights	f l aɪ t z
flood	f l ʌ t
flores	f l ɔ ɹ s
florida	f l ɔ ɹ i d ə
flour	f l ɔ ɹ
flows	f l oʊ s
flute	f l u d
focused	f oʊ k ə s d
focuses	f oʊ k ə s ɪ s
food	f ʊ t
food	f ʊ d
foot	f u t
footage	f u t ɪ dʒ
football	f ʊ d b ɔ l
foote	f u d
foote	f u t
for	f ɹ
for	f ɹ ɝ
for	f ɝ ɹ
for	v ə
forage	f ɔ ɹ ɪ dʒ
forbidden	f ɔ ɹ b ɪ d ə n
force	f ɔ z
forces	f ɔ ɹ s ɪ s
forces	f ɔ s ɪ s
forces	f ɔ z ɪ z
ford	f ɔ ɹ t
foreign	f ɔ ɹ ɪ ŋ
foreign	f ɔ ɹ i n
foreigner	f ɔ ɹ ə n ɝ
foreigners	f ɔ ɹ ə n ɝ z
forensic	f ɝ æ n s ɪ k
form	f ɔ n
forms	f ɔ m s
forrest	f ɔ ɹ ə s t
fort	f ɔ ɹ d
fort	f ɔ d
forte	f ɔ ɹ t
fortes	f ɔ ɹ t eɪ s
forts	f ɔ ɹ d z
forty	f ɔ d i
foster	f ɔ s t ɝ
fought	f ɔ d
foundation	f aʊ n d eɪ s ə n
founders	f aʊ n d ɝ s
foxy	f ɑ k s ɪ
fragmentation	f ɹ ɛ k m ə n t eɪ ʃ ə n
france	f ɹ ɛ n s
france	f ɹ æ n z
france	f ɹ ɛ n z
frances	f ɹ æ n s ɪ s
francis	f ɹ æ n s ɪ z
frankel	f ɹ æ ŋ k ə l
franta	f ɹ æ n d ə
franz	f ɹ æ ŋ z
franz	f ɹ æ n s
fraternity	f ɹ ə t ɝ n ɪ t i
fred	f ɹ ɪ t
freda	f ɹ ɛ d
frederick	f ɹ ɛ d ɝ ɪ k
fredkin	f ɹ ɛ t k ɪ n
freelancing	f ɹ i l æ n s ɪ ŋ
freezes	f ɹ i z ɪ s
freight	f ɹ eɪ d
fremantle	f ɹ ɪ m ɛ n t ə l
french	f ɹ ɛ n z
french	f ɹ ɛ n s
frenkel	f ɹ æ ŋ k ə l
frescoes	f ɹ ɛ s k oʊ s
fresh	f ɹ ɛ s
fresnel	f ɹ ɛ ʃ n ə l
fresnel	f ɹ ɛ s n ə l
fresno	f ɹ ɛ s m oʊ
friday	f ɹ aɪ d ɪ
friendly	f ɹ ɛ n t l i
friends	f ɹ ɛ n d s
frisbee	f ɹ ɪ s p i
frits	f ɹ ɪ t s
frost	f ɹ ʌ s t
fruit	f ɹ u d
fruits	f ɹ u d s
fuel	f j ʊ l
full	f u l
fully	f u l i
fun	f ɑ n
fuse	f j u s
fused	f j u z t
fusing	f j u s ɪ ŋ
fussell	f ɑ z ə l
fuzzier	f ʌ s i ɝ
fuzzy	f ʌ s i
gadsden	ɡ ɛ d s t ə n
gags	ɡ æ ɡ s
galaxies	ɡ æ l ə k s i s
gallows	ɡ æ l oʊ s
game	ɡ eɪ n
game	k eɪ m
game's	ɡ eɪ n z
games	ɡ eɪ n z
gamete	ɡ æ m ɪ t
ganesh	ɡ ɛ n ɪ ʃ
gang	ɡ æ n
ganges	ɡ æ n dʒ ɪ s
gans	ɡ æ n s
gantry	ɡ æ n d ɹ i
ganz	ɡ æ n s
garden	ɡ ɑ ɹ t ə n
garis	ɡ ɛ ɹ ɪ z
garrison	ɡ æ ɹ ɪ z ə n
garrison	ɡ ɛ ɹ ɪ s ə n
garrisons	ɡ ɛ ɹ ɪ s ə n z
garry	ɡ æ ɹ i
gary	ɡ æ ɹ i
gaseous	ɡ æ s ə s
gases	ɡ æ s ɪ s
gases	ɡ ɛ s ɪ z
gash	ɡ æ s
gasses	ɡ æ s ɪ s
gaston	ɡ ɛ s t ə n
gates	ɡ eɪ d s
gatineau	ɡ æ t i n oʊ
gay	k eɪ
gaze	ɡ eɪ s
geatish	ɡ ɪ t ɪ ʃ
geese	ɡ i z
gene	dʒ ɪ n
gene	dʒ i m
gene	dʒ ɪ m
general	dʒ æ n ɹ ə l
general's	dʒ ɛ n ɝ ə l z
generally	dʒ ɛ n ɝ l i
generally	dʒ æ n ɝ ə l i
generators	dʒ ɛ n ɝ eɪ t ɝ s
genes	dʒ i m z
genie	dʒ ɪ n i
genius	dʒ ɪ n j ə z
geno's	dʒ i n oʊ s
gens	dʒ ɛ n s
gentile	dʒ ɛ n d aɪ l
georges	dʒ ɔ ɹ dʒ ɪ s
georgetown	dʒ ɔ ɹ dʒ d aʊ n
georgian	dʒ ɔ dʒ ə n
gert	ɡ ɝ d
gets	k ɪ t s
gettysburg	ɡ ɛ t ɪ s b ɝ ɡ
ghats	k ɑ d s
ghats	ɡ ɑ d z
ghent	ɡ æ n t
ghetto	ɡ æ t oʊ
ghost	k oʊ s t
ghost	ɡ oʊ z t
gig	k ɪ k
gigs	ɡ ɪ k s
gilda's	ɡ ɪ l d ə s
gilead	ɡ ɪ l ɪ t
gillmore's	ɡ ɪ l m ɔ ɹ s
gimmicks	ɡ ɪ m ɪ ɡ z
gisco	dʒ ɪ s k oʊ
giselle	dʒ ɪ z ɛ l
give	ɡ i v
given	ɡ i v ə n
glaciation	ɡ l eɪ s i eɪ ʃ ə n
glacier	ɡ l eɪ s ɝ
glamour	k l æ m ɝ
glasgow	ɡ l æ s ɡ oʊ
glasgow	ɡ l æ z k oʊ
glass	k l æ s
glasses	ɡ l æ s ɪ s
glastonbury	ɡ l æ s t ə n b ɝ i
gleason	k l ɪ s ə n
goal	k oʊ l
goalkeeper	k oʊ l k i p ɝ
god	k ɔ t
god's	ɡ ɑ t s
gods	ɡ ɑ d s
goes	ɡ oʊ s
good	k ʊ d
good	ɡ ʊ t
good's	ɡ u d s
goodies	ɡ u d i z
goodman	k ʊ d m ə n
goods	ɡ u d z
goods	k ʊ d z
goose	ɡ u z
gore	k ɔ
government	ɡ ʌ v ɝ n m ə n t
government	k ɑ v ɝ m ə n t
government	ɡ ʌ v ɝ m m ə n t
governments	ɡ ʌ v ɝ n m ə n t s
governor	ɡ ɑ v ɝ n ɝ
grab	ɡ ɹ æ p
grace	ɡ ɹ eɪ z
graces	ɡ ɹ eɪ z ɪ z
grade	ɡ ɹ eɪ t
grade	k ɹ eɪ d
grain	k ɹ eɪ n
grandes	ɡ ɹ æ n d ɪ s
grant	ɡ ɹ æ n d
granted	ɡ ɹ æ n d ɪ d
grapes	k ɹ eɪ p s
grass	k ɹ æ s
grasses	ɡ ɹ æ s ɪ s
gravelly	ɡ ɹ ɛ v ə l i
gravity	k ɹ æ v ə t i
gravity	ɡ ɹ æ v ə d i
greasewood	ɡ ɹ ɪ s w ʊ d
great	ɡ ɹ eɪ d
great	k ɹ eɪ t
greatest	ɡ ɹ eɪ d ə s t
greece	k ɹ i s
greek	ɡ ɹ ɪ k
greek	k ɹ i k
greeks	ɡ ɹ i ɡ z
greeks	ɡ ɹ ɪ ɡ z
green	ɡ ɹ ɪ n
greenfield	k ɹ ɪ n f i l d
greens	ɡ ɹ i n s
greeted	k ɹ i t ɪ d
gregory	ɡ ɹ ɛ ɡ ɹ i
gregson	ɡ ɹ ɛ k s ə n
grey	k ɹ eɪ
grid	ɡ ɹ i d
grid	ɡ ɹ ɪ t
grieg	ɡ ɹ ɪ ɡ
griggs	ɡ ɹ ɪ k s
grimani	ɡ ɹ ɪ m ɑ n i
grimsby	ɡ ɹ ɪ m s b i
grip	ɡ ɹ i p
groceries	ɡ ɹ oʊ s ɝ i z
group	k ɹ u p
groups	ɡ ɹ u p z
groups	ɡ ɹ u b z
groups	k ɹ u b z
grow	k ɹ oʊ
growers	k ɹ oʊ ɝ z
growing	ɡ ɹ oʊ ɪ n
grows	ɡ ɹ oʊ s
grub	ɡ ɹ ʌ p
guadeloupe	k w ɑ d ə l u p
guard	ɡ ɑ t
guatemala	k w ɑ t ə m ɑ l ə
guest	ɡ ɛ ʃ t
guilt's	ɡ ɪ l d s
guitar	k ɪ t ɑ ɹ
guitar	ɡ ɪ d ɑ ɹ
guitarist	k ɪ t ɑ ɹ ɪ s t
guitars	ɡ ɪ d ɑ ɹ z
gully	ɡ ɑ l i
gunpowder	k ʌ n p aʊ d ɝ
guns	ɡ ʌ n s
gus	ɡ ɑ s
gut	ɡ ɑ t
guy	k aɪ
gwynn	k w i n
gyms	dʒ ɪ m s
gypsy's	dʒ ɪ p s i s
gyre	dʒ aɪ ɝ
habit	h æ b ɪ d
habitats	h æ p ə t æ t s
hacked	h æ ɡ d
hacks	h æ ɡ s
had	h æ t
had	h ɛ d
haggart	h æ ɡ ɝ d
hair	h æ
hall's	h ɔ l s
haller	h ɛ l ɝ
halton	h æ l d ə n
ham	h ɛ m
hamlin	h æ m l ɪ ŋ
hammamat	h æ m ə m æ d
hammond	h æ m ə n t
hampden	h æ m p t ə n
hampered	h æ m b ɝ d
handicrafts	h æ n d ɪ k ɹ æ f t s
handkerchief	h æ ŋ k ɝ tʃ i f
hands	h æ n s
hanger	h æ ŋ ɡ ɝ
hankins	h æ ŋ k ɪ ŋ z
hankinson	h æ n k ɪ n s ə n
hanslick	h ɛ n s l ɪ k
hard	h ɑ t
hardly	h ɑ t l i
hare	h æ
harlem	h ɑ ɹ l ə n
harpy	h ɑ ɹ b i
harriet	h æ ɹ i ə t
harrington	h æ ɹ ɪ n t ə n
harriot	h ɛ ɹ i ə d
harris	h æ ɹ i z
harrisburg	h æ ɹ ɪ s b ɝ ɡ
hart	h ɑ ɹ d
hartt	h ɑ ɹ t
harvested	h ɑ ɹ v ə s t ɪ d
has	h æ s
has	h ɛ s
hasty	h eɪ s t ɪ
hat	h æ d
hate	h eɪ d
haute	h ɑ t
have	h ɛ v
having	h æ v ɪ n
hayes's	h eɪ s ɪ z
he	ɪ
he	h ɪ
he's	h ɪ z
he's	h ɪ s
head	h æ d
head	h æ t
head	h ɛ t
headed	h æ d ɪ d
headquartered	h ɛ d k w ɔ ɹ t ɝ d
headquarters	h æ d k w ɔ ɹ t ɝ z
headquarters	h ɛ d k w ɔ ɹ t ɝ s
headquarters	h ɛ d k ɔ ɹ t ɝ z
headquarters	h ɛ d k w ɔ t ə s
heads	h ɛ d s
heads	h æ d s
headsets	h ɛ d s ɛ d s
healey	h ɪ l i
hear	h ɪ ɹ
heard	h ɝ t
hearings	h ɪ ɹ ɪ ŋ z
heart	h ɑ ɹ d
heartland	h ɑ ɹ t l æ n d
heat	h ɪ t
heat	h i d
heathland	h ɪ θ l æ n d
heatley	h ɪ t l i
heats	h ɪ d s
heavens	h æ v ə n z
heavily	h æ v ɪ l i
heavy	h æ v ɪ
heavy	h æ v i
hedged	h ɛ dʒ t
height	h aɪ d
heights	h aɪ d z
heights	h aɪ d s
heights	h aɪ t z
helens	h ɛ l ə n s
helical	h æ l ɪ k ə l
hello	h æ l oʊ
hells	h ɛ l s
helmut	h æ l m ə t
helping	h ɛ l p ɪ n
helsinki	h ɛ l s ɪ n k i
hemisphere	h ɛ m ɪ s f ɪ ɹ
henchman	h æ n tʃ m ə n
hendrix	h æ n d ɹ ɪ k s
henri	h æ n ɹ i
henri	h ɛ n ɹ ɪ
henry	h æ n ɹ ɪ
henry's	h ɛ n ɹ i s
henshaw	h æ n ʃ ɔ
here	h i
here	h i ɹ
hero's	h i ɹ oʊ z
heroic	h i ɹ oʊ ɪ k
hers	ɝ s
hers	h ɝ s
herself	ɝ s ɛ l f
herzen	h ɝ s ə n
hess	h æ s
heterogeneous	h ɛ t ɹ ə dʒ i n i ə s
heterosexual	h ɛ t ɹ oʊ s ɛ k ʃ u ə l
hetman	h ɛ d m ə n
hetman's	h ɛ d m ə n z
hid	h ɪ t
hiding	h aɪ t ɪ ŋ
higgs	h ɪ k s
hiking	h aɪ k ɪ n
hilbert	h ɪ l b ɝ d
hills	h ɪ l s
him	ɪ n
him	h ɪ n
hincks	h ɪ n k s
hindus	h ɪ n d u s
hinterland	h ɪ n d ɝ l æ n d
hips	h ɪ b s
hire	h aɪ ɝ
hirsch	h ɝ s
his	h i z
his	h i s
historians	h ɪ s t ɔ ɹ i ə n s
historically	h ɪ s t ɔ ɹ ɪ k ə l i
hit	h ɪ d
hit	h i t
hits	h ɪ d z
hobbies	h ɑ b i s
holbrook	h oʊ l b ɹ u k
holding	h oʊ l d ɪ n
holes	h oʊ l s
holiness	h oʊ l ɪ n ə s
hollywood	h ɑ l ɪ w ʊ d
home	h oʊ n
honey	h ʌ m ɪ
honorable	ɑ n ɹ ə b ə l
hood	h u d
hook	h u k
hooked	h u k t
hooker	h u k ɝ
hopper	h ɑ b ɝ
horace	h ɔ ɹ ɪ s
horizontal	h ɔ ɹ ɪ z ɑ n d ə l
horns	h ɔ n s
horror	h ɔ ɹ
horror	h ɑ ɹ ɝ
horse	h ɔ z
horse	h ɔ ɹ z
horsemen	h ɔ ɹ s m ə n
hot	h ɑ d
hotel	h oʊ d ɛ l
hour	aʊ ɝ
hourly	aʊ ɝ l i
hours	aʊ ɝ z
hours	aʊ ɹ s
house	h aʊ z
housed	h aʊ z d
housed	h aʊ z t
houses	h aʊ z ɪ z
houses	h aʊ s ɪ s
houses	h aʊ z ɪ s
housing	h aʊ s ɪ ŋ
housing	h aʊ s ɪ n
hub	h ɑ b
hub	h ɑ p
hub	h ʌ p
hudson	h ɑ d s ə n
hughes	j u s
humanitarian	h j u m æ n ɪ t ɛ ɹ i ə n
humor	j u m ɝ
humour	j u m ɝ
hundreds	h ʌ n ɝ d s
hundreds	h ʌ n d ɝ d s
hungary	h ɑ ŋ ɡ ɝ i
hungary	h ʌ ŋ ɡ ɹ i
hunt	h ɑ n t
hunter	h ʌ n d ɝ
hunting	h ʌ n t ɪ n
hurt	h ɝ d
husband	h ʌ s b ə n d
husby	h ɑ s b i
huskies	h ʌ s k i s
hussars	h ɑ s ɝ z
hussein	h u z eɪ n
hut	h ɑ t
hutchings	h ʌ tʃ ɪ n z
hutton	h ɑ t ə n
hutu	h u d u
hyde	h aɪ t
i	i
ibsen	ɪ p s ə n
ice	aɪ z
icing	aɪ z ɪ ŋ
ideologies	aɪ d i ɑ l ə dʒ ɪ z
idols	aɪ d ə l s
iliad	ɪ l i ə t
illinois	ɪ l ə n ɔɪ s
imagery	ɪ m ɪ dʒ ɝ i
images	ɪ m ɪ dʒ ɪ s
imari	ɪ m ɑ ɹ i
immortality	ɪ m ɔ ɹ t æ l ɪ t i
impair	ɪ m p æ ɹ
implant	ɪ m p l æ n d
implementation	ɪ m b l ə m ɛ n t eɪ ʃ ə n
important	ɪ m b ɔ ɹ t ə n t
important	ɪ n p ɔ ɹ t ə n t
impose	ɪ m p oʊ s
impostor	ɪ m p ɑ s t ɝ
impressionism	ɪ m p ɹ ɛ ʃ ə n ɪ s ə m
imprint	ɪ m p ɹ ɪ n d
imprisonment	ɪ n p ɹ ɪ z ə n m ə n t
improved	ɪ m b ɹ u v d
in	ə m
in	ɪ ŋ
in	ɪ m
in	i n
inactive	ɪ n ɛ k t ɪ v
inaugural	ɪ n ɔ ɡ ɝ ə l
inca	ɪ n k ə
incentives	ɪ n s ɛ n t ɪ v s
incident	ɪ n s ə d ə n d
included	ɪ n ɡ l u d ɪ d
includes	ɪ n ɡ l u d z
inclusion	ɪ n k l u ʃ ə n
incongruous	ɪ n k ɑ ŋ ɡ ɹ u ə s
incorporated	ɪ n k ɔ ɹ b ɝ eɪ t ɪ d
increased	ɪ ŋ k ɹ i s d
increasing	ɪ n k ɹ i z ɪ ŋ
incremental	ɪ n k ɹ ə m ɛ n t ə l
indefatigable	ɪ n d ɪ f ɛ t ɪ ɡ ə b ə l
independent	ɪ n d ɪ b ɛ n d ə n t
indians	ɪ n d i ə n s
indicate	ɪ n d ə ɡ eɪ t
indignation	ɪ n d ɪ ɡ n eɪ s ə n
indispensable	ɪ n d ɪ s b ɛ n s ə b ə l
indonesia	ɪ n d oʊ n ɪ ʃ ə
indonesia	ɪ n d ə n ɪ ʃ ə
induces	ɪ n d u s ɪ s
influence	ɪ n f l u ə n z
influences	ɪ n f l u ə n s ɪ s
informatics	ɪ n f ɔ ɹ m ɛ t ɪ k s
infractions	ɪ m f ɹ æ k ʃ ə n s
ingredients	ɪ ŋ ɡ ɹ i d i ə n t s
initial	ɪ n i ʃ ə l
initialism	ɪ m ɪ ʃ ə l ɪ z ə m
initiated	ɪ n i ʃ i eɪ t ɪ d
initiation	ɪ n i s i eɪ ʃ ə n
inquiry	ɪ n k w aɪ ɝ i
inside	ɪ n s aɪ t
insight	ɪ n s aɪ d
inspired	ɪ n s b aɪ ɝ d
instances	ɪ n s t ə n s ɪ s
instrumentals	ɪ n s t ɹ ə m ɛ n t ə l z
instrumentation	ɪ n s t ɹ ə m ɛ n d eɪ ʃ ə n
intact	ɪ n d ɛ k t
intake	ɪ n d eɪ k
integral	ɪ n d ɛ ɡ ɹ ə l
intellectual	ɪ n t ə l æ k tʃ u ə l
intelligentsia	ɪ n t ɛ l ɪ dʒ ɛ n t s i ə
intended	ɪ n d ɛ n d ɪ d
intense	ɪ n d ɛ n s
intention	ɪ n d ɛ n ʃ ə n
intentional	ɪ n d ɛ n ʃ ə n ə l
intentionally	ɪ n d ɛ n ʃ ə n ə l i
interact	ɪ n t ɝ ɛ k t
interacting	ɪ n t ɹ æ k t ɪ ŋ
interaction	ɪ n t ɹ æ k ʃ ə n
interaction	ɪ n d ɝ ɛ k ʃ ə n
interaction	ɪ n d ɹ æ k ʃ ə n
interactions	ɪ n t ɹ æ k ʃ ə n z
interactive	ɪ n t ɹ ɛ k t ɪ v
intercept	ɪ n d ɝ s ɛ p t
intercity	ɪ n t ɝ s ɪ t ɪ
interest	ɪ n t ɹ ə ʃ t
interests	ɪ n t ɹ ə s t z
interfere	ɪ n t ɝ f ɪ ɹ
interference	ɪ n t ɝ f ɪ ɹ ə n s
interim	ɪ n t ɝ ə n
interim	ɪ n t ɹ ə n
interior	ɪ n d ɪ ɹ i ɝ
international	ɪ n t ɝ n æ ʃ ə n ə l
internships	ɪ n d ɝ n ʃ ɪ p s
inti	ɪ n d i
intimacy	ɪ n d ɪ m ə s i
into	ɪ n d u
introduced	ɪ n t ɹ ə d u s d
introduces	ɪ n t ɹ ə d u s ɪ s
introductions	ɪ n t ɹ ə d ʌ k ʃ ə n s
invasion	ɪ n v eɪ ʃ ə n
invented	ɪ n v ɛ n t ɪ t
inventions	ɪ n v ɛ n ʃ ə n s
inverse	ɪ n v ɝ z
inversion	ɪ n v ɝ ʃ ə n
investigation	ɪ n v ɛ ʃ t ə ɡ eɪ ʃ ə n
investors	ɪ n v ɛ s t ɝ s
invitation	ɪ n v ɪ d eɪ ʃ ə n
ions	aɪ ə n s
irrationally	ɪ ɹ æ ʃ ə n ə l i
is	ɪ s
is	i z
is	i s
is	ɪ ʃ
isaac	aɪ s ə k
isabel	ɪ s ə b ɛ l
isabella	ɪ s ə b ɛ l ə
isabelle	ɪ s ə b ɛ l
iskra	ɪ s k ɹ ə
islam	ɪ s l ə m
islamic	ɪ s l æ m ɪ k
islington	ɪ s l ɪ ŋ d ə n
israel	ɪ s ɹ i ə l
israeli	ɪ s ɹ eɪ l i
issuance	ɪ ʃ ʊ ə n s
issue	ɪ ʃ ʊ
issued	i ʃ u d
issues	ɪ ʃ u s
istanbul	ɪ s t æ n b u l
it	i t
it	ɪ d
it	i d
italian	ɪ d æ l j ə n
italy	ɪ d æ l i
item	aɪ d ə n
items	aɪ t ə n z
ivan	i v ə n
jack	dʒ ɛ k
jack's	dʒ ɛ k s
jackson	dʒ æ k ʃ ə n
jam	dʒ æ n
james	dʒ eɪ m s
jan	dʒ æ m
jane	dʒ eɪ m
jane's	dʒ eɪ m z
japanese	dʒ æ p ə n i s
japanese	dʒ æ p ə n ɪ z
jasper	dʒ æ s b ɝ
jaspers	dʒ æ s p ɝ s
jaws	dʒ ɑ s
jazz	dʒ æ s
jeffersons	dʒ ɛ f ɝ s ə n s
jeffery	dʒ ɛ f ɹ i
jenkins	dʒ ɛ n k ɪ n z
jennifer	dʒ ɛ n ɪ f ɝ
jensen	dʒ æ n s ə n
jersey	dʒ ɝ s i
jersey's	dʒ ɝ s i z
jesuits	dʒ ɛ z u ɪ t s
jesus	dʒ i s ə s
jet	dʒ ɛ d
jews	dʒ u s
jez	dʒ ɛ s
jezreel	dʒ ɛ z ɝ i l
jimmy's	dʒ ɪ m ɪ z
jin	dʒ i n
job	dʒ ɑ p
jobs	dʒ ɑ p s
johansen	dʒ oʊ h æ m s ə n
joined	dʒ ɔɪ n t
joint	dʒ ɔɪ n d
jolly	dʒ ʌ l i
jones	dʒ oʊ n s
jose	dʒ oʊ s
joseph	dʒ oʊ z ə f
joseph's	dʒ oʊ s ə f s
journals	dʒ ɝ n ə l s
judges	dʒ ʌ dʒ ɪ s
jung	dʒ ɑ ŋ
jute	dʒ u d
kalispell	ɡ æ l ɪ s p ɛ l
kane	ɡ eɪ n
kanji	ɡ ɑ n dʒ i
kansas	k æ n s ə s
kansas	ɡ æ n s ə s
kantner	ɡ æ n t n ɝ
kaplan	ɡ æ p l ə n
kappes	ɡ æ p s
kasten	ɡ æ s t ə n
katerina	k æ t ɹ i n ə
katherine	k æ θ ɹ i n
kathleen	k æ θ l ɪ n
katty	k ɛ t i
katty	ɡ ɛ t i
katz	ɡ æ d z
katz	k æ d s
kaye	ɡ eɪ
keaton	k ɪ t ə n
keats	k ɪ d s
keats	k ɪ d z
keeled	k ɪ l d
keen	k ɪ n
keep	k ɪ p
kel	k æ l
kelly	ɡ ɛ l i
kelly	k ɛ l ɪ
kelly	ɡ æ l i
kelly	k æ l i
kelsey	ɡ ɛ l s i
ken	ɡ ɛ n
ken	k æ n
kendrick	ɡ ɛ n d ɹ ɪ k
kennebec	k æ n ə b ɛ k
kennedy	k æ n ə d i
kennedy's	k æ n ə d i z
kennedys	k æ n ə d i z
kenney	k æ n i
kensington	k ɛ n s ɪ ŋ t ə n
kent	ɡ ɛ n t
kent	ɡ æ n t
kentish	k ɛ n d ɪ ʃ
kentucky	k æ n t ʌ k i
kenyan	k æ n j ə n
kenyon	k æ n j ə n
kerr	ɡ ɝ
kerr's	k ɛ ɹ s
kerry's	k ɛ ɹ ɪ z
kestrels	ɡ ɛ s t ɹ ə l z
ket	ɡ ɛ t
kevin	k æ v ɪ n
kevin	ɡ æ v ə n
kevin	ɡ ɛ v ə n
key	k ɪ
key	ɡ i
keyboard	ɡ i b ɔ d
keys	k i s
keys	ɡ i z
khan	ɡ ɑ n
kick	ɡ ɪ ɡ
kids	k ɪ t s
kids	ɡ ɪ d z
kids	ɡ ɪ d s
kids	ɡ ɪ t s
kif	ɡ ɪ f
kilkenny	k ɪ l k æ n i
killing	k ɪ l ɪ n
killings	k ɪ l ɪ ŋ s
kills	ɡ ɪ l z
kilometers	k ɪ l ə m i t ɝ s
kim	k i m
kim	ɡ ɪ m
kindergarten	k ɪ n d ɝ ɡ ɑ ɹ d ə n
kinds	k aɪ n d s
king	k ɪ n
king	ɡ ɪ ŋ
king's	k ɪ ŋ s
king's	k ɪ n z
kingdom	k ɪ n d ə m
kingmaker	k ɪ ŋ m eɪ ɡ ɝ
kingpin	ɡ ɪ ŋ b ɪ n
kings	k ɪ ŋ s
kingston	ɡ ɪ ŋ s t ə n
kingston	k ɪ n s t ə n
kirksville	k ɝ k s f i l
kisan	k ɪ s ə n
kissed	ɡ ɪ s t
kit	ɡ ɪ t
kit	k ɪ d
kits	k ɪ d z
kitsch	k ɪ d s
klang	ɡ l æ ŋ
klang	k l æ n
klemm	k l æ n
kleptomania	k l ɛ p d ə m eɪ n i ə
kling	k l ɪ n
kloster	k l ʌ s t ɝ
knocked	n ɑ k d
knocking	n ɑ k ɪ n
known	m oʊ n
kondo	ɡ ɑ n d oʊ
korean	k ɔ ɹ i ə n
korean	k ɝ i ə n
korean	ɡ ɹ i ə n
kozak	k oʊ ʃ ə k
kremlin	k ɹ ɛ m l ɪ n
krishna's	k ɹ ɪ ʃ n ə s
krishnan	k ɹ ɪ ʃ n ə n
kristall	k ɹ ɪ s t ə l
kristina	k ɹ ɪ s t i n ə
kudu	ɡ u d u
kudzu	k ɑ d z u
kuyper	k aɪ b ɝ
l	æ l
lab	l æ p
lab	l ɛ p
laboratory	l æ b ɝ ə t ɔ ɹ i
laborers	l eɪ b ɝ ɝ s
labs	l ɛ b z
labs	l æ b s
lace	l eɪ z
lacey	l eɪ s ɪ
lachlan	l æ k l ə m
lacks	l ɛ k s
ladder	l æ t ɝ
ladies	l eɪ d i s
lafferty	l ɛ f ɝ t i
lake	l eɪ ɡ
lakes	l eɪ ɡ s
lakes	l eɪ ɡ z
lamb	l æ n
lambda	l æ n d ə
lance	l æ n z
lancing	l ɛ n s ɪ ŋ
land	l ɛ n t
landtag	l æ n d æ ɡ
langley	l æ n l ɪ
langton	l æ ŋ d ə n
languages	l æ ŋ ɡ w ɪ dʒ ɪ s
languished	l æ ŋ ɡ w ɪ ʃ d
lanky	l æ ŋ ɡ i
lanois	l ɛ n ɔɪ s
lansbury's	l æ n s b ɝ i z
lansdowne	l æ n z d aʊ n
lansing	l æ n z ɪ ŋ
laos	l aʊ z
laplace	l ə p l eɪ z
laptops	l æ p d ɑ p s
lars	l ɑ ɹ s
laser	l eɪ s ɝ
lasted	l æ s t ə t
late	l eɪ d
later	l eɪ d ɝ
latter	l ɛ t ɝ
latter	l æ d ɝ
lattice	l ɛ t ɪ s
latvia	l ɛ d f i ə
latvia	l æ t f i ə
laughed	l æ f d
laundry	l ɔ n d ɹ ɪ
laurie's	l ɔ ɹ i z
lawrence	l ɔ ɹ ə n z
laws	l ɔ s
lawson	l ɔ s ə m
lays	l eɪ s
lead	l i t
leadership	l i d ə s ɪ p
leafs	l i v z
league	l i k
league	l ɪ k
league	l ɪ ɡ
leagues	l i k s
leagues	l i ɡ s
leak	l i ɡ
leakey	l ɪ k i
leaks	l ɪ k s
lear's	l i ɝ z
learnt	l ɝ n d
least	l ɪ s t
leave	l ɪ v
leaves	l i f s
leaves	l ɪ v s
leaving	l i v ɪ n
lebanese	l æ b ə n i z
lebanon	l æ b ə n ə n
lectures	l ɛ k tʃ ɝ s
led	l ɛ t
ledge	l ɛ d s
lee's	l i s
leech	l ɪ tʃ
leeds	l ɪ d s
leeds	l i d s
leesburg	l ɪ z b ɝ ɡ
legality	l ɪ ɡ æ l ɪ t i
legendary	l ɛ dʒ ə n d ɝ i
leighton's	l eɪ d ə n z
leisure	l i ʃ ɝ
leisure	l ɛ ʃ ɝ
leka	l ɪ k ə
lemon	l æ m ə n
lend	l æ n d
lending	l æ n d ɪ ŋ
length	l ɛ n θ
length	l æ ŋ θ
lengthen	l ɛ ŋ ð ə n
lengthened	l ɛ n θ ə n d
lengthening	l æ n θ ə n ɪ ŋ
lengthy	l ɛ n θ i
lens	l æ n s
lens	l æ n z
lenses	l ɛ n s ɪ z
lenses	l ɛ n s ɪ s
lenses	l ɛ n z ɪ s
lent	l ɛ n d
lent	l æ n d
lenten	l æ n t ə n
lenten	l ɛ n d ə n
leroi	l ɪ ɹ ɔɪ
lesbians	l ɛ s b i ə n s
less	l æ s
lessons	l ɛ s ə n s
let	l ɛ d
letter	l æ t ɝ
letter	l ɛ d ɝ
lettering	l ɛ t ɹ ɪ ŋ
letters	l ɛ t ɝ s
lev	l ɛ f
levels	l ɛ v ə l s
leverage	l ɛ v ɝ ɪ dʒ
lewis	l u i s
lib	l i p
libby	l i b i
libraries	l aɪ b ɹ ɛ ɹ i s
libya	l i b i ə
libyan	l ɪ p i ə n
licking	l ɪ k ɪ n
lids	l ɪ t s
lies	l aɪ s
lifeguard	l aɪ v ɡ ɑ ɹ d
light	l aɪ d
lights	l aɪ d s
ligurian	l ɪ ɡ j u ɹ i ə n
likeness	l aɪ k m ə s
lillis	l ɪ l i z
limburg	l ɪ m b ɝ k
lime	l aɪ n
limes	l aɪ n z
limousin	l ɪ m ə s i n
lincoln	l ɪ ŋ ɡ ə n
linear	l i n i ə
linear	l i n i ɝ
lines	l aɪ n s
linkage	l ɪ ŋ ɡ ɪ dʒ
linton	l ɪ ŋ d ə n
lippert	l ɪ b ɝ t
liquid	l i k w ɪ d
lisa	l ɪ z ə
lisa	l ɪ s ə
lisbon	l ɪ s b ə n
list	l i s t
list	l ɪ ʃ t
list	l i ʃ t
listeria	l ɪ s t ɪ ɹ i ə
literatures	l ɪ t ɝ ə tʃ ɝ s
litt	l ɪ d
little	l i t ə l
live	l aɪ f
live	l i v
lived	l i v d
liver	l i v ɝ
lives	l i v z
lives	l aɪ f s
lives	l ɪ v s
lives	l aɪ f z
livestock	l aɪ f s t ɑ k
living	l i v ɪ ŋ
liz	l ɪ s
lizard	l ɪ s ɝ d
lobes	l oʊ b s
locals	l oʊ k ə l s
locating	l oʊ k eɪ t ɪ n
lock	l ɑ ɡ
locomotives	l oʊ k ə m oʊ t ɪ v s
log	l ɔ k
logo	l oʊ k oʊ
long	l ɔ n
longer	l ɔ ŋ ɡ ɝ
look	l u k
looked	l u k t
looked	l ʊ k d
looking	l ʊ k ɪ n
loose	l u z
looses	l u z ɪ z
loot	l u d
looted	l u d ɪ d
looter	l u d ɝ
lopeman	l oʊ b m ə n
loral	l ɔ ɹ ə l
lorenzo	l ɔ ɹ ɛ n s oʊ
los	l ɔ z
lose	l u s
loss	l ɔ z
losses	l ɔ z ɪ s
lost	l ɔ ʃ t
lot	l ɑ d
lottery	l ɑ t ɹ i
louis	l u ɪ
louis	l u i z
louis	l u i s
louis	l u ɪ z
louisa	l u i s ə
louise	l u ɪ s
love	l ʌ f
luc	l ʊ k
lucid	l u z ɪ d
luckily	l ʌ k i l i
lucy	l u z i
luis	l u ɪ s
lumber	l ɑ m b ə
lure	l u ɹ
lusignan	l u z ɪ ɡ n ə n
luther	l u ð ɝ
lutherans	l u θ ɹ ə n z
luthier	l u θ i ɝ
luxembourg	l ʌ ɡ z ə m b ɝ ɡ
luxury	l ʌ ɡ z ɝ i
lynn	l i n
m	æ n
m	æ m
m	ɛ n
machine's	m ə s ɪ n s
mackenzie	m ə ɡ ɛ n s i
maclaren	m ə k l æ ɹ ə n
macpherson	m ə k f ɝ z ə n
madame	m æ d ə n
made	m eɪ t
madeline	m æ d ə l i n
mademoiselle	m æ d ə m ə s ɛ l
madison	m ɛ d ɪ s ə n
madison	m æ t ə s ə n
madras	m ɛ d ɹ ə s
magazine	m æ ɡ ə s i n
magazine	m æ ɡ ə z ɪ n
magdalene	m æ ɡ d ə l ɪ n
magnesium	m æ ɡ n ɪ s i ə m
magnesium	m æ ɡ n i s i ə m
magnus	m æ k n ə s
magnus	m æ k n ə z
magnusson	m æ ɡ m ə s ə n
main	n eɪ n
mainstream	m eɪ n s t ɹ ɪ m
maintain	m eɪ n d eɪ n
maintained	m eɪ n d eɪ n d
maintains	m eɪ n d eɪ n z
maison	m eɪ s ə n
maize	m eɪ s
majors	m eɪ dʒ ɝ s
makin's	m eɪ k ɪ n s
malaysia	m ə l eɪ ʃ ə
malaysian	m ə l eɪ ʃ ə n
males	m eɪ l s
mali	m ʌ l i
malibu	m æ l i b u
man's	m æ n s
man's	m ɛ n z
managed	m æ n ɪ dʒ t
managers	m æ n ɪ dʒ ɝ s
manco	m æ n k oʊ
mandate	m ɛ n d eɪ d
manga	m æ n k ə
manganese	m æ n ɡ ə n i s
mangrove	m æ ŋ ɡ ɹ oʊ v
manhattan	m æ n h æ d ə n
manila	m ə n i l ə
manitoba	m æ n i t oʊ b ə
manitoba	m æ n i d oʊ b ə
manitoba	m æ n ɪ d oʊ b ə
manmade	m æ n m eɪ t
manoeuvre	m ə n u v ɝ
mansion	m æ n s ə n
mantle	m ɛ n t ə l
manufacture	m æ n ə f æ k tʃ ɝ
manure	m ə n u ɝ
many	m æ n i
many	m ɛ n ɪ
manyfold	m æ n ɪ f oʊ l d
marconi	m ɑ ɹ ɡ oʊ n i
margaret	m ɑ ɡ ɝ ɪ t
margaret's	m ɑ ɹ ɡ ɝ ɪ t s
marijuana	m ɛ ɹ i w ɑ n ə
marion	m æ ɹ i ə n
mariposa	m ɛ ɹ ɪ p oʊ s ə
marked	m ɑ ɹ k d
markers	m ɑ ɹ k ɝ s
markets	m ɑ ɹ k ə t s
markup	m ɑ ɹ k ə p
marla	m ɑ ɹ l ə
marple	m ɑ ɹ b ə l
marriage	m æ ɹ ɪ dʒ
marriages	m ɛ ɹ ɪ dʒ ɪ s
married	m æ ɹ i d
married	m ɛ ɹ ɪ d
marsella	m ɑ ɹ s ɛ l ə
marsh	m ɑ ɹ z
marshal	m ɑ ɹ s ə l
marshes	m ɑ ɹ ʃ ɪ z
marshes	m ɑ ɹ ʃ ə s
martin	m ɑ ɹ t i n
martin	m ɑ ɹ t ə n
martin	m ɑ d ɪ n
martini	m ɑ ɹ t ɪ n i
martins	m ɑ ɹ d ɪ n z
mary's	m ɛ ɹ i s
maryland	m ɛ ɹ i l ə n d
marys	m ɛ ɹ i s
mascot	m æ s ɡ ɑ t
mascot	m æ s k ə d
mason	m eɪ z ə n
mass	m ɑ z
mass	m ʌ s
masses	m æ s ɪ s
master	m ʌ s t ə
masters	m ɑ s t ə s
matches	m æ tʃ ɪ s
materialised	m ə t ɪ ɹ i ə l aɪ z t
maternal	m ə d ɝ n ə l
matisse	m æ t ɪ s
matra	m æ t ɹ ə
matrix	m ɛ t ɹ ɪ k s
matter	m æ d ɝ
matters	m æ t ɝ s
maugham	m ɔ k ə m
maurice	m ɔ ɹ ɪ s
maurice	m ɔ ɹ ɪ z
maximus	m æ ɡ z ɪ m ə s
mazda's	m ʌ s d ə s
maze	m eɪ s
mccartney	m ə k ɑ ɹ t n i
mcclean	m ə k l ɪ n
mccook	m ə k u k
mccracken	m ə k ɹ æ k ə n
mclean	m ə k l ɪ n
mcpherson	m ə k f ɝ z ə n
me	n
me	m ɪ
meadows	m æ d oʊ s
meadows	m ɛ d oʊ s
meal	m ɪ l
meals	m ɪ l z
means	m i n s
means	m ɪ n z
means	n i n z
measure	m ɛ ʃ ɝ
measure	m ɛ ʃ ə
measured	m ɛ ʃ ɝ d
measures	m ɛ ʃ ɝ z
measures	m ɛ ʃ ɝ s
measures	m ɛ ʃ ə s
measuring	m ɛ z ɝ ɪ ŋ
meat	m ɪ t
medal	m æ t ə l
medals	m ɛ t ə l z
media	m ɪ d i ə
medial	m ɪ d i ə l
medicine	m æ d ə s ə n
medway	m æ d w eɪ
meeks	m ɪ k s
meeting	m ɪ t ɪ ŋ
meets	m ɪ t s
meets	m ɪ d z
melbourne	m æ l b ɝ n
member	n ɛ m b ɝ
members	m ɛ m b ɝ s
memories	m ɛ m ɝ i s
memory	m æ m ɝ i
memory	m ɛ m ɝ ɪ
memory	m ɛ m ɹ i
memphis	m æ m f ə s
men	m æ n
men's	m ɛ n s
mende	m æ n d
mendon	m æ n d ə n
mental	m ɛ n d ə l
mention	m æ n ʃ ə n
mentor	m æ n d ɝ
mentored	m æ n t ɝ d
menu	m æ n j u
menzies	m æ n z i z
merchandise	m ɝ tʃ ə n d aɪ s
merging	m ɝ dʒ ɪ n
mesial	m i z i ə l
met	m ɛ d
metallic	m ɪ d æ l ɪ k
meteorites	m i d i ɝ aɪ t s
meter	m i d ə
meters	m ɪ t ɝ z
metropolitan	m ɛ t ɹ ə b ɑ l ə t ə n
mexia	m æ k s i ə
micaiah	m ɪ k eɪ ə
mickey's	m ɪ k i s
middletown	m ɪ d ə l d aʊ n
midwifery	m ɪ d w aɪ f ɹ i
migrations	m aɪ ɡ ɹ eɪ ʃ ə n s
miguel	m ɪ ɡ ɛ l
mikita	m ɪ k ɪ t ə
milano	m ɪ l ɑ n oʊ
mildred	m ɪ l d ɹ ɪ d
militaries	m ɪ l ə t ɛ ɹ i z
millennium	m ɪ l ɛ n i ə m
mills	m ɪ l s
mills	m i l z
mimi	m ɪ m i
miners	m aɪ n ɝ s
ming	m i n
minimal	m ɪ n i m ə l
minimum	m ɪ n ə m ə n
minisink	m ɪ n ɪ s ɪ ŋ ɡ
ministerial	m ɪ n ɪ s t ɪ ɹ i ə l
ministers	m ɪ n ɪ s t ɝ s
ministries	m ɪ n ɪ s t ɹ i s
minnie	m i n i
mintaka	m ɪ n t ʌ k ə
miramax	m ɪ ɹ ə m æ k s
miriam	m ɪ ɹ i ə n
mirror	m ɪ ɝ
misbehavior	m ɪ s b ɪ h eɪ v j ɝ
miscarriage	m ɪ s k æ ɹ ɪ dʒ
misfire	m ɪ s f aɪ ɝ
missing	m ɪ s ɪ n
missions	m ɪ s ə n s
misspelled	m ɪ s b ɛ l t
mistress	m ɪ s t ɹ ə s
mistresses	m ɪ s t ɹ ɛ s ɪ s
mistry	m ɪ s t ɹ i
moat	m oʊ d
model	m ɑ t ə l
modeling	m ɑ d l ɪ n
modes	m oʊ t z
molde	m oʊ l t
molly's	m ɑ l ɪ z
mommy	m ʌ m i
monda	m ɑ n t ə
monday	m ɑ n d i
mondo	m ɑ n t oʊ
monetary	m ɑ n ɪ t ɹ i
money	m ɑ n i
money	m ʌ n ɪ
monk	m ɑ ŋ k
monkees	m ɑ n k i z
monks	m ɑ n k s
monks	m ɑ ŋ k s
monomers	m ɑ n ə m ɝ s
monro's	m ʌ n ɹ oʊ z
monsters	m ɑ n s t ɝ s
monstrous	m ɑ n s t ɝ ə s
montana	m ɑ n d æ n ə
montgomery	m ɑ n t ɡ ʌ m ɝ i
moore	m ɔ ɹ
moore's	m u ɹ z
moorings	m ʊ ɹ ɪ ŋ z
moose	m u z
moot	m u d
morgan	m ɔ ɹ k ə n
morning	m ɔ n ɪ n
mornington	m ɔ ɹ n ɪ ŋ d ə n
morphine	m ɔ f ɪ n
morrill	m ɔ ɹ ɪ l
morse	m ɔ ɹ z
morse	m ɔ z
mortimer	m ɔ ɹ t ə m ɝ
moscow	m ʌ s k oʊ
moscow's	m ʌ s k oʊ z
moses	m oʊ s ɪ s
mosque	m ʌ s k
mother	m ɑ ð ɝ
motif	m oʊ t ɪ v
motif	m oʊ t ɪ f
motifs	m oʊ t ɪ v z
motifs	m oʊ t ɪ f s
motive	m oʊ t ɪ f
motors	m oʊ t ɝ s
moult	m oʊ l d
mound	m aʊ n t
mountain	m aʊ n d ə n
mountains	m aʊ n d ə n s
mountains	m aʊ n d ə n z
mouse	m aʊ z
moved	m u v t
movies	m u v i s
mozambique	m oʊ z æ m b ɪ k
mrs	m ɪ s ɪ s
much	m ɑ tʃ
mud	m ɑ d
mug	m ɑ k
mulde	m ʌ l t
multiparty	m ʌ l t i p ɑ ɹ t i
multitasking	m ʌ l t i d æ s k ɪ ŋ
mummification	m ɑ m ə f ə k eɪ ʃ ə n
muscat	m ɑ s k æ t
muscle	m ʌ z ə l
muscles	m ʌ s ə l s
museum	n j u z i ə m
museum	m j u s i ə m
museums	m j u z i ə m s
music	m j u s ɪ k
musica	m j u s ɪ k ə
musical	m j u s ɪ k ə l
musicals	m j u z ɪ k ə l s
musician	m j u ʒ ɪ ʃ ə n
musician	m j u s ɪ ʃ ə n
musicians	m j u s ɪ ʃ ə n z
musicians	m j u ʒ ɪ ʃ ə n z
musick	m j u z ɪ k
musketeers	m ʌ s k ə t ɪ ɹ z
muslim	m ʌ s l ə m
muslims	m ʌ s l ə m z
muslims	m ʌ s l ɪ m z
muslims	m ʌ s l i n z
muslims	m ʌ s l i m z
mussels	m ʌ z ə l z
must	m ʌ ʃ t
muzzle	m ʌ s ə l
mysteries	m ɪ s t ɹ i z
mysteries	m ɪ s t ɹ ɪ s
mystery	m ɪ s t ɹ ɪ
mystique	m ɪ s t ɪ k
n	æ n
nab	n æ p
name	m eɪ n
name	n eɪ n
names	n eɪ m s
naming	n eɪ m ɪ n
nan	n ɛ n
nang	n æ n
nanking	n æ n k ɪ n
nansen	n ɛ n s ə n
napier	n eɪ b i ɝ
napoleon	n ə b oʊ l i ə n
narrow	n æ ɹ oʊ
narrower	n æ ɹ oʊ ɝ
narrowly	n æ ɹ oʊ l i
nashville	n æ ʃ v i l
nasmith	n æ ʃ m ɪ θ
nat	n æ d
nat	n ɛ t
national	m æ s n ə l
national	n æ s n ə l
national	n æ s ə n ə l
nations	n æ ʃ ə n s
nations	m ɛ ʃ ə n s
natives	n eɪ t i v s
naturalism	n æ tʃ ɝ ə l ɪ z ə m
naturalistic	n æ tʃ ɝ ə l ɪ s t ɪ k
naturalized	n æ tʃ ɝ ə l aɪ z d
nature	m eɪ tʃ ɝ
navistar	n æ v i s t ɑ ɹ
nea	m i ə
neal	m i l
nealon	m i l ə n
near	n i
near	n i ɹ
near	m i
near	n i ɝ
near	m ɪ ɹ
near	m ɪ
nearing	n ɪ ɹ ɪ n
nebraska	n ə b ɹ ɛ s k ə
needed	n ɪ d ɪ d
needs	n i d s
needs	n ɪ d s
needs	n i t s
negated	n ɪ ɡ eɪ t ɪ d
negotiations	n ɪ ɡ oʊ ʃ i eɪ s ə n z
neil	m i l
nelson	n ɛ l s ə m
nelson	m ɛ l s ə n
nelson	n æ l s ə n
nene	n ɪ n
nest	m ɛ s t
nest	n ɛ ʃ t
nesta	n ɛ ʃ t ə
nesters	n æ s t ɝ z
network	m ɛ t w ɝ k
never	n æ v ɝ
nevertheless	n ɛ v ɝ θ ə l ɛ s
newcastle	n u ɡ æ s ə l
newport	n u b ɔ ɹ d
news	n u s
newspaper	n u s p eɪ p ɝ
newspaper	n u z p eɪ b ɝ
newspapers	n u s p eɪ p ɝ z
newton	n u d ə n
next	m ɛ k s
nez	n ɛ s
niche	m ɪ tʃ
nicholas	n ɪ k ə l ə z
nicholson	m ɪ k ə l s ə n
nicky	m ɪ k i
niece	n i z
nights	n aɪ d z
nine	m aɪ n
nipple	m ɪ p ə l
nissen	m ɪ s ə n
nixon	m ɪ k s ə n
no	m oʊ
noah	m oʊ ə
nocturnal	n ɑ k d ɝ n ə l
node	n oʊ t
node	m oʊ d
nodes	n oʊ t s
noise	n ɔɪ s
nomadic	n oʊ m æ t ɪ k
nominees	n ɑ m ə n i s
nonprofit	n ɑ n p ɹ ɑ f ə t
nonstarter	n ɑ n s t ɑ ɹ t ɝ
nonstop	n ɑ n s t ʌ p
nord	n ɔ ɹ
norris's	n ɔ ɹ ɪ s ɪ s
northeast	n ɔ ɹ θ ɪ s t
northerly	n ɔ ɹ θ ɝ l i
northern	n ɔ ɹ θ ɝ n
northernmost	n ɔ ɹ θ ɝ n m oʊ s t
nose	n oʊ s
notation	n oʊ d eɪ ʃ ə n
noteworthy	n oʊ t w ɝ θ i
nothing	n ɑ θ ɪ ŋ
nothing	n ʌ θ ɪ n
notice	m oʊ t ɪ s
notice	n oʊ t i z
notion	m oʊ ʃ ə n
nourish	n ɝ ɪ s
novels	n ɑ v ə l s
nullifying	m ʌ l ə f aɪ ɪ ŋ
number	n ʌ m ɝ
numbers	n ʌ m b ə s
numbers	n ʌ m b ɝ s
nuns	n ʌ n s
nurses	n ɝ s ɪ s
nut	n ɑ t
nuts	n ɑ t s
nutt	n ɑ t
oases	oʊ eɪ s i z
obedience	oʊ b ɪ d i ə n s
oblast	ɑ b l ɛ s t
observance	ə b s ɝ v ə n s
obsolete	ɑ b s ə l ɪ t
obstetrics	ɑ p s t æ t ɹ ɪ k s
obtain	ə p t eɪ n
obtained	ə p t eɪ n d
occasion	ə k eɪ ʃ ə n
occasional	ə k eɪ ʃ ə n ə l
occasionally	ə k eɪ ʃ n ə l i
occasions	ə k eɪ ʃ ə n z
occurs	ə k ɝ s
of	ʌ f
of	ɔ f
of	ɑ f
of	ɑ v
of	ə f
off	ʌ v
off	ɔ v
offenses	ə f ɛ n s ɪ s
offers	ɔ v ɝ z
offers	ɑ f ɝ s
offers	ɔ f ɝ s
office	ɔ f ə z
office	ɔ f i s
officers	ɔ f ə s ɝ s
offices	ɔ f ə s ə s
offices	ɔ f ə s ɪ s
officials	ə f i ʃ ə l z
ogre	oʊ ɡ ɹ
ollie	oʊ l ɪ
olympias	oʊ l ɪ m p i ə z
olympic	oʊ l ɪ m b ɪ k
olympus	oʊ l ɪ m b ə s
omnibus	ɑ m n i b ə s
on	ʌ n
on	ɔ ŋ
on	ʌ m
once	w ʌ n z
onega	oʊ n eɪ k ə
ones	w ʌ n s
onesimus	oʊ n ɪ s ɪ m ə s
only	oʊ n l ɪ
ontario	ɑ n t æ ɹ i oʊ
ontario's	ɑ n d æ ɹ i oʊ z
onto	ɔ n d u
opened	oʊ b ə n d
opens	oʊ b ə n z
operated	ɑ p ɹ eɪ t ɪ d
operated	ʌ p ɹ eɪ t ɪ d
operates	ɑ p ɝ eɪ t z
operating	ʌ p ɝ eɪ t ɪ ŋ
operation	ɑ p ɹ eɪ ʃ ə n
operations	ɑ p ɹ eɪ ʃ ə n z
operations	ɑ p ɝ eɪ ʃ ə n s
operators	ɑ p ɝ eɪ t ɝ s
oppose	ə p oʊ s
opposed	ə p oʊ z t
opposed	ə p oʊ s t
opposes	ə p oʊ s ɪ z
opposing	ə p oʊ s ɪ ŋ
opposition	ɑ p ə s ɪ ʃ ə n
or	ɹ
orbiter	ɔ ɹ b ə t ɝ
order	ɔ t ə
orders	ɔ d ə s
organization	ɔ ɹ ɡ ə n ə ʒ eɪ ʃ ə n
organs	ɔ ɡ ə n s
oriented	ɔ ɹ i ɛ n t ə d
original	ɹ ɪ dʒ ə n ə l
origins	ɝ ɪ dʒ ə n s
ornamental	ɔ ɹ n ə m ɛ n t ə l
ornamentations	ɔ ɹ m ə m ɛ n t eɪ ʃ ə n z
orphans	ɔ ɹ f ə m z
orpheus	ɔ ɹ f i ə z
oscar	ɑ s k ɝ
oslo	ʌ s l oʊ
oslo	ɑ s l oʊ
osmium	ɑ s m i ə m
osmond	ɑ z m ə n d
osteen	ʌ s t i n
other	ɑ ð ɝ
other	ɑ ð ə
other	ʌ θ ɝ
others	ʌ ð ɝ s
others	ɑ ð ɝ z
others	ʌ ð ə s
ounces	aʊ n z ɪ z
our	aʊ ɝ
our	ʌ ɝ
out	aʊ d
outcrops	aʊ t k ɹ ɑ b s
outer	aʊ d ɝ
outgrew	aʊ t k ɹ u
outpost	aʊ t b oʊ s t
ovens	ʌ v ə n s
overlapped	oʊ v ɝ l ɛ p t
overseas	oʊ v ɝ s i s
owens	oʊ ə n s
owned	oʊ n t
owns	oʊ n s
p	b i
pace	b eɪ s
pace	p eɪ z
pacers	p eɪ s ɝ s
pacified	b æ s ə f aɪ d
pack	b æ k
pack's	b æ k s
package	b æ k ɪ dʒ
package	b ɛ k ɪ dʒ
packaged	b æ k ɪ dʒ d
packer	b æ k ɝ
packer's	b æ k ɝ z
packers	b æ k ɝ z
packet	b æ k ɪ t
packet	b æ k ə t
packing	b æ k ɪ ŋ
packs	b æ k s
packs	b æ ɡ z
pact	b æ k t
pad	b æ d
padded	b æ d ɪ d
paddington	b æ d ɪ ŋ d ə n
paddle	b æ t ə l
paddle	b æ d ə l
paddling	b æ d l ɪ ŋ
paddock	b æ d ə k
paddocks	b æ d ə k s
paddy	b æ t i
page	b eɪ dʒ
pages	b eɪ dʒ ɪ z
pages	p eɪ dʒ ɪ s
paid	b eɪ d
paige	b eɪ dʒ
painter	b eɪ n t ɝ
pair	b ɛ ɹ
pair	b æ ɹ
pairing	b æ ɹ ɪ ŋ
pairs	b ɛ ɹ s
pairs	b ɛ ɹ z
paisley	b eɪ s l i
pala	b ɑ l ə
palace	b æ l ə s
palace	b æ l ə z
palamede	b æ l ə m i d
palamon	b æ l ə m ə n
palazzo	p ə l ɑ s oʊ
pale	b eɪ l
pallium	p ɛ l i ə m
palm	b ɑ m
palm	b ɑ n
palm	p ʌ m
palm	p ɑ n
palmer	b ɑ m ə
palo	b æ l oʊ
pamplona	b æ m b l oʊ n ə
pan	b æ n
pan	b ɛ n
panama	b æ n ə m ə
panda	b æ n d ə
panel	b æ n ə l
panels	b æ n ə l z
panics	b æ n ɪ k s
panik	b æ n ɪ k
panola	b ə n oʊ l ə
pans	b æ n s
pans	b æ n z
pant	p ɛ n t
pantomimes	p æ n d ə m aɪ m z
pap	b æ p
paper	b eɪ p ɝ
paper's	b eɪ b ɝ z
papers	p eɪ p ɝ s
papers	b eɪ b ɝ z
paphos	p æ f oʊ s
pappus	b æ p ə s
par	b ɑ
par	b ɑ ɹ
parachute	b æ ɹ ə ʃ u t
paradigm	p ɛ ɹ ə d aɪ n
paradise	p æ ɹ ə d aɪ s
paradox	p æ ɹ ə d ɑ k s
paramount	b æ ɹ ə m aʊ n t
parasites	p æ ɹ ə s aɪ t s
pardon	b ɑ ɹ d ə n
parent	b æ ɹ ə n t
parentheses	p ɝ ɛ n θ ə s ɪ s
parents	b ɛ ɹ ə n t s
paris	p ɛ ɹ i z
paris	b ɛ ɹ ɪ s
paris	b æ ɹ ə s
paris	b æ ɹ ɪ s
parish	b æ ɹ ɪ ʃ
parish	p æ ɹ ɪ s
parishes	p ɛ ɹ ɪ ʃ ɪ z
parity	p ɛ ɹ ɪ d i
park	b ɑ ɹ k
park's	b ɑ ɹ k s
parker	b ɑ ɹ k ɝ
parker	b ɑ k ə
parkersburg	p ɑ ɹ k ɝ s b ɝ ɡ
parking	b ɑ k ɪ ŋ
parking	b ɑ ɹ k ɪ ŋ
parking	p ɑ k ɪ n
parkinson's	b ɑ ɹ k ɪ n s ə n s
parlance	p ɑ l ə n z
parlance	p ɑ ɹ l ə n z
parliamentary	p ɑ ɹ l ə m ɛ n t ɹ i
parma	b ɑ ɹ m ə
parrish	p æ ɹ ɪ ʃ
parry	b ɛ ɹ i
parser	p ɑ ɹ s ɝ
parsons	b ɑ ɹ s ə n z
part	b ɑ t
part	b ɑ ɹ t
part	b ɑ d
part	b ɑ ɹ d
partial	b ɑ ɹ ʃ ə l
partially	p ɑ s ə l i
participate	b ɑ ɹ t ɪ s ə p eɪ t
particle	b ɑ t ɪ k ə l
particles	p ɑ ɹ t ə k ə l s
particles	p ɑ ɹ t ɪ k ə l z
partied	p ɑ ɹ t ɪ d
parties	b ɑ t i z
parties	b ɑ ɹ t i z
parties	p ɑ t ɪ s
parties	b ɑ ɹ t i s
parting	b ɑ t ɪ ŋ
partly	b ɑ t l i
parton	b ɑ ɹ t ə n
partridge	b ɑ ɹ t ɹ ɪ dʒ
parts	b ɑ t s
parts	b ɑ ɹ t s
party	b ɑ d i
party	b ɑ ɹ t i
party	b ɑ t i
party	b ɑ ɹ d i
party	b ɑ d ɪ
party	p ɑ d i
party	p ɑ ɹ t ɪ
party	p ɑ ɹ d i
party's	b ɑ ɹ t i z
pas	b ɑ s
pasadena	b æ s ə d i n ə
pascal	b æ s k ə l
pass	b ɑ s
pass	b æ s
pass	b ʌ s
passage	b æ s ɪ dʒ
passage	p ɛ s ɪ dʒ
passed	b æ s t
passed	b ɑ s t
passed	b æ ʃ t
passed	b æ s d
passed	b ɑ z d
passenger	p æ s ɪ n dʒ ɝ
passengers	b æ s ə n dʒ ɝ s
passes	p ɑ s ɪ s
passes	p æ s ɪ s
passes	b ʌ s ɪ z
passes	b ʌ s ɪ s
passes	b æ s ə z
passes	b ɑ z ɪ z
passes	b æ s ə s
passes	p æ s ə s
passing	b ɑ s ɪ ŋ
passy	b æ s i
past	b æ s t
past	b ɑ s t
paste	b eɪ s t
pasture	p æ s t ɝ
pat	b æ d
patch	b æ tʃ
patch	b æ t s
patched	p ɛ tʃ t
patches	b æ tʃ ɪ z
patching	b æ tʃ ɪ ŋ
patchwork	b æ tʃ w ɝ k
patent	b æ t ə n d
path	b æ θ
path	b ɑ θ
paths	b æ θ s
patrice	p ə t ɹ i s
patricia	p ə t ɹ i ʃ ə
patterson	p ɛ t ɝ s ə n
patterson	b æ t ɝ s ə n
patti	b æ t ɪ
patti	p ɛ t i
patton	b æ t ə n
paul	b ɔ l
paul	b ɑ l
paulin	b ɔ l ɪ n
paulus	b ɔ l ə z
pauses	p ɔ s ə s
pawn	b ɔ n
paxton	b æ k s t ə n
pay	b eɪ
payments	b eɪ m ə n t s
payne	b eɪ n
payson	b eɪ s ə n
payton	b eɪ d ə n
pea	b i
peace	b i z
peace	b i s
peace	p ɪ s
peak	b i k
peak	p ɪ k
peak	b ɪ ɡ
peak	b i ɡ
peake	b i k
peaked	b i k t
peaked	p i k d
peaking	p ɪ k ɪ ŋ
peale	p ɪ l
pearl	b ɝ l
pearly	b ɝ l i
peas	b i z
peat	b i t
peat	b i d
peck	b ɛ k
pedee	b ɛ d i
peel	b ɪ l
peel	b i l
peeples	p i p ə l s
peers	b ɪ ɹ z
pegasus	p ɛ ɡ ə z ə s
pegler	b æ ɡ l ɝ
peirce	p ɪ ɹ z
pelagic	b ə l ɛ dʒ ɪ k
pella	b ɛ l ə
pellet	p æ l ə t
pellet	b ɛ l ɪ t
pelton	b ɛ l t ə n
pen	b ɛ n
pence	b ɛ n s
pending	b ɛ n d ɪ ŋ
penguin	p ɛ n ɡ w ɪ n
penn	b ɛ n
penn's	p æ n s
penney	b ɛ n i
penning	b ɛ n ɪ ŋ
pennington	b ɛ n ɪ ŋ t ə n
penny	b ɛ n i
penny's	b æ n i z
pens	p ɛ n s
pense	b ɛ n s
pension	p æ n ʃ ə n
pentax	b æ n t æ k s
pentax	b ɛ n t æ k s
penthouse	b æ n d h aʊ s
penzance	b ɛ n z ə n s
people	b i p ə l
people	p i b ə l
pepa	b ɛ b ə
pepper	p æ p ɝ
per	b ɝ
perce	b ɝ z
perceval	p ɝ s ɛ v ɛ l
percival	p ɝ s i v ə l
perdue	b ɝ d u
perelman	b ɛ ɹ ə l m ə n
perfect	b ɝ f ɛ k t
performance	p ɝ f ɔ ɹ m ə n z
performer	b ə f ɔ m ə
period	p i ɹ i ə d
periods	p ɪ ɹ i ə d z
periods	p ɪ ɹ i ə d s
perkins	b ɝ k ɪ n z
permian	b ɝ m i ə n
perry	b ɛ ɹ i
persia	p ɝ ʃ ə
persian	p ɝ s ə n
persian	p ɝ ʃ ə n
person	b ɝ s ə n
person	p ɝ ʃ ə n
personal	b ɝ s ə n ə l
persons	p ɝ s ə n s
persons	b ɝ s ə n s
persuades	p ɝ ʃ w eɪ d z
perth	b ɝ θ
pest	p æ s t
pests	b ɛ s t s
pet	b ɛ t
pet	b ɛ d
pete	b i d
pete	b ɪ d
pete	b i t
pete	p ɪ t
peter	b i d ɝ
peter	b i t ə
peter	p i d ɝ
peter	p ɪ t ɝ
peter	b i t ɝ
peter's	b i t ɝ z
peterson	b i t ɝ s ə n
petition	p ə d ɪ ʃ ə n
petrie	p ɛ t ɹ i
pets	b ɛ t s
peyton	b eɪ t ə n
peyton's	b eɪ t ə n z
phantom	f æ n d ə m
phantoms	f æ n d ə m s
pharmacy	f ɑ m ə z ɪ
phase	f eɪ s
phased	f eɪ s t
phases	f eɪ s ɪ z
phases	f eɪ s ɪ s
philippines	f ɪ l ə p ɪ n s
philo	f ɪ l oʊ
philosophy	f ɪ l ɑ z ə f i
phonemic	f ə n ɪ m ɪ k
phones	f oʊ m z
photographed	f oʊ t ə ɡ ɹ æ f d
physician	f ɪ z i ʃ ə n
pianist	b i ə n ɪ s t
piccolo	p ɪ k oʊ l oʊ
pick	b ɪ ɡ
picked	p ɪ k d
pickens	p ɪ k ə n s
pickens	b ɪ k ə n z
picture	p ɪ tʃ ɝ
pictures	p ɪ k tʃ ɝ s
pictures	b ɪ k tʃ ɝ s
piece	b i s
pieces	p i s ɪ s
pieces	p i s ə s
pieces	p i z ɪ s
pieces	p i s i z
piedmont	p i d m ɑ n d
pierce	b ɪ ɹ s
piet	b i t
pig	p ɪ k
pigeon	b i dʒ ə n
piglet	b ɪ ɡ l ə t
pigs	b ɪ ɡ s
pike	b aɪ k
piles	b aɪ l z
pillar	b ɪ l ɝ
pillars	b ɪ l ə z
pillow	b ɪ l oʊ
pillsbury	p ɪ l s b ɛ ɹ i
pindus	b ɪ n d ə z
pine	b aɪ n
pines	b aɪ n s
pini	b ɪ n i
pinion	b ɪ n j ə n
pinner	b ɪ n ɝ
pinus	b aɪ n ə s
pioneer	b aɪ ə n ɪ ɹ
pioneered	p aɪ ə n i ɝ d
pioneering	b aɪ ə n ɪ ɹ ɪ ŋ
pipes	b aɪ p s
pistons	p ɪ s t ə n s
pit	b ɪ t
pit	b i t
pitch	b ɪ tʃ
pitch	b ɪ t s
pitched	b ɪ tʃ t
pitchers	p i tʃ ɝ z
pitches	b ɪ tʃ ɪ z
pitman's	b ɪ t m ə n z
pitt	b i t
pitt	b ɪ t
pitt	p ɪ d
pitted	p i t ɪ d
pizarro	p ɪ s ɑ ɹ oʊ
place	p l eɪ z
places	p l eɪ s ɪ s
places	p l eɪ z ɪ z
places	b l eɪ s ɪ z
plains	p l eɪ n s
plan	b l æ n
plan	p l ɛ n
planes	b l eɪ n z
planetarium	p l æ n ɪ t ɛ ɹ i ə m
planned	b l æ n d
planned	p l æ n t
planning	b l æ n ɪ ŋ
plans	p l æ n s
plant	b l ɑ n d
plant	p l æ n d
plant	b l æ n t
plant	b l æ n d
plantain	p l æ n t i n
plantation	p l æ n d eɪ ʃ ə n
plants	p l æ n t z
plaque	b l æ k
plaques	b l æ k s
plaskett	b l æ s k ɪ t
plasma	p l æ s m ə
plasmid	p l æ s m ɪ t
plassey	b l æ s i
plaster	b l æ s t ɝ
plate	p l eɪ d
plates	p l eɪ t z
platforms	p l æ t f ɔ ɹ m s
platinum	p l æ t i n ə m
platoon	p l ə d u n
platt	b l æ t
plattsburgh	b l æ t s b ɝ ɡ
play	b l eɪ
played	b l eɪ d
player	p l eɪ ɹ
plays	p l eɪ s
plays	b l eɪ z
plays	b l eɪ s
plaza	p l ɑ s ə
pleas	p l i s
pleasant	p l ɛ s ə n t
please	p l i s
pleasure	p l ɛ ʃ ɝ
pleasured	p l ɛ ʃ ɝ d
plot	b l ɑ t
plot	b l ɑ d
plotkin	b l ɑ t k ɪ n
plots	b l ɑ t s
plotters	b l ɑ t ɝ z
plotting	b l ɑ t ɪ ŋ
plug	b l ʌ ɡ
plumage	b l u m ɪ dʒ
poacher	b oʊ tʃ ɝ
pockets	b ɑ k ə t s
pod	b ɔ d
point	b ɔɪ n t
point	b ɔɪ n d
pointe	b ɔɪ n d
polar	b oʊ l ɝ
pole	b oʊ l
poles	b oʊ l z
police	p ə l ɪ s
policies	p ɑ l ə s ɪ s
polish	b ɑ l ɪ ʃ
polishing	p ɑ l ɪ s ɪ ŋ
politician	p ɑ l ə d ɪ ʃ ə n
poll	b oʊ l
polluted	b ə l u t ɪ d
polydeuces	p ɑ l ɪ d u s ɪ s
polyhedron	p ɑ l i h i d ɹ ə n
polymer	p ɑ l ɪ m ɝ
polymer	b ɑ l ɪ m ɝ
pony	b oʊ n i
pool	b ʊ l
pool	p ʊ l
poor	p ɔ
pop	b ɑ p
pop	b ɑ b
pope's	b oʊ p s
popping	b ɑ p ɪ ŋ
poppy	b ɑ p i
pops	b ɑ p s
populations	p ɑ p j ə l eɪ ʃ ə n s
port	b ɔ t
porticos	p ɔ ɹ t ɪ k oʊ z
portrayed	p ɔ ɹ t ɹ eɪ t
ports	b ɔ ɹ d z
ports	b ɔ t s
ports	p ɔ d z
portuguese	p ɔ ɹ tʃ ə ɡ i s
portuguese	p ɔ tʃ ə ɡ i s
pose	b oʊ z
pose	p oʊ s
posen	p oʊ s ə n
posing	p oʊ s ɪ ŋ
position	p ə ʃ ɪ ʃ ə n
position	p ə z ɪ s ə n
position	p ə ʒ ɪ ʃ ə n
positions	p ə z ɪ ʒ ə n z
positions	p ə z ɪ ʒ ə n s
possible	p ɑ z ə b ə l
posted	b oʊ s t ɪ d
posters	b oʊ s t ɝ z
pot	b ɔ t
potassium	p ə t æ ʃ i ə m
potential	p ə d ɛ n ʃ ə l
pots	b ɑ t s
pott	b ɑ d
powder	b aʊ d ɝ
power	b aʊ ɝ
power	p ʌ
power	b ɑ
power	p aʊ ɹ
power	b ʌ
powered	b aʊ ɝ d
powerful	b aʊ ɝ f ə l
powers	b aʊ ɝ z
powers	p aʊ ɝ s
powers	p aʊ ɝ ʃ
practice	p ɹ æ k t ə z
practice	b ɹ æ k t ɪ s
practiced	p ɹ æ k t ə s d
practising	p ɹ æ k t ə s ɪ ŋ
praise	p ɹ eɪ s
praised	p ɹ eɪ z t
pratchett	b ɹ æ tʃ ɪ t
pratt	b ɹ æ t
pratt	p ɹ æ d
pray	b ɹ eɪ
prayer	b ɹ eɪ ɝ
preachers	b ɹ i tʃ ɝ z
precaution	p ɹ ɪ k ɔ ʃ ə n
preceded	p ɹ i s i d ə d
preceded	p ɹ ɪ s i d ə d
precedes	p ɹ i s i d z
precession	p ɹ ɪ s ɛ ʃ ə n
precision	p ɹ ɪ s ɪ s ə n
preclinical	p ɹ i k l ɪ n ɪ k ə l
predecessor	p ɹ i d ə s ɛ s ɝ
predecessor	p ɹ ɪ d ə s ɛ s ɝ
predecessors	p ɹ ɛ d ə s ɛ s ɝ s
predictions	p ɹ ɪ d ɪ k ʃ ə n z
predominant	p ɹ i d ɑ m ə n ə n t
predominantly	p ɹ i d ɑ m ə n ə n t l i
predominately	p ɹ i d ɑ m ə n ə n t l i
preferable	p ɹ ɛ f ɝ ə b ə l
preference	p ɹ ɛ f ɝ ə n s
prefrontal	p ɹ i f ɹ ʌ n t ə l
premier	p ɹ i m ɪ ɹ
premier	p ɹ i m i ɹ
premier	p ɹ i m j ɝ
premier	p ɹ ɪ m i ɹ
prep	p ɹ æ p
prepaid	p ɹ i b eɪ d
prerecorded	p ɹ i ɹ ɪ k ɔ ɹ d ɪ d
preschool	p ɹ i s k u l
preschoolers	p ɹ i s k u l ɝ z
preseason	p ɹ i s i z ə n
presence	p ɹ ɛ s ə n s
present	p ɹ i s ɛ n t
present	p ɹ ɪ s ɛ n t
presented	p ɹ i z ɛ n ə d
presented	p ɹ i z ɛ n t ə d
presented	p ɹ i z ɛ n t ɪ d
presented	p ɹ ɪ z ɛ n t ə d
presented	p ɹ ɪ s ɛ n t ɪ d
presenter	p ɹ i z ɛ n t ɝ
presenter	p ɹ ɪ z ɛ n t ɝ
presenters	p ɹ i z ɛ n t ɝ z
presenting	p ɹ ɪ z ɛ n t ɪ ŋ
presenting	p ɹ i z ɛ n t ɪ n
presided	p ɹ i s aɪ d ɪ d
president	p ɹ ɛ s ɪ d ə n t
presiding	p ɹ ɪ s aɪ d ɪ ŋ
presiding	p ɹ i s aɪ d ɪ ŋ
press	b ɹ ɛ s
pressed	b ɹ ɛ s t
presser	p ɹ æ s ɝ
presser	p ɹ ɛ ʃ ɝ
presses	p ɹ ɛ s ə s
presses	b ɹ ɛ s ɪ s
pressure	p ɹ ɛ ʒ ɝ
pressures	p ɹ ɛ ʃ ɝ s
presumes	p ɹ i s u m z
preteen	p ɹ i d ɪ n
pretense	p ɹ ɪ t ɛ n s
pretoria	p ɹ ɪ t ɔ ɹ i ə
prevalent	p ɹ ɛ f ə l ə n t
prey	b ɹ eɪ
price	p ɹ aɪ z
price	b ɹ aɪ z
prices	p ɹ aɪ z ɪ z
pricing	p ɹ aɪ z ɪ ŋ
prickly	b ɹ ɪ k l i
priest	p ɹ ɪ s t
priesthood	p ɹ i s t h u d
primates	b ɹ aɪ m eɪ t s
primitive	p ɹ ɪ m ə t ɪ v
prince's	p ɹ ɪ n s ɪ s
princes	p ɹ ɪ n s ɪ s
princesses	p ɹ ɪ n s ɛ s ɪ z
princeton	b ɹ ɪ n s t ə n
pringle	b ɹ ɪ ŋ ɡ ə l
prins	p ɹ ɪ n s
prinz	p ɹ ɪ n s
prismatic	p ɹ ɪ s m æ t ɪ k
prison	p ɹ ɪ s ə n
prisoner	p ɹ i z ə n ɝ
prisoners	p ɹ ɪ z ə n ɝ s
prisoners	p ɹ ɪ s ə n ə z
prisoners	p ɹ ɪ s ə n ɝ z
privileges	p ɹ ɪ v l ɪ dʒ ɪ s
prix	p ɹ ɪ
prize	p ɹ aɪ s
prize	b ɹ aɪ z
prizes	p ɹ aɪ s ɪ z
pro	b ɹ oʊ
problematic	p ɹ ɑ b l ə m ɛ t ɪ k
problems	p ɹ ɑ b l ə m s
problems	p ɹ ɑ p l ə m z
processes	p ɹ ɑ s ɛ s i z
processes	p ɹ ɑ s ɛ s ɪ s
processes	p ɹ ɑ s ɛ s ə s
produces	p ɹ ə d u s ə z
products	p ɹ ɑ d ə k s
programming	b ɹ oʊ ɡ ɹ æ m ɪ ŋ
programs	p ɹ oʊ ɡ ɹ æ m s
projectiles	p ɹ ə dʒ ɛ k d aɪ l z
prolific	b ɹ oʊ l ɪ f ɪ k
prolific	b ɹ ə l ɪ f ɪ k
prominence	b ɹ ɑ m ə n ə n s
promising	p ɹ ɑ m ə s ɪ ŋ
promoters	p ɹ ə m oʊ t ɝ s
promotes	p ɹ ə m oʊ d z
promptly	p ɹ ɑ m p l i
proofed	p ɹ u v d
proofs	p ɹ u f z
prophecy	p ɹ ɑ v ə s i
proposal	p ɹ ə p oʊ s ə l
proposals	p ɹ ə p oʊ s ə l z
proposed	p ɹ ə p oʊ z t
proposed	p ɹ ə p oʊ s t
props	p ɹ ɑ b z
prose	b ɹ oʊ s
prose	p ɹ oʊ s
prosperity	p ɹ ɑ s p ɛ ɹ ə t i
prostitutes	p ɹ ɑ s t ə t u d z
protected	p ɹ ə d ɛ k t ɪ d
protection	p ɹ ə d ɛ k ʃ ə n
protections	p ɹ ə t ɛ k ʃ ə n z
protective	p ɹ ə d ɛ k t ɪ v
protectors	p ɹ ə t ɛ k t ɝ s
protein	p ɹ oʊ d i ŋ
proteins	p ɹ oʊ d i n z
proteins	b ɹ oʊ t i n z
protestantism	p ɹ ɑ t ə s t ə n d ɪ s ə m
protests	p ɹ ə t ɛ s
province's	p ɹ ɑ v ə n s ɪ z
provincial	p ɹ ə v ɪ n s ə l
provision	p ɹ ə v ɪ ʃ ə n
provisional	p ɹ ə v ɪ ʃ ə n ə l
provisions	p ɹ ə v ɪ ʃ ə n z
pruning	b ɹ u n ɪ ŋ
pseudonym	s u d ə n i m
pub	p ʌ p
pub	b ʌ p
pub	b ɑ b
puberty	b j u b ɝ d i
public	p ɑ b l ɪ k
public	b ʌ p l ɪ k
publication	p ɑ b l ɪ k eɪ ʃ ə n
publication	p ɑ b l ɪ ɡ eɪ ʃ ə n
publications	p ʌ b l ɪ k eɪ ʃ ə n s
published	p ʌ b l ɪ s t
published	b ʌ b l ɪ s t
publishing	p ʌ b l ɪ ʃ ɪ n
pubs	b ʌ b z
pubs	p ʌ p s
puck	p ɑ k
puck	b ʌ k
pudding	p u d ɪ ŋ
pudding	p ʊ t ɪ ŋ
puddle	p ʌ t ə l
puerto	p ɔ ɹ t ə
puff	b ʌ f
puff	p ɑ f
puka	b u k ə
pul	p ʊ l
pulaski	p u l æ s k i
pulling	p u l ɪ ŋ
pulse	b ʌ l s
pump	b ʌ m p
pumping	b ʌ m p ɪ ŋ
pun	b ʌ n
punch	b ʌ n tʃ
punching	b ʌ n tʃ ɪ ŋ
pundit	b ʌ n d ɪ t
punk	b ʌ ŋ k
punning	b ʌ n ɪ ŋ
purbeck	b ɝ b ɛ k
purchase	p ɝ tʃ ə z
pure	p j u ɹ
pure	b j ɔ
purposes	p ɝ p ə s ɪ s
purposes	p ɝ p ə s ə s
purr	b ɝ
purse	b ɝ s
pursue	p ɝ ʃ u
pursued	p ɝ ʃ u d
put	p ʊ d
putting	p ʊ t ɪ n
puzzle	p ʌ s ə l
puzzle	b ʌ z ə l
puzzles	b ʌ z ə l z
puzzles	p ʌ z ə l s
pygmy	b ɪ k m i
pylades	b aɪ l eɪ d z
quadrate	k w ɑ d ɹ eɪ d
quadratic	k w ɑ d ɹ ɛ t ɪ k
qualities	k w ɑ l ɪ t i s
quantum	ɡ w ɑ n t ə m
quarterback	k w ɔ ɹ t ɝ b ɛ k
quarters	k w ɔ ɹ t ɝ s
queensland	k w i n s l æ n d
queenston	k w ɪ n s t ə n
question	k w ɛ s ə n
quiche	k ɪ ʃ
quickly	k w ɪ k l ɪ
quigley	k w ɪ k l i
quinn	ɡ w ɪ n
quire	k w aɪ ɝ
quit	k w ɪ d
rabbit	ɹ æ b ɪ d
race	ɹ eɪ z
raced	ɹ eɪ z d
races	ɹ eɪ s ɪ s
racine	ɹ eɪ z ɪ ŋ
racing	ɹ eɪ z ɪ ŋ
racing	ɝ eɪ z ɪ ŋ
racks	ɹ æ ɡ s
radcliffe	ɹ ɛ d k l ɪ f
radical	ɹ ɛ d ɪ ɡ ə l
radical	ɹ ɛ d ɪ k ə l
radley	ɹ ɛ d l i
raids	ɹ eɪ d s
railway's	ɹ eɪ l w eɪ s
raise	ɹ eɪ s
raised	ɹ eɪ z t
raising	ɹ eɪ s ɪ n
raising	ɹ eɪ s ɪ ŋ
ramsay	ɹ æ m z eɪ
ramsay's	ɹ æ m s i z
ramsey	ɹ æ n s i
ran	ɹ æ ŋ
rance	ɹ æ n z
randles	ɹ ɛ n d ə l z
randy	ɹ ɛ n d i
rangers	ɹ eɪ n dʒ ɝ s
ranges	ɹ eɪ n dʒ ɪ s
rank	ɹ æ n k
ranking	ɹ æ ŋ ɡ ɪ ŋ
rankings	ɹ æ ŋ k ɪ ŋ z
rankings	ɹ æ ŋ k ɪ n s
ransom	ɹ æ n s ə n
rapes	ɹ eɪ b s
rapid	ɹ ɛ p ɪ d
rapidly	ɹ æ b ə d l i
rapids	ɹ æ b ɪ t s
rarely	ɹ æ l i
rasche	ɹ æ ʃ
rashid	ɹ ɑ ʃ ɪ t
rate	ɹ eɪ d
rates	ɹ eɪ t z
rather	ɹ ɑ ð ɝ
rating	ɹ eɪ d ɪ ŋ
ratings	ɹ eɪ t ɪ ŋ s
ratings	ɹ eɪ d ɪ ŋ z
ratliff	ɹ æ t l ɪ f
ratlike	ɹ ɛ t l aɪ k
rattling	ɹ æ t l ɪ ŋ
ravenscroft	ɹ eɪ v ə n s k ɹ ɔ f t
rawlins	ɹ ɔ l ɪ ŋ z
raymond	ɹ eɪ m ə n t
rays	ɹ eɪ s
raz	ɹ æ s
reached	ɹ i tʃ d
reaches	ɹ i tʃ ɪ s
reactors	ɹ i æ k t ɝ s
readers	ɹ i d ɝ s
readers	ɹ ɪ d ɝ z
reading	ɹ ɪ d ɪ ŋ
readings	ɹ ɪ d ɪ ŋ z
readings	ɹ i d ɪ ŋ z
reads	ɹ i t s
ready	ɹ ɛ d ɪ
realized	ɹ i ə l aɪ z t
reapportionment	ɹ i ə p ɔ ɹ ʃ ə n m ə n t
reason	ɹ i s ə n
reasons	ɹ i z ə n s
reasons	ɹ i s ə n z
reasons	ɹ i s ə n s
rebelled	ɹ i b ɛ l d
rebels	ɹ i b ɛ l z
rebels	ɹ ɪ b ɛ l z
rebroadcast	ɹ i b ɹ ɔ d k æ s t
rebuffs	ɹ i b ʌ v s
recalls	ɹ ɪ k ɔ l z
received	ɹ ɪ z i v d
received	ɹ i s i v d
recent	ɹ i s ɛ n t
recent	ɹ i s ə n d
recently	ɹ i s ə n l i
reception	ɹ ɪ ʃ ɛ p ʃ ə n
recognized	ɹ ɛ k ə ɡ n aɪ z t
records	ɹ ɪ k ɔ ɹ d s
recovers	ɹ ɪ k ɑ v ɝ z
recovery	ɹ ɪ k ʌ v ɝ i
recur	ɹ ɪ k ɝ
red	ɹ ɛ t
red	ɹ æ d
reda's	ɹ i d ə s
redacted	ɹ ɪ d æ k t ɪ d
redeemed	ɹ i d i m d
redemption	ɹ i d ɛ m p ʃ ə n
redevelopment	ɹ i d ɪ v ɛ l ə p m ə n t
redo	ɹ i d u
reduced	ɹ ɪ d u s d
reduces	ɹ ɪ d u s ɪ s
reductions	ɹ ɪ d ʌ k ʃ ə n z
redundant	ɹ i d ʌ n d ə n t
reefs	ɹ i v z
reel	ɹ ɪ l
reelection	ɹ i ɪ l ɛ k s ə n
reeling	ɹ ɪ l ɪ ŋ
rees	ɹ i s
reestablished	ɹ i i s t æ b l ɪ ʃ t
reestablishing	ɹ i i s t æ b l ɪ ʃ ɪ ŋ
reference	ɹ ɛ f ɝ ə n s
referenced	ɹ ɛ f ɝ ə n s t
references	ɹ ɛ f ɹ ə n s ɪ z
refined	ɹ i f aɪ n d
refinery	ɹ i f aɪ n ɝ i
refining	ɹ ɪ v aɪ n ɪ ŋ
refit	ɹ ɪ f ɪ t
reflections	ɹ ɪ f l ɛ k ʃ ə n s
reflects	ɹ ɪ f l ɛ k s
reflex	ɹ ɪ f l ɛ k s
reflexes	ɹ ɪ f l ɛ k s ə s
reflexes	ɹ ɪ f l ɛ k s ə z
reformation	ɹ i f ɔ ɹ m eɪ ʃ ə n
reformed	ɹ i f ɔ ɹ m d
reforms	ɹ i f ɔ ɹ m z
refractories	ɹ i f ɹ æ k t ɝ i z
refrains	ɹ i f ɹ eɪ n z
refugees	ɹ ɛ f j u dʒ ɪ z
refurbishment	ɹ i f ɝ b ɪ ʃ m ə n t
reg	ɹ ɛ k
regency	ɝ ɪ dʒ ə n s i
regensburg	ɹ ɪ ɡ ə n s b ɝ ɡ
regicides	ɹ ɛ dʒ ə s aɪ t s
regime	ɹ eɪ z i m
region	ɹ ɪ dʒ ə n
region	ɝ i dʒ ə n
regional	ɹ ɪ dʒ ə n ə l
regional	ɝ ɪ dʒ ə n ə l
regional	ɝ i dʒ ə n ə l
regions	ɹ i dʒ ə n s
regular	ɹ ɛ k l ɝ
regular	ɹ ɛ ɡ l ɝ
rehab	ɹ i h æ p
rehearsal	ɹ ɪ h ɝ s ə l
rehearsals	ɹ ɪ h ɝ s ə l z
rehearsing	ɹ ɪ h ɝ s ɪ ŋ
reis	ɹ i s
rejections	ɹ ɪ dʒ ɛ k ʃ ə n z
rejoice	ɹ i dʒ ɔɪ s
rejoicing	ɹ i dʒ ɔɪ s ɪ ŋ
relations	ɹ ɪ l eɪ ʃ ə n z
relatives	ɹ ɛ l ə t ɪ v s
relaxation	ɹ ɪ l æ k s eɪ ʃ ə n
release	ɹ i l i z
released	ɹ i l i s d
released	ɹ i l ɪ s t
releases	ɹ i l i s ɪ s
reliability	ɹ ɪ l aɪ ə b ɪ l ɪ t i
reliance	ɹ ɪ l aɪ ə n s
relies	ɹ i l aɪ z
reliever	ɹ ɪ l ɪ v ɝ
religious	ɹ i l ɪ dʒ ə s
religious	ɹ ɪ l i dʒ ə s
rely	ɹ ɪ l aɪ
remained	ɹ i m eɪ n d
remains	ɹ ɪ m eɪ n s
remarked	ɹ i m ɑ k t
remarque	ɹ i m ɑ ɹ k
remember	m ɛ m b ɝ
remembering	ɹ i m æ m b ɝ ɪ ŋ
reminder	ɹ ɪ m aɪ n d ɝ
reminds	ɹ i m aɪ n d s
remote	ɹ ɪ m oʊ t
removal	ɹ i m u v ə l
remover	ɹ i m u v ə
renamed	ɹ ɪ m eɪ n d
renaming	ɹ ɪ n eɪ m ɪ ŋ
renew	ɹ i n u
rennes	ɹ ɛ m
reno	ɹ ɪ n oʊ
renounce	ɹ i n aʊ n s
renowned	ɹ i n aʊ n d
rentals	ɹ ɛ n d ə l z
rentals	ɹ ɛ n t ə l s
renters	ɹ ɛ n d ɝ z
renton	ɹ ɛ n d ə n
renzo	ɹ ɛ n s oʊ
reorder	ɹ i ɔ ɹ d ɝ
repairs	ɹ i p ɛ ɹ z
repeatedly	ɹ ɪ p i d ɪ d l ɪ
repeatedly	ɹ ɪ p ɪ d ɪ d l i
repel	ɹ i p ɛ l
replace	ɹ i p l eɪ s
replaced	ɹ i p l eɪ s t
replacement	ɹ i p l eɪ s m ə n t
replacing	ɹ i p l eɪ s ɪ ŋ
replicas	ɹ ɛ p l ɪ k ə s
report	ɹ ɪ b ɔ t
reposed	ɹ ɪ p oʊ z d
represent	ɹ ɛ p ɹ i z ɛ n t
representative	ɹ ɛ p ɹ ə z ɛ n t ə t ɪ v
representative	ɹ ɛ p ɹ i z ɛ n ə t ɪ v
representatives	ɹ ɛ p ɹ ə z ɛ n t ə t ɪ v z
represented	ɹ ɛ p ɹ ə z ɛ n t ə d
represented	ɹ ɛ p ɹ ə z ɛ n ə d
represented	ɹ ɛ p ɹ i z ɛ n t ɪ d
represented	ɹ ɛ p ɹ ə s ɛ n t ɪ d
represents	ɹ ɛ p ɹ i z ɛ n t s
represents	ɹ ɛ p ɹ ə s ɛ n t s
repression	ɹ ɪ p ɹ ɛ ʃ ə n
republic	ɹ i b ʌ b l ɪ k
republicans	ɹ i p ʌ b l ɪ k ə n s
repudiate	ɹ ɪ p j u d i eɪ t
requests	ɹ ɪ k w ɛ s
require	ɹ i k w aɪ ɝ
require	ɹ ɪ k w aɪ ɹ
requirements	ɹ i k w aɪ ɝ m ə n t s
requiring	ɹ i k w aɪ ɹ ɪ ŋ
requiring	ɹ ɪ k w aɪ ɹ ɪ ŋ
research	ɹ ɪ s ɝ tʃ
researchers	ɹ i s ɝ tʃ ɝ s
resellers	ɹ i s ɛ l ɝ z
resembles	ɹ ɪ s ɛ m b ə l z
resembling	ɹ i z ɛ m b l ɪ ŋ
resembling	ɹ ɪ s ɛ m b l ɪ ŋ
resentment	ɹ i s ɛ n m ə n t
reserve	ɹ ɪ s ɝ v
reside	ɹ ɪ s aɪ d
resided	ɹ ɪ s aɪ d ɪ d
residence	ɹ ɛ s ɪ d ə n s
residences	ɹ ɛ s ɪ d ə n s ɪ z
residences	ɹ ɛ z ɪ d ə n s ɪ s
resident	ɹ ɛ s ɪ d ə n t
residential	ɹ ɛ z ɪ d ɛ n ʃ ə l
residential	ɹ ɛ s ɪ d ɛ n ʃ ə l
residents	ɹ ɛ s ɪ d ə n t s
resides	ɹ ɪ s aɪ d z
resides	ɹ ɪ s aɪ t z
residing	ɹ ɪ s aɪ d ɪ ŋ
residing	ɹ i s aɪ d ɪ ŋ
resignation	ɹ ɛ s ɪ ɡ n eɪ ʃ ə n
resigned	ɹ i s aɪ n d
resigned	ɹ i z aɪ n d
resigning	ɹ i s aɪ n ɪ ŋ
resist	ɹ ɪ s ɪ s t
resistance	ɹ ɪ z ɪ s t ə n z
resistance	ɹ ɪ s ɪ s t ə n s
resistant	ɹ ɪ s ɪ s t ə n t
resisted	ɹ ɪ z ɪ s t ə d
resolution	ɹ ɛ s ə l u ʃ ə n
resolutions	ɹ ɛ s ə l u ʃ ə n z
resolve	ɹ i s ɑ l v
resonance	ɹ ɛ s ə n ə n s
resort	ɹ i z ɔ ɹ t
resort	ɹ ɪ z ɔ ɹ t
resorts	ɹ i z ɔ ɹ t s
responder	ɹ ɪ s p ɑ n d ɝ
responders	ɹ ɪ s p ɑ n d ɝ z
restaurant	ɹ ɛ s t ɹ ɑ n t
restore	ɹ i s t ɔ ɹ
restore	ɹ i s t ɔ
restored	ɹ i s t ɔ ɹ d
restored	ɹ i s t ɔ d
restrained	ɹ ɪ s t ɹ eɪ n d
restricted	ɹ i s t ɹ ɪ k t ɪ d
restricts	ɹ ɪ s t ɹ ɪ k t s
restrooms	ɹ ɛ s t ɹ u m z
result	ɹ i s ʌ l t
resulted	ɹ i z ɑ l t ɪ d
resulted	ɹ i s ʌ l t ə d
resulting	ɹ i s ʌ l t ɪ ŋ
resume	ɹ ɪ s u m
resuming	ɹ i z u m ɪ ŋ
resurface	ɹ i s ɝ f ə s
retail	ɹ i d eɪ l
retailers	ɹ i d eɪ l ɝ z
retained	ɹ i d eɪ n d
retained	ɹ ɪ t eɪ n d
retardant	ɹ i t ɑ ɹ d ə n t
retelling	ɹ i d ɛ l ɪ ŋ
reti	ɹ ɛ t i
retirement	ɹ i t aɪ ɝ m ə n t
retiring	ɹ i t aɪ ɝ ɪ ŋ
retook	ɹ i t u k
retort	ɹ i d ɔ t
retracting	ɹ ɪ t ɹ æ k t ɪ ŋ
returned	ɹ i d ɝ n d
returning	ɹ i d ɝ n ɪ ŋ
returns	ɹ i d ɝ n z
revalued	ɹ i v æ l j u d
reveal	ɹ ɪ v i l
revealed	ɹ ɪ v i l d
revealing	ɹ ɪ v i l ɪ ŋ
reveals	ɹ ɪ v i l z
revenue	ɹ æ v ə n u
reverse	ɹ ɪ v ɝ z
reversed	ɹ i v ɝ s t
reverses	ɹ ɪ v ɝ s ɪ s
reviews	ɹ i v j u s
reviews	ɹ ɪ v j u z
revision	ɹ ɪ v ɪ ʒ ə n
revisions	ɹ ɪ v ɪ ʒ ə n z
revival	ɹ ɪ v aɪ v ə l
revue	ɹ i v j u
rhett	ɹ ɛ d
rhyme	ɹ aɪ n
rhys	ɹ ɪ s
ribbons	ɹ ɪ p ə n z
rich	ɝ i tʃ
richards	ɹ ɪ tʃ ɝ t s
richardson	ɹ ɪ tʃ ɝ t s ə n
ride	ɹ aɪ t
rides	ɹ aɪ t s
ridge	ɹ i dʒ
riding	ɹ aɪ t ɪ ŋ
ridley	ɹ ɪ t l i
ried	ɹ i d
right	ɹ aɪ d
rights	ɹ aɪ t z
rights	ɹ aɪ d z
rigid	ɹ ɪ dʒ ɪ t
rim	ɹ i m
rim	ɹ ɪ n
rime	ɹ aɪ n
ring	ɹ ɪ n
riquet's	ɹ ɪ ɡ ɛ t s
rise	ɹ aɪ s
rises	ɹ aɪ s ɪ z
rising	ɹ aɪ s ɪ ŋ
ritchie	ɹ i tʃ i
river	ɹ i v ɝ
river	ɹ i v ə
river's	ɹ ɪ v ɝ s
river's	ɹ i v ɝ s
riverine	ɹ ɪ v ɝ ɪ n
rivers	ɹ ɪ v ɝ s
rivers	ɹ i v ɝ z
road	ɝ oʊ d
robbed	ɹ ɑ p d
robert	ɹ ɑ b ɝ d
roberts	ɹ ɑ b ɝ d s
roblin	ɹ ɑ b l ɪ n
rode	ɹ oʊ t
rogers	ɹ ɑ dʒ ɝ s
rome	ɹ oʊ n
rookie	ɹ u k i
rooms	ɹ u n z
roosters	ɹ u s t ɝ s
root	ɹ u d
rootkit	ɹ u t k ɪ t
roots	ɹ u t z
roped	ɹ oʊ p d
ropes	ɹ oʊ b z
rosa	ɹ oʊ s ə
rosaleen	ɹ oʊ s ə l i n
rose	ɹ oʊ s
rosedale	ɹ oʊ s d eɪ l
rosen	ɹ oʊ s ə n
roses	ɹ oʊ z ɪ s
rosie	ɝ oʊ s i
rosie's	ɹ oʊ z ɪ z
rosita	ɹ oʊ s ɪ d ə
roster	ɹ ɔ s t ɝ
rotates	ɹ oʊ t eɪ d z
round	ɝ aʊ n d
rounds	ɹ aʊ n d s
route	ɹ u d
routers	ɹ u t ɝ z
routes	ɹ u d z
rowing	ɹ oʊ ɪ n
roxy	ɹ ʌ k s i
roxy	ɹ ʌ k s ɪ
rubber	ɹ ɑ b ɝ
rudimentary	ɹ u d ə m ɛ n t ɹ i
rudolf	ɹ u d ɑ l f
rufinus	ɹ u f ɪ n ə s
rulings	ɹ u l ɪ ŋ s
runner	ɹ ɑ n ɝ
runoff	ɹ ʌ n ɔ f
runs	ɹ ʌ n s
ruptured	ɹ ʌ b tʃ ɝ d
rural	ɹ u ɹ ə l
rush	ɹ ʌ s
rushing	ɹ ʌ ʃ ɪ n
russell	ɹ ʌ ʃ ə l
rutherford	ɹ ʌ ð ɝ f ɝ d
ryde	ɹ aɪ t
sacked	s æ ɡ d
sacramento	s æ k ɹ ə m ɛ n d oʊ
saddle	s ɛ d ə l
sahlin	ʃ ɑ l i n
said	s ɛ t
said	s eɪ t
sailors	s eɪ l ɝ s
salem	s eɪ l ə n
salesman	s eɪ l s m ə n
sam	s æ n
same	s eɪ n
sami	s æ m ɪ
sampras	s æ m b ɹ ə s
samson	s æ m z ə n
samsung	s æ m s ə n
sandra's	s æ n d ɹ ə s
sandwich	s æ n w ɪ tʃ
sandwiched	s æ n w ɪ tʃ t
sanko	s æ n k oʊ
santa	s æ n d ə
santos	s æ n t oʊ z
sat	s ɛ t
satellites	s ɛ t ə l aɪ t s
sault	s ɔ l d
save	s eɪ f
sawmill	s ɔ m i l
saxophonist	s ɛ k s ɑ f ə n ɪ s t
says	s i z
scarborough	s k ɑ ɹ b ɹ oʊ
scarecrow	s k ɛ ɹ k ɹ oʊ
scene	s i m
scene	s ɪ n
scenes	s i n s
scenes	s ɪ n z
scenic	s ɪ n ɪ k
scheme	s k ɪ n
schenker	ʃ æ ŋ k ɝ
schizophrenia	s k ɪ s ə f ɹ i n i ə
schools	s k u l s
sciences	s aɪ ə n s ɪ s
scores	s k ɔ ɹ s
scores	s k ɔ s
scott	s k ɑ d
scottish	s k ɑ t ɪ s
scotty	s k ɑ d i
scouts	s k aʊ d z
scrapped	s k ɹ æ b d
screaming	s k ɹ i m ɪ n
screen	s k ɹ i m
scrim	s k ɹ i m
scripted	s k ɹ ɪ p t ɪ d
scripts	s k ɹ ɪ p s
seafood	s i f ʊ d
seam	s i n
sears	s ɪ ɹ s
season	s i s ə n
season	s ɪ z ə n
season	s ɪ s ə n
season	s ɪ s ə m
seasonal	s ɪ z ə n ə l
seasons	ʃ i s ə n s
seasons	s i z ə n s
seasons	s i s ə n z
seat	s i d
seat	s ɪ t
seat	s ɪ d
seaton	s i d ə n
seats	s i d z
seats	s ɪ t s
seats	s i d s
seattle	s i æ d ə l
seclusion	s ɪ k l u ʃ ə n
seconds	s ɛ k ə n s
secret	s i k ɹ ɪ d
secretly	s i k ɹ ɪ d l i
sections	s ɛ k ʃ ə n s
sector	s ɛ k d ɝ
see	ʃ i
see	s ɪ
seeding	s i t ɪ ŋ
seeds	s i t s
seems	s ɪ n z
seen	s i m
seen	s ɪ ŋ
seized	s i z t
seizure	s i z ɝ
seizures	s i z ɝ z
selections	s ə l ɛ k ʃ ə n s
semantic	s ɪ m ɛ n t ɪ k
semblance	s ɛ m p l ə n z
semitic	s æ m ɪ t ɪ k
senate	s æ n ə t
send	s ɛ n t
sends	s ɛ n t s
senses	s ɛ n s ɪ s
sent	s ɛ n d
sentence	s ɛ n d ə n s
sentences	s ɛ n t ə n s ɪ s
sentencing	s ɛ n d ə n s ɪ ŋ
separated	s ɛ p ɹ eɪ t ɪ d
separating	s ɛ p ɹ eɪ t ɪ ŋ
serb	s ɝ p
sergeant	s ʌ dʒ ə n t
serial	s i ɹ i ə l
serious	s i ɹ i ə s
sermons	s ɝ m ə n s
serpent	s ɝ p ə n d
servers	s ɝ v ɝ s
service	s ɝ v i s
service	s ɝ v ɪ z
service	s ɝ v ə z
services	s ɝ v ə s ə s
servilia	s ɝ v ɪ l i ə
seton	s ɪ t ə n
settler	s ɛ d l ə
settlers	s ɛ t l ɝ s
seventeen	s ɛ v ə n d i n
several	s æ v ɹ ə l
severn	s ɛ v ə n
sexes	s ɛ k s ɪ s
shadows	ʃ ɛ d oʊ z
shahs	ʃ ɑ s
shakespeare	ʃ eɪ k s p ɪ ɹ
shakespeare's	ʃ eɪ k s p ɪ ɹ z
shall	s æ l
shambles	ʃ æ m b ə l s
shanghai	ʃ æ n h aɪ
shaped	ʃ eɪ p d
share	ʃ æ ɹ
share	s ɛ ɹ
shared	ʃ æ d
shares	ʃ æ ɹ z
shaw's	ʃ ɔ s
shawnee	ʃ ɔ n ɪ
she	s i
she	ʃ ɪ
she	s ɪ
shee	s i
sheen	ʃ ɪ n
sheet	ʃ i d
sheets	ʃ i d z
sheffield	ʃ æ f i l d
sheikh	ʃ ɪ k
shellac	s ɛ l æ k
shelled	ʃ ɛ l t
shelley's	ʃ ɛ l ɪ z
shield	s i l d
shimizu	ʃ ɪ m ɪ z u
shinano	ʃ i n ɑ n oʊ
ship	ʃ i p
ships	ʃ i p s
shire	ʃ aɪ ɝ
shocked	ʃ ɑ k d
shoes	ʃ u s
shooter	ʃ u d ɝ
shooting	ʃ u d ɪ ŋ
shops	s ɑ p s
shops	s ɑ b z
shores	ʃ ɔ s
shortages	ʃ ɔ ɹ t ɪ dʒ ɪ s
shortfalls	ʃ ɔ ɹ t f ɔ l z
shot	ʃ ʌ t
shot	ʃ ɑ d
should	ʃ ʊ t
shoulders	ʃ oʊ l d ɝ s
shovel	ʃ ɑ v ə l
show	s oʊ
shows	ʃ oʊ s
shows	s oʊ z
shrine	s ɹ aɪ n
shrines	s ɹ aɪ n z
shukri	ʃ u k ɹ i
shuts	ʃ ɑ t s
siblings	s ɪ b l ɪ ŋ s
siblings	s ɪ b l ɪ n z
sicily	s ɪ ʃ ɪ l i
sid	s ɪ t
side	s aɪ t
sides	s aɪ t s
sides	s aɪ t z
sides	s aɪ d s
sidney	s ɪ t n ɪ
siebel	z i b ə l
sight	s aɪ d
sights	s aɪ t z
sightseeing	s aɪ d s i ɪ ŋ
sigismund	s ɪ ɡ ɪ s m ə n d
signals	s ɪ ɡ n ə l s
signs	s aɪ n s
sikhs	s ɪ k s
simmons	s i m ə n z
simon	s i m ə n
simonetta	s ɪ m ə n ɛ t ə
simple	s ɪ m b ə l
simplifications	s ɪ m p l ə f ə k eɪ ʃ ə n s
since	s i n z
since	s i n s
sindhi	s ɪ n t i
singapore	s ɪ ŋ ə p ɔ ɹ
singh	s ɪ n
sings	s ɪ ŋ s
sisal	s ɪ s ə l
sisson	s ɪ ʃ ə n
sister's	s ɪ s t ɝ s
sisters	s ɪ s t ə s
sisters	s ɪ ʃ t ɝ s
sit	ʃ ɪ d
sitcom	s ɪ t k ɑ n
site	s aɪ d
sited	s aɪ d ɪ d
sites	s aɪ d z
sites	s aɪ t z
sivas	s ɪ v ə s
size	s aɪ s
sizes	s aɪ z ɪ s
sketches	s k æ tʃ ɪ z
skid	s k ɪ t
skiffle	s k i f ə l
skills	s k ɪ l s
skin	s k i m
skis	s k ɪ z
skits	s k ɪ d s
slabs	s l æ p s
slang	s l æ n
slant	s l æ n d
slayer	s l eɪ ɹ
sledge	s l ɛ d z
sleds	s l ɛ t s
sleepin	s l i p ɪ ŋ
slide	s l aɪ t
sliding	s l aɪ t i ŋ
slime	s l aɪ n
slip	s l i p
smaller	s m ɑ l ɝ
smooth	s m u θ
snack	s m æ k
snag	s n æ k
sneaking	s n ɪ k ɪ ŋ
snelling	s m ɛ l ɪ ŋ
snickers	s n i k ɝ z
snooker	s n u k ɝ
snoopy	s n u b i
snotty	s n ɑ d i
snub	s n ɑ p
social	ʃ oʊ ʃ ə l
socialism	s oʊ s ə l ɪ z ə m
sociology	s oʊ ʃ i ɑ l ə dʒ i
software	s ɔ f t w ɛ
soldiers	s oʊ l dʒ ɝ s
soldiers	ʃ oʊ l dʒ ɝ z
solos	s oʊ l oʊ s
solutions	s ə l u ʃ ə n s
some	s ʌ n
something	s ʌ n θ ɪ ŋ
somme	s ʌ m
son	ʃ ə n
song	s ɔ n
song	s ʌ n
song	s ɑ n
songs	s ɔ n z
songs	s ɔ ŋ s
sons	s ʌ n s
soon	z u n
source	s ɔ z
sources	s ɔ ɹ s ə s
sources	s ɔ ɹ s ɪ s
southern	s ɑ ð ə n
southwest	s aʊ θ w ɛ ʃ t
spaces	s p eɪ s ɪ s
spanish	s p æ n ɪ z
spanish	s p æ n ɪ s
spasmodic	s p æ s m ɑ d ɪ k
speakers	s p i k ɝ s
speaks	s p ɪ k s
specializes	s p ɛ ʃ ə l aɪ z ɪ s
specializing	s p ɛ s ə l aɪ z ɪ ŋ
specializing	s p ɛ ʃ ə l aɪ s ɪ ŋ
species	s p i ʃ ɪ z
species	s p i s i s
species	s p i s ɪ s
species	s p i s ɪ z
species	s p i s i ʃ
species	s p i ʃ i s
species	s p ɪ s ɪ s
species	s p ɪ ʃ i z
species	s p i z i z
spectators	s p ɛ k t eɪ t ɝ s
speech	s p i t s
speed	s p ɪ d
speeds	s p ɪ d z
spells	s p ɛ l s
spend	s p ɛ n t
spent	s p ɛ n d
spice	s p aɪ z
spielberg	s p ɪ l b ɝ ɡ
spitzer	s p ɪ t s ɝ
splashes	s p l æ ʃ ɪ s
splinters	s p l ɪ n t ɝ s
split	s p l ɪ d
sponge	s p ɑ n dʒ
spoofed	s p u f d
sports	s p ɔ ɹ t z
sprinklers	s p ɹ ɪ ŋ ɡ l ɝ s
sta	s t ɑ
stadion	s t eɪ d i ə m
staff	s t ʌ f
stages	s t eɪ dʒ ɪ s
staircase	s t æ ɹ k eɪ s
stamped	s t æ m p d
stance	s t æ n z
standards	s t æ n d ɝ d s
stang	s t æ n
stanley	s t æ n l ɪ
staple	s t eɪ b ə l
star	ʃ t ɑ ɹ
starred	s t ɑ ɹ t
stars	s t ɑ s
stars	s t ɑ ɹ s
start	ʃ t ɑ ɹ t
started	s t ɑ d ɪ d
state	s t eɪ d
state	s d eɪ d
state	ʃ t eɪ t
stated	s t eɪ d ɪ d
states	s t eɪ d s
states	s t eɪ t z
static	s t ɛ t ɪ k
station	ʃ t eɪ ʃ ə n
stations	s t eɪ ʃ ə n s
staves	s t eɪ f s
stayed	s t eɪ t
stays	s t eɪ s
ste	s d
steadily	s t æ d ɪ l ɪ
steeplechase	s t i p ə l tʃ eɪ z
stent	s t æ n t
step	s t æ p
stephen	s t i f ə n
stephens	s t i f ə n z
stewart	s t u ɝ d
still	s t i l
stillwater	s t ɪ l w ɔ d ɝ
stone	s d oʊ n
stood	s t u d
stories	s t ɔ ɹ i s
stories	z t ɔ ɹ i z
strait	ʃ t ɹ eɪ d
strassman	s t ɹ æ s m ə n
strategies	s t ɹ æ t ə dʒ i s
strategies	s t ɹ æ t ə dʒ ɪ z
street	s t ɹ ɪ t
street	s t ɹ i d
strength	s t ɹ ɛ n θ
strengthened	s t ɹ ɛ n θ ə n d
stripes	s t ɹ aɪ b z
stuart	s t u ɝ d
stubbs	s t ɑ p s
studied	s t ʌ d ɪ d
studied	s t ɑ d ɪ d
studied	s t ɑ d i d
studies	s t ʌ d ɪ z
studies	s t ʌ d i s
studios	s t u d i oʊ s
study	s t ɑ d i
stupa	s t u b ɑ
styles	s t aɪ l s
submarine	s ɑ b m ɝ i n
subsequent	s ʌ b s i k w ə n t
subsequently	s ʌ b s i k w ə n t l i
subspecies	s ʌ b s p i s ɪ z
subspecies	s ʌ b s p i s i s
subspecies	s ʌ b s p i z ɪ z
substance	s ɑ b s t ə n s
substances	s ʌ p s t ə n s ɪ z
substantial	s ə p s t æ n ʃ ə l
suburbs	s ɑ b ɝ b z
succeeds	s ə k s i d s
successes	s ə k s ɛ s ɪ s
succession	s ə k s ɛ s ə n
successor	s ə k s ɛ ʃ ɝ
sued	ʃ u d
suffered	s ɑ f ɝ d
sugar	s u ɡ ɝ
sugar	ʃ u ɡ ɝ
suit	s u d
summarises	s ɑ m ɝ aɪ z ɪ z
summit	s ɑ m ɪ t
sundays	s ʌ n d eɪ s
superintendent	s u p ɝ ə n d ɛ n d ə n t
supermarket	s u p ɝ m ɑ ɹ k ə t
superstar	s u p ɝ s t ɑ ɹ
superstars	s u p ɝ s t ɑ ɹ z
support	s ə p ɔ d
supporting	s ə p ɔ t ɪ n
supportive	s ə p ɔ t i v
suppose	s ə p oʊ s
supposed	s ə p oʊ s d
supposed	s ə p oʊ s t
supposedly	s ə p oʊ s ə d l i
surfaces	s ɝ f ə s ə s
surfaces	s ɝ f ə z ɪ z
surfs	s ɝ v z
surgeons	s ɝ dʒ ə n s
surrey	s ɑ ɹ i
surroundings	s ɝ aʊ n d ɪ ŋ s
surtees	s ɝ d i z
surveys	s ɝ v eɪ s
susan	s u s ə n
susanna	s u s æ n ə
susie	s u s i
suzuki	s ə s u k i
swam	s w æ n
swazi	s w ɑ ʃ i
swedish	s w ɪ d ɪ ʃ
swedish	s w i d ɪ s
swirling	s w ɝ l i ŋ
swiss	s w i s
switch	s w i t s
sydney	s ɪ t n i
symphonie	s ɪ n f ə n i
symphonies	s ɪ m f ə n i s
synge	s ɪ n
syntheses	s ɪ n θ ə s ɪ s
synthetic	s ɪ m θ ɛ t ɪ k
system	s ɪ s t ə n
system's	s ɪ s t ə m s
systems	s ɪ s t ə m s
systems	s ɪ s t ə n z
systems	s ɪ s t ə n s
t	d
t	d i
ta	d ɑ
tab	d æ p
table	d eɪ b ə l
tables	d eɪ b ə l z
tacitus	d æ s i t ə z
tact	d æ ɡ d
tactic	d æ k t ɪ k
tad	d æ d
taft	d æ f t
tag	t æ k
tag	d æ ɡ
taggart	t æ ɡ ɝ d
tai	d aɪ
tail	d eɪ l
tailored	d eɪ l ɝ d
tak	d æ k
take	d eɪ k
taken	d eɪ k ə n
takes	d eɪ k s
taking	d eɪ k ɪ ŋ
taking	t eɪ k ɪ n
talent	d æ l ə n t
talents	d æ l ə n t s
tales	d eɪ l z
talk	d ɔ k
talk	d ɑ k
talked	t ɔ k d
talked	d ɔ k t
talking	d ɔ k ɪ ŋ
talks	d ɔ k s
talks	d ɔ ɡ s
tall	d ɔ l
tallinn	t ɛ l ɪ n
tallis	d æ l ɪ s
tallon	d æ l ə n
tally	d æ l i
tally	t ɛ l i
talons	d æ l ə n z
tambo	d æ m b oʊ
tambourine	d æ m b ɝ i n
tame	d eɪ m
tamed	d eɪ m d
tammy	d æ m i
tampa	d æ m p ə
tampa	t æ m b ə
tampering	d æ m p ɝ ɪ ŋ
tamworth	d æ m w ɝ θ
tan	d æ n
tandem	d æ n d ə m
tandem	d æ n d ə n
tang	d æ ŋ
tanks	d æ ŋ k s
tanner	d ɛ n ɝ
tannic	d æ n ɪ k
tanning	t ɛ n ɪ ŋ
tanning	d æ n ɪ ŋ
tantalum	d æ n t ə l ə m
tantrums	d æ n t ɹ ə m z
tao	t aʊ
taos	d aʊ s
tap	d æ p
tape	d eɪ b
tapers	d eɪ p ɝ z
taping	d eɪ p ɪ ŋ
tar	d ɑ
tar	d ɑ ɹ
taranto	d ɝ æ n t oʊ
target	d ɑ ɹ ɡ ə t
target	d ɑ k ɪ t
targets	d ɑ ɹ ɡ ə t s
tart	d ɑ t
task	d æ s k
tasman	d æ s m ə n
tasmania	t æ s m eɪ n i ə
tasmania	d æ s m eɪ n i ə
tatar	d æ d ɝ
tate	d eɪ t
taught	d ɔ t
taught	t ɔ d
taunton	d ɔ n t ə n
tax	d æ k s
tax	d ɛ k s
taxation	t æ k z eɪ ʃ ə n
taxes	t æ k s ə s
taxes	t æ k s ɪ s
taxes	d æ k s ə s
taxi	d æ k s i
taxi	t æ k s ɪ
taxis	t ɛ k s ɪ s
taxis	t æ k s ɪ z
taylor	d eɪ l ɝ
taylor's	d eɪ l ɝ z
taz	d æ z
tea	d i
teacher	d i tʃ ə
teachers	t i tʃ ɝ s
teachers	d i tʃ ɝ z
teaching	d i tʃ ɪ ŋ
team	d i m
team	t ɪ m
team	t i n
team	t ɪ n
team	d ɪ m
team's	d i m z
teams	d i m z
teams	t ɪ m z
teams	d i n z
teams	d ɪ m z
tear	t ɛ ɹ
tearing	d ɪ ɹ ɪ ŋ
teas	d i s
teased	t ɪ s t
teases	d i z ɪ s
teatro	d i d ɹ oʊ
tech	t æ k
tech	d ɛ k
technical	t ɛ k n i k ə l
technique	t ɛ k n ɪ k
techniques	t ɛ k n ɪ k s
technologies	t ɛ k n ɑ l ə dʒ ɪ s
technologies	t ɛ k n ɑ l ə dʒ i s
ted	d ɛ d
ted	d æ t
teddy	d ɛ d i
tedium	t ɪ d i ə m
teen	t ɪ n
teen	t i m
teen	d i n
teenage	d i n ɪ dʒ
teenager	t i m eɪ dʒ ɝ
teenager	d i n eɪ dʒ ɝ
teenagers	d i m eɪ dʒ ɝ z
tel	d ɛ l
telegraph	d ɛ l ə ɡ ɹ æ f
telegrapher	d ɛ l ə ɡ ɹ æ f ɝ
television	d ɛ l ə v ɪ ʒ ə n
television	t ɛ l ə v ɪ ʃ ə n
television	d ɛ l ɪ v ɪ ʃ ə n
television	t ɛ l ə v ɪ z ə n
television	d ɛ l ə v ɪ ʃ ə n
tell	d ɛ l
telling	d ɛ l ɪ ŋ
tells	t ɛ l s
tells	d ɛ l z
tells	t æ l s
temperature	t ɛ m p ɝ ə tʃ ɝ
temple	t ɛ m b ə l
temple	d ɛ m p ə l
temples	d ɛ m p ə l z
tempo	d ɛ m b oʊ
temporarily	t ɛ m p ɹ ɛ ɹ ə l i
ten	d ɛ n
ten	t æ n
tenby	d ɛ n b i
tend	d ɛ n d
tendencies	t ɛ n d ə n s ɪ z
tender	d ɛ n d ɝ
tender	d æ n d ə
tendered	t ɛ n t ɝ d
tenison's	d ɛ n ɪ s ə n z
tennant	d ɛ n ə n t
tennessee	d ɛ n ə s i
tennessee	d æ n ə s i
tennis	d ɛ n ɪ s
tennis	d ɛ n ə s
tennyson's	d ɛ n ɪ s ə n z
tenor	d ɛ n ɝ
tense	d ɛ n s
tenses	d ɛ n s ɪ z
tension	d ɛ n ʃ ə n
tensions	d ɛ n ʃ ə n s
tensor	d ɛ n s ɝ
tensor	d æ n s ə
tent	d ɛ n t
tenth	d ɛ n θ
terence	d ɛ ɹ ə n s
term	d ɝ m
terman	d ɝ m ə n
termed	d ɝ m d
terminal	d ɝ m ə n ə l
terminology	t ɝ m ə n ɑ l ə dʒ i
terminology	d ɝ m ə n ɑ l ə dʒ i
terms	d ɝ m z
terms	t ɝ n z
terraces	d ɛ ɹ ə s ɪ s
terri	d ɛ ɹ ɪ
terror	t ɛ ɹ
teslin	t ɛ s l ɪ ŋ
test	d ɛ s t
testicular	t æ s t ɪ k j ə l ɝ
testing	d ɛ s t ɪ ŋ
testing	d ɛ s t ɪ n
tests	d ɛ s t s
tex	d ɛ k
tex	d ɛ k s
texans	t ɛ k s ə n s
texas	d ɛ k s ə s
texas	t ɛ k s ə z
texts	d ɛ k s
thanes	θ eɪ n s
that	θ æ t
that's	ð ɛ t s
thats	ð æ t s
the	ð
the	θ ə
the	θ i
the	θ ɪ
the	θ ʌ
the	ð ɑ
their	ð æ ɹ
them	ð ə n
them	ð ɛ n
themes	θ ɪ m z
then	ð æ n
theorem	θ i ɝ ə m
theorem	θ ɪ ɝ ə m
theorem	θ i ɹ ə m
theorems	θ i ɝ ə m z
there	ð ɛ
there	ð æ
there	ð æ ɹ
therefore	ð æ ɹ f ɔ ɹ
these	ð ɪ s
these	ð i s
these	ð ɪ z
these	θ i s
these	θ ɪ s
these	θ i z
thesis	θ i s ɪ z
thesis	θ ɪ s ɪ s
thesis	θ i s i s
they	θ eɪ
thickens	θ ɪ k ə n s
things	θ ɪ ŋ s
things	θ i ŋ z
things	θ ɪ n z
this	θ ɪ s
this	ð i s
this	ð i z
this	ð ɪ z
thomas	d ɑ m ə s
thompson	d ɑ m s ə n
thompson	d ɑ n s ə n
thompson's	t ɑ m s ə n s
thompson's	t ʌ m s ə n z
thomson	d ɑ m s ə n
thorington	θ ɔ ɹ ɪ ŋ t ə n
thoroughly	θ ɹ oʊ l i
those	ð oʊ s
though	θ oʊ
thousand	θ aʊ s ə n d
thousands	θ aʊ s ə n z
thrasea	θ ɹ eɪ s i ə
threads	θ ɹ ɛ t s
thus	ð ʌ z
thus	θ ʌ s
thwarted	θ w ɔ ɹ t ɪ d
tiber	d aɪ b ɝ
tibet	t ɪ b ɛ t
ticket	d ɪ k ə t
ticket	d ɪ k ɪ t
tickets	d ɪ k ə t s
tidal	t aɪ t ə l
tide	d aɪ d
tie	d aɪ
tier	d ɪ ɹ
tiffany	d ɪ f ə n i
tiger	d aɪ ɡ ɝ
tigers	d aɪ ɡ ɝ z
tile	d aɪ l
tim	d ɪ m
tim	t ɪ n
tim	t i m
timber	d ɪ m b ə
timber	d ɪ m b ɝ
time	d aɪ m
time	d aɪ n
time	t aɪ n
times	d aɪ m z
times	t aɪ m s
times	t aɪ n z
timing	d aɪ m ɪ ŋ
timing	d aɪ m ɪ n
timing	t aɪ m ɪ n
tin	d ɪ n
tina	d i n ə
tinker	d ɪ ŋ k ɝ
tiny	d aɪ n i
tipstaves	t ɪ p s t eɪ f s
tire	d aɪ ɹ
tissue	d ɪ ʃ u
titans	d aɪ t ə n z
title	d aɪ t ə l
titles	t aɪ t ə l s
titles	d aɪ t ə l z
to	d oʊ
to	d u
to	t ʊ
to	d i
to	d ɪ
to	t i
to	d ə
toads	d oʊ t s
toes	d oʊ z
toes	t oʊ s
tokens	d oʊ k ə n s
tolerance	d ɑ l ɝ ə n s
tolerances	d ɑ l ɝ ə n s ɪ z
tolga	d oʊ l ɡ ə
toll	d oʊ l
toll	d ɔ l
tom	d ɑ m
tom	t ɑ n
tom	d ɑ n
tomb	t u n
tomes	t oʊ n z
tomkins	d ɑ m k ɪ n z
tommy	d ɑ m i
tone	d oʊ n
tong	d ɔ ŋ
tong	t ɑ n
tonga	d ɑ ŋ ɡ ə
tongs	t ʌ ŋ z
tongs	d ɑ ŋ s
toni's	d oʊ n i z
tonka	t ɑ n k ə
tons	d ʌ n z
tony	d oʊ n i
too	d u
took	d ʊ k
took	t u k
took	t ʊ ɡ
tool	d u l
toomey	d u m i
top	d ɑ p
top	d ɔ p
topaz	d oʊ b æ z
topic	d ɑ b ɪ k
topics	d ɑ p ɪ k s
torey	d ɔ ɹ i
torque	d ɔ k
torsion	d ɔ ʃ ə n
tortures	d ɔ ɹ tʃ ɝ z
total	t oʊ d ə l
total	d oʊ t ə l
totally	d oʊ t ə l i
totem	d oʊ t ə m
totten	d ɑ t ə n
touch	d ʌ tʃ
touch	t ɑ tʃ
touchdown	d ʌ tʃ d aʊ n
touchdown	t ʌ tʃ t aʊ n
tour	t ɔ
tour	d ɔ ɹ
tour	d ɔ
tour	d u ɹ
touring	t u ɹ ɪ ŋ
tourists	d ʊ ɹ ɪ s t s
tournament	d ɔ n ə m ə n t
towards	t ɔ d s
tower	d aʊ ɝ
town	d aʊ n
town's	d aʊ n z
townes	d aʊ n z
towns	d aʊ n z
townsend	t aʊ n s ə n d
townsend	d aʊ n s ə n d
township	d aʊ n ʃ ɪ p
toxic	d ɑ k s ɪ k
toxicity	d ɑ k s ɪ s ə t i
toys	d ɔɪ z
trace	d ɹ eɪ s
track	d ɹ æ k
track	t ɹ æ ɡ
track	t ɹ ɛ k
tracked	d ɹ æ ɡ d
tracks	d ɹ æ k s
traction	d ɹ æ k ʃ ə n
tracy	t ɹ eɪ z i
trade	d ɹ eɪ d
traded	t ɹ eɪ t ɪ d
traditions	t ɹ ə d ɪ ʃ ə n s
traffic	d ɹ æ f ɪ k
trail	d ɹ eɪ l
trails	t ɹ eɪ l s
train	d ɹ eɪ n
trained	d ɹ eɪ n d
trainee	t ɹ eɪ n ɪ
trainee	d ɹ eɪ n i
training	t ɹ eɪ n ɪ n
trains	t ɹ eɪ n s
trains	d ɹ eɪ n z
trait	d ɹ eɪ d
traits	t ɹ eɪ d s
tran	d ɹ æ n
transaction	t ɹ æ n s æ k ʃ ə n
transamerica	t ɹ æ n s ə m ɛ ɹ ɪ k ə
transfers	t ɹ æ n s f ɝ s
transistor	t ɹ æ n s ɪ s t ɝ
transit	d ɹ æ n s ɪ t
transitioning	t ɹ æ n z ɪ ʃ ə n ɪ ŋ
translatable	t ɹ æ n s l eɪ t ə b ə l
translate	t ɹ æ n s l eɪ t
translates	t ɹ æ n s l eɪ t s
translation	t ɹ æ n s l eɪ ʃ ə n
translation	d ɹ æ n s l eɪ ʃ ə n
translation	t ɹ æ n s l eɪ s ə n
translations	t ɹ æ n s l eɪ ʃ ə n z
translator	t ɹ æ n s l eɪ t ɝ
translators	t ɹ æ n s l eɪ t ɝ z
transliterated	t ɹ æ n z l ɪ t ɝ eɪ t ɪ d
transliteration	t ɹ æ n z l ɪ t ɝ eɪ ʃ ə n
transmitted	d ɹ æ n s m ɪ t ɪ d
transplantation	t ɹ æ n s p l æ n t eɪ ʃ ə n
transplants	d ɹ æ n s p l æ n t s
transponder	t ɹ æ n s p ɑ n d ɝ
transport	t ɹ æ n s p ɔ t
transportation	d ɹ æ n s p ɝ d eɪ ʃ ə n
transposing	t ɹ æ n s p oʊ s ɪ ŋ
transversal	t ɹ æ n z v ɝ s ə l
trapping	d ɹ æ p ɪ ŋ
traps	d ɹ æ p s
trashy	d ɹ æ ʃ i
travels	t ɹ ɛ v ə l z
traverse	t ɹ æ v ɝ s
traversed	t ɹ æ v ɝ s t
travis	t ɹ æ v ɪ z
trays	t ɹ eɪ s
tre	t ɹ
treasure	t ɹ ɛ ʃ ɝ
treasurer	t ɹ ɛ ʃ ɝ ɝ
treasurers	t ɹ ɛ z ɝ ɝ z
treasures	t ɹ ɛ ʃ ɝ s
treasury	t ɹ ɛ ʃ ɝ i
treated	d ɹ i t ɪ d
treatment	d ɹ i t m ə n t
treaty	t ɹ i d i
tree	d ɹ i
trees	t ɹ i s
trends	t ɹ ɛ n z
trespassing	t ɹ ɛ s p æ s ɪ ŋ
tresses	t ɹ ɛ s ɪ s
trials	t ɹ aɪ l s
tribe's	d ɹ aɪ b z
tribes	t ɹ aɪ p s
tribes	t ɹ aɪ p z
tribes	d ɹ aɪ b z
tribute	t ɹ ɪ b j u d
tricia	t ɹ ɪ ʃ ə
trick	d ɹ ɪ ɡ
tried	d ɹ aɪ d
tries	t ɹ aɪ s
trillium	t ɹ i l i ə m
trims	d ɹ ɪ m z
trine	d ɹ aɪ n
trips	d ɹ ɪ p s
triton	d ɹ aɪ t ə n
trod	d ɹ ɑ d
trombly	t ɹ ɑ m b l i
trombone	d ɹ ʌ m b oʊ n
trombone	t ɹ ʌ m b oʊ n
troops	d ɹ u p s
truck	d ɹ ʌ ɡ
truck	t ɹ ɑ k
trucks	d ɹ ʌ k s
trucks	t ɹ ʌ ɡ s
true	d ɹ u
trumbull	d ɹ ʌ m b ə l
trumpet	t ɹ ʌ m b ə t
trunk	d ɹ ʌ ŋ k
try	d ɹ aɪ
tryouts	t ɹ aɪ aʊ d z
tub	t ʌ p
tube	t u p
tuck	d ʌ k
tumors	d u m ɝ z
tumour	d u m ɝ
tumours	t u m ɝ s
tune	d u n
tunes	d u n z
tungsten	d ʌ n s t ə n
tungsten	d ʌ ŋ s t ə n
tunnel	d ʌ n ə l
tunnels	t ʌ n ə l s
tupper	t ɑ p ɝ
turbo	d ɝ b oʊ
turkey	d ɝ k i
turkey's	t ɝ k i s
turn	d ɝ n
turn	t ɝ m
turndown	d ɝ n d aʊ n
turned	d ɝ n d
turner	d ɝ n ɝ
turning	d ɝ n ɪ ŋ
turnpike	d ɝ n p aɪ k
turns	t ɝ m z
turton	d ɝ t ə n
tuscany	d ʌ s k ə n i
tusk	d ʌ s k
tusker	d ʌ s k ɝ
tute	t u d
tutsis	d u t s i z
twain	d w eɪ n
twenties	t w ɛ n t i s
twice	t w aɪ z
two	d u
tye	d aɪ
type	d aɪ p
types	d aɪ p s
types	t aɪ p z
typhoon	d aɪ f u n
typical	d ɪ p ɪ k ə l
typo	d aɪ b oʊ
tyres	d aɪ ɝ z
tyson's	d aɪ s ə n z
umbrellas	ə m b ɹ ɛ l ə z
unattainable	ʌ n ə d eɪ n ə b ə l
unchecked	ə n tʃ ɛ k d
uncles	ɑ ŋ k ə l z
under	ɑ n d ɝ
under	ʌ n t ɝ
undertake	ʌ n d ɝ d eɪ k
undertook	ʌ n d ɝ t u k
underwent	ɑ n d ɝ w ɛ n t
undeserved	ʌ n d ɪ s ɝ v d
undutiful	ə n d u t ɪ f ə l
uniforms	j u n ə f ɔ ɹ m s
unique	j u n ɪ k
uniquely	j u n ɪ k l i
universe	j u n ə f ɝ s
universities	j u n ə v ɝ s ə t ɪ s
unleashed	ə n l ɪ ʃ t
unreleased	ʌ n ɹ i l i s t
unreleased	ə n ɹ i l i s t
unscripted	ə n s k ɹ ɪ p t ɪ d
until	ə n d ɪ l
until	ʌ n d ɪ l
unusable	ə n j u ʒ ə b ə l
up	ɑ p
upon	ə b ɔ n
upriver	ə p ɹ ɪ v ɝ
uptick	ʌ p d ɪ k
urban	ɹ b ə n
urn	ɹ n
used	j u s t
used	j u s d
used	j u z t
useful	j u z f ə l
useless	j u z l ə s
user	j u s ɝ
user	j u s ə
users	j u s ɝ z
uses	j u z ɪ s
uses	j u s ə s
uses	j u s ɪ s
uses	j u z ə s
using	j u s ɪ ŋ
using	j u z ɪ n
using	j u s ɪ n
usual	j u z
usually	j u ʃ ə l i
usually	j u z ə l i
usually	j u ʒ u ə l i
usually	j u s ə l i
uterus	j u t ɹ ə s
valens	v æ l ə n s
valley	f ɛ l i
valley	v ɛ l i
valuable	v ɛ l j ə b ə l
values	v æ l j u s
van	v ɛ n
vanishing	v æ m ɪ ʃ ɪ n
vanity	f æ n ɪ t i
vegan	v ɪ ɡ ə n
vehicle	v ɪ h ɪ k ə l
vehicle	v i h i k ə l
velocity	f ə l ɑ s ə t i
vending	v æ n d ɪ ŋ
vendors	f ɛ n d ɝ z
venetian	f ə n i ʃ ə n
venice	f æ n ɪ z
ventures	v ɛ n tʃ ɝ s
verses	v ɝ s ɪ s
version	v ɝ ʃ ə n
version	v ɝ s ə n
version	f ɝ ʃ ə n
versions	v ɝ ʃ ə n z
victims	v ɪ k t ə m s
victorious	v ɪ k t ɔ ɹ i ə z
video	v i d i oʊ
view	f j u
views	v j u s
vigo	v i k oʊ
vila	v ɪ l ə
villagers	v ɪ l ɪ dʒ ɝ s
violators	v aɪ ə l eɪ t ɝ s
visible	v ɪ s ə b ə l
vision	v ɪ ʃ ə n
visionary	v ɪ ʃ ə n ɛ ɹ i
visions	v ɪ ʃ ə n z
visit	v ɪ s ɪ t
visited	v ɪ s ɪ t ɪ d
visitors	v ɪ z ə t ɝ s
visitors	v ɪ z ɪ t ɝ s
visual	v ɪ ʃ u ə l
visual	v ɪ ʃ ə l
vital	f aɪ t ə l
vivant	v ɪ v ɛ n t
volunteer	v ɑ l ə n t i ɹ
wafers	w eɪ f ɝ s
waits	w eɪ d s
waits	w eɪ d z
walid	w ɑ l ɪ d
walked	w ɔ k d
walker	w ɔ ɡ ɝ
walker	w ɑ k ɝ
walking	w ɔ k ɪ n
walls	w ɔ l s
walter	w ɔ l d ɝ
wandered	w ʌ n d ɝ d
wanderers	w ʌ n d ɝ ɝ z
wandering	w ʌ n d ɝ ɪ ŋ
wang	w æ n
wann	w ʌ n
warm	w ɔ n
warnings	w ɔ ɹ n ɪ n z
warriors	w ɔ ɹ i ɝ z
wars	w ɔ s
wars	w ɔ ɹ s
was	w ɑ s
was	w ɔ s
was	w ʌ s
washington	w ɑ ʃ ɪ ŋ d ə n
washington	w ɑ s ɪ ŋ t ə n
watches	w ɑ tʃ ɪ s
watching	w ɑ tʃ ɪ n
water	w ɔ d ɝ
waters	w ɔ t ɝ s
watershed	w ɔ t ɝ ʃ ɛ t
watson	w ɑ d s ə n
waves	w eɪ f s
ways	w eɪ s
we	w ɪ
weapons	w ɛ p ə n s
wears	w ɛ ɹ s
weed	w i t
weeds	w i t s
weekend	w i k æ n d
weeks	w ɪ k s
weightless	w eɪ d l ə s
weights	w eɪ t z
weird	w i ɹ d
wem	w ɛ n
went	w ɛ n d
wesleyan	w ɛ s l i ə n
what	h w ɑ t
what	w ɑ d
whatever	w ɑ t ɛ v ɝ
wheat	w ɪ t
wheat	w i d
wheeling	w ɪ l ɪ ŋ
when	w æ n
when	h w æ n
where	w ɛ ɹ
where	w æ ɹ
where	h w æ ɹ
where's	w ɛ ɹ z
wherein	w ɛ ɹ ɪ n
whereupon	w ɛ ɹ ə p ɑ n
wherever	w ɛ ɹ ɛ v ɝ
which	w ɪ t s
which	w i tʃ
whig	w ɪ k
whip	w i p
whitby	w ɪ d b i
white	h w aɪ d
whitstable	w ɪ d s t eɪ b ə l
whittier	w ɪ t ɪ ɹ
wicca	w i k ə
wide	w aɪ t
widely	w aɪ t l i
widespread	w aɪ t s p ɹ ɛ d
wife	w aɪ v
will	w i l
willesden	w ɪ l ɪ s t ə n
william	w ɪ l j ə n
willis	w ɪ l i s
windham	w ɪ n t ə m
windows	w ɪ n d oʊ s
windsor	w ɪ n s ɝ
wing	w ɪ n
wings	w ɪ ŋ s
winner	w i n ɝ
wins	w ɪ n s
winter	w ɪ n d ɝ
winters	w ɪ n t ɝ s
wire	w aɪ ɝ
wires	w aɪ ɝ z
wisdom	w ɪ s t ə m
with	w i θ
without	w ɪ θ aʊ t
wives	w aɪ v s
wolfram	w u l f ɹ ə m
woman	w u m ə n
womb	w u n
women	w u m ə n
women's	w ɪ m ə n s
wood	w ʊ t
woods	w ʊ d s
woods	w u d s
worcester	w u s t ɝ
words	w ɝ d s
words	w ɝ t z
worked	w ɝ k d
workers	w ɝ k ɝ s
working	w ɝ k ɪ n
works	w ɝ ɡ z
worms	f ɔ m z
worried	w ɝ ɪ d
would	w ʊ t
wrapped	ɹ æ p d
wrapped	ɹ æ b d
wreck	ɹ ɛ ɡ
wrestler	ɹ ɛ s l ɝ
wrestlers	ɹ ɛ s l ɝ z
wrightson	ɹ aɪ d s ə n
write	ɝ aɪ d
writer	ɹ aɪ d ɝ
writes	ɹ aɪ d z
writing	ɹ aɪ d ɪ ŋ
written	ɹ ɪ d ə n
wrote	ɹ oʊ d
x	ɛ ɡ s
xenia	s i n i ə
yard	j ɑ t
year's	j ɪ ɹ s
years	j ɪ ɹ s
years	j i ɹ z
yet	j ɛ d
yorkshire	j ɔ ɹ k ʃ ɝ
yorkshire	j ɔ ɹ k ʃ aɪ ɝ
you	j ʊ
you're	j ʊ ɹ
young	j ʌ n
younger	j ʌ ŋ ɡ ɝ
youngstown	j ʌ ŋ s t aʊ n
your	j ɹ
your	j u ɹ
yuan	j u ʌ n
z	s i
z	s
z	s ɛ t
zebra	z ɛ b ɝ ə
zeck	s ɛ k
zen	z æ n
zeppelin	s ɛ b l ɪ n
zero	z i ɹ oʊ
zinc	s ɪ ŋ k
zinn	s ɪ n
zipper	z ɪ b ɝ
zodiac	s oʊ d i æ k
zones	s oʊ n z
zoo	s u
zucchini	z u ɡ i n i
zucker	s ʌ k ɝ
