a	ʌ
a	ɛ
abelian	ə b ɪ l i ə n
abuja	ə p u dʒ ə
academy	ə k æ d ə m ɪ
accompanist	ə k ɑ m p ə n ɪ s t
acidic	ə s ɪ t ɪ k
acquire	ə k w aɪ ɹ
acquiring	ə k w aɪ ɹ ɪ ŋ
ad	æ t
adherents	æ d h ɪ ɹ ə n t s
admired	æ d m aɪ ɝ d
admires	æ d m aɪ ɝ z
adventure	ə d v ɛ n tʃ ɝ
advice	æ d v aɪ z
aero	æ ɹ oʊ
affordable	ə f ɔ ɹ t ə b ə l
africans	æ f ɹ ɪ k ə n z
afrikaans	ɑ f ɹ i k ɑ n z
afrikaners	æ f ɹ ɪ k ɑ n ɝ z
agrarian	ə k ɹ ɛ ɹ i ə n
agreed	ə k ɹ i d
aid	eɪ t
aide	eɪ t
air	æ
aircraft's	ɛ ɹ k ɹ æ f t s
akron	æ k ɹ ə m
al	ɛ l
album	æ l b ə n
albums	æ l p ə m z
alcalde	ɛ l k æ l d
aleksander	æ l ə ɡ z æ n d ɝ
alfie	ɛ l f i
algorithm	æ l ɡ ɹ ɪ ð ə m
algorithm	æ l ɡ ɝ ɪ θ ə m
alicea	ə l i s i ə
alicia's	ə l i ʃ ə z
allen	ɛ l ə n
allergies	æ l ɝ dʒ i z
alpha	ɛ l f ə
altenburg	ɔ l t ə m b ɝ ɡ
am	æ n
ambassador	æ m b æ s ə t ɝ
amber	ɛ m b ɝ
american	ə m ɛ ɹ ɪ k ə n
amiga	ə m i k ə
amphibians	æ n f ɪ b i ə n z
amsterdam	æ n s t ɝ d æ m
amtrak	æ m t ɹ æ k
amtrak's	æ m t ɹ æ k s
an	ɛ n
analyses	ə n æ l ɪ s ɪ s
anax	æ n ɛ k s
and	ə n t
and	æ n t
andretti	æ n d ɹ ɛ d i
andy	ɛ n d i
angeles	æ n dʒ ə l i z
angles	æ ŋ k ə l z
angola	æ n ɡ oʊ l ə
anime	ɛ n ə m
anna	æ m ə
anorexia	æ n ɝ æ k s i ə
another	æ n ʌ ð ɝ
antecedent	æ n t i s i d ə n t
anthem	ɛ n θ ə m
appeasement	ə p i s m ə n t
appendices	ə p ɛ n d ə s i z
arab	ɛ ɹ ə b
arabella	ɛ ɹ ə b ɛ l ə
arabesque	ɛ ɹ ə b ɛ s k
arable	ɛ ɹ ə b ə l
aragon	ɛ ɹ ə ɡ ə n
aran	ɛ ɹ ə n
aras	ɑ ɹ ə s
arctic	ɑ ɹ t ɪ k
ardra	ɑ ɹ d ɹ ə
ardsley	ɑ ɹ t s l i
are	ɹ
are	ɑ ɝ
area's	ɛ ɹ i ə z
argentinian	ɑ ɹ dʒ ə n t ɪ n i ə n
arid	æ ɹ ə d
arison	ɛ ɹ ɪ s ə n
aristocrats	ɹ ɪ s t ə k ɹ æ t s
aristophanic	ɹ ɪ s t ə f æ n ɪ k
arkose	ɑ ɹ k oʊ z
arman	ɑ ɹ m ə n
armas	ɑ ɹ m ə s
arnhem	ɑ ɹ n h æ m
arnie	ɑ ɹ n i
aroma	ɹ oʊ m ə
aromatics	æ ɹ ə m æ t ɪ k s
around	ɹ aʊ n d
arousal	ɹ aʊ z ə l
array	ɹ eɪ
arrays	ɹ eɪ z
arrives	ɹ aɪ v z
arrow	ɛ ɹ oʊ
arrowhead	ɛ ɹ oʊ h ɛ d
arruda	ɑ ɹ u d ə
art	ɑ ɹ d
arthropods	ɑ ɹ θ ɹ ə p ɑ d z
artifacts	ɑ ɹ t ə f ɛ k t s
artist's	ɑ ɹ t ə s t s
as	ə z
asbury	æ s b ɛ ɹ i
ashantis	ə ʃ ɑ n t i z
asiatic	eɪ z i æ t ɪ k
aspiring	ə s p aɪ ɝ ɪ ŋ
associated	ə s oʊ ʃ i eɪ t ə d
association	ə s oʊ s i eɪ ʃ ə n
association's	ə s oʊ s i eɪ ʃ ə n z
asteroid	æ s t ɹ ɔɪ d
asteroids	æ s t ɹ ɔɪ d z
at	æ d
atoms	æ d ə m z
attard	æ t ɑ ɹ d
atwood	æ d w ʊ d
auburn	ɔ b ɝ n
aureus	ɔ ɹ i ə s
award	ə w ɔ ɹ t
awry	ɹ aɪ
aztec	æ s t ɛ k
bacardi	b ə k ɑ ɹ d i
backpacks	b æ ɡ p æ k s
backup	b æ k ə b
bad	b æ t
bader	b æ t ɝ
bahamas	b ə h ɑ m ə s
ballet	b æ l i
ballot	b æ l ə d
bambino	b ɛ m b i n oʊ
bancroft	b æ ŋ k ɹ ɔ f t
bands	b ɛ n d z
bangladesh	b æ ŋ ɡ l ə d æ ʃ
bangladesh	b æ ŋ l ə d æ ʃ
banyan	b ɛ n j ə n
baptist	b æ p t ə s
baptistery	b æ p t ə s t ɹ i
bar	p ɑ ɹ
bar	p ɑ
barbados	b ɑ ɹ b eɪ d oʊ z
barbara	b ɑ ɹ b ɹ ə
barclay	b ɑ ɹ k l i
barclays	b ɑ ɹ k l i z
bardstown	b ɑ ɹ d z t aʊ n
barnsley	b ɑ ɹ n z l i
baroda	p ɝ oʊ d ə
barometric	b ɛ ɹ ə m ɛ t ɹ ɪ k
baronets	b ɛ ɹ ə n ə t s
baroque	p ɝ oʊ k
baroque	b ɝ oʊ ɡ
barra	b ɛ ɹ ə
barramundi	b ɛ ɹ ə m ʌ n d i
barren	b ɛ ɹ ə n
barret	b ɛ ɹ ɪ t
barrett	b ɛ ɹ ɪ t
barrington	b ɛ ɹ ɪ ŋ t ə n
barrow	b ɛ ɹ oʊ
barrows	b ɛ ɹ oʊ z
barry	b ɛ ɹ i
barty	b ɑ ɹ d i
basal	b eɪ z ə l
basil	b æ s ə l
bass	p æ s
bats	b ɛ t s
battleford	b æ d ə l f ɝ d
bayer	b eɪ ɹ
beaches	b i tʃ i z
beaches	p i tʃ ɪ z
bear	b ɛ
beastly	b ɪ s t l i
beat	p i t
beating	b i d ɪ ŋ
beatles	b i d ə l z
beatriz	b i t ɹ ɪ s
beatty	b i d i
beatty's	b i d i z
became	b i k eɪ m
beck	b æ k
become	b i k ʌ m
becomes	b i k ʌ m z
bed	b ɛ t
beddington	b ɛ t ɪ ŋ t ə n
beetles	b i d ə l z
beetling	b ɪ t ə l ɪ ŋ
before	b i f ɔ
behr	b ɛ ɹ
belarusian	b ɛ l ə ɹ u ʃ i ə n
beller	b æ l ɝ
bengal	b ɛ n ɡ ə l
bengal	b æ ŋ ɡ ə l
bengali	b ɛ n ɡ ɑ l i
bengals	b æ ŋ ɡ ə l z
berating	b ɪ ɹ eɪ d ɪ ŋ
berlin	b ɝ l i n
berson	b ɝ ʃ ə n
beta	b eɪ d ə
bets	b æ t s
better	b ɛ ɾ ɝ
betting	b ɛ d ɪ ŋ
beyond	b i ɑ n d
bianca	b i æ n k ə
bianco	b i ɑ ŋ k oʊ
bickerton	p ɪ k ɝ t ə n
bid	b ɪ t
bidders	b ɪ t ɝ z
big	b ɪ k
bigod	b ɪ k ə d
bihar	b i h ɑ ɹ
bihar	b i h ɑ
billboard's	b ɪ l b ɔ ɹ d z
billed	b ɪ l t
billed	p ɪ l d
bing	b ɪ n
bits	b ɪ d s
bitterroot	b ɪ t ɝ ɹ u t
blade	b l eɪ t
blaine	b l eɪ m
blockbuster	b l ɑ k b ʌ s t ɝ
blyth	b l aɪ θ
board	b ɔ t
boardwalks	b ɔ ɹ d w ɔ k s
boats	b oʊ d s
bob	b ʌ b
bobcats	b ɑ b k æ t s
bold	b oʊ l t
borda	b ɔ ɹ d ə
border	b ɔ ɹ t ɝ
borland's	b ɔ ɹ l ə n d z
bosnia	b ɑ z m i ə
bottrell	b ɑ t ɹ ə l
brachial	b ɹ æ k i ə l
brackets	b ɹ æ k ə t s
bradberry	b ɹ æ d b ɛ ɹ i
braid	b ɹ eɪ t
brandon	b ɹ ɛ n d ə n
brandt	b ɹ æ n t
brasserie	b ɹ æ s ɹ i
breed	b ɹ i t
bremmer	b ɹ ɛ m ɝ
breweries	b ɹ u ɝ i z
bridges	b ɹ ɪ dʒ ɪ s
brigid	b ɹ ɪ dʒ ɪ t
brisbane	b ɹ ɪ s b eɪ n
brokerage	b ɹ oʊ k ɹ ɪ dʒ
bruck	b ɹ ɑ k
buccaneers	b ʌ k ə n ɪ ɹ z
buckinghamshire	b ʌ k ɪ ŋ h æ m ʃ aɪ ɝ
budapest	b u t ə p æ s t
buddy	b ɑ d i
build	b ɪ l t
burke	b ɝ ɡ
busbee	b ʌ z b i
buzzell	b ə s ɛ l
bylsma	b ɪ l z m ə
byrd	b ɝ t
byres	b aɪ ɝ z
cab	k æ p
caddies	k æ t i z
caddy	k æ t i
cadillac	k æ t ə l æ k
cafferty	k æ f ɝ d i
cairns	k æ ɹ n z
calibre	k æ l ə b ɝ
caliph	k ɛ l ɪ f
camden	k æ m t ə n
cameron	k æ m ɹ ə n
camille	k ə m ɪ l
campbell	k æ m p ə l
campos	k æ m p oʊ s
canberra	k æ m b ɝ ə
canberra	k æ n b ɝ ə
capital	k æ p i t ə l
card	ɡ ɑ ɹ d
care	k ɛ
career	k ɝ i ɹ
career	k ɝ i ɝ
carlsson	k ɑ ɹ l s ə n
carmel	k ɑ ɹ m ə l
caroline	k ɛ ɹ ə l ɪ n
carotene	k ɛ ɹ ə t i n
carrion	k ɛ ɹ i ə n
carroll	k ɛ ɹ ə l
carrollton	k ɛ ɹ ə l t ə n
carry	k ɛ ɹ i
carvings	k ɑ ɹ v ɪ ŋ s
casbah	k æ s p ə
case	ɡ eɪ z
cases	k eɪ z ɪ z
casinos	k ə s i n oʊ z
catherine	k æ θ ɹ i n
catherines	k æ θ ɹ i n z
ceased	s i z d
cecil	s ɪ s ə l
cellist	tʃ æ l ɪ s t
cells	ʃ ɛ l z
celtic	k ɛ l d ɪ ɡ
centenary	s ɛ n t ɛ n ɝ i
center	s ɛ n t ɹ
center	s ɛ n d ɝ
centralism	s ɛ n t ɹ ə l ɪ z ə m
centre	s æ n t ɝ
chancellor	tʃ æ n s l ɝ
chaparral	ʃ æ p ɝ ɛ l
charlestown	tʃ ɑ ɹ ə l z t aʊ n
charlottesville	ʃ ɑ ɹ l ə t s v ɪ l
chen	tʃ æ n
chengdu	tʃ æ ŋ d u
chenille	ʃ ə n ɪ l
chest	tʃ æ s t
childeric	tʃ ɪ l d ɹ ɪ k
chinsurah	tʃ ɪ n s ɝ ə
choir	k w aɪ ɹ
choirs	k w aɪ ɝ z
chorale	k ɹ æ l
chowder	tʃ aʊ t ɝ
chrisman	k ɹ ɪ s m ə n
chromosomes	k ɹ oʊ m ə z oʊ n z
chromosomes	k ɹ oʊ m ə z oʊ m z
cities	s ɪ t ɪ z
citizens	s ɪ t ə s ə n z
civic	s ɪ f ɪ k
cladding	k l æ t ɪ ŋ
cladistics	k l ə t ɪ s t ɪ k s
clara	k l ɛ ɹ ə
clarified	k l æ ɹ ə f aɪ d
clarify	k l æ ɹ ə f aɪ
clarinetist	k l ɛ ɹ ə n ɛ t ɪ s t
clarinetists	k l ɛ ɹ ə n ɛ t ɪ s t s
clarkston	k l ɑ ɹ k s t ə n
clemons	k l ɛ m ə n s
clifford	k l ɪ f ɝ t
close	k l oʊ s
closer	k l oʊ z ɝ
closest	k l oʊ z ə s t
club	k l ɑ b
cluck	k l ɑ k
clypeus	k l i p i ə s
cobb	k ɑ p
cochlear	k ɑ k l ɪ ɹ
cochlear	k ɑ k l i ɹ
codes	k oʊ t s
coding	k oʊ t ɪ ŋ
coed	k oʊ æ d
coercion	k oʊ ɝ ʒ ə n
coleridge	k oʊ l ɝ ɪ dʒ
collaborative	k ə l æ b ɝ ə t ɪ v
color	k ɑ l ɝ
coloration	k ɑ l ɝ eɪ ʃ ə n
colors	k ɑ l ɝ z
colt	k oʊ l d
columns	k ʌ l ə n z
combat	k ɑ m p æ t
comedic	k ə m i t ɪ k
comm	k ʌ m
commentaries	k ɑ m ə n t ɛ ɹ i z
commentators	k ɑ m ə n d eɪ t ɝ z
commodore	k ɑ n ə d ɔ ɹ
common	k ʌ m ə n
company	k ɑ m p ə n i
comparable	k ə m p ɛ ɹ ə b ə l
comparable	k ɑ m p ɹ ə b ə l
competed	k ə m p ɪ t ɪ d
complementary	k ɑ m p l ə m ɛ n t ɝ i
concord	k ɑ n k ɔ ɹ d
concubine	k ɑ ŋ k j ə b aɪ n
concubines	k ɑ ŋ k j ə b aɪ n z
condone	k ə n d oʊ m
cones	k oʊ m z
congress	k ɑ n ɡ ɹ ə s
congreve	k ɑ n ɡ ɹ i v
conscripts	k ɑ n s k ɹ ɪ p t s
contacting	k ɑ n t æ k t ɪ n
contracting	k ɑ n t ɹ æ k t ɪ ŋ
contrast	k ə n t ɹ æ s t
contrasts	k ə n t ɹ æ s t s
contributed	k ə n t ɹ ɪ b j u d ɪ d
cookies	k u k i z
cordell	k ɔ ɹ d ɛ l
corneal	k ɔ ɹ n i l
cornerback	k ɔ ɹ n ɝ b æ k
cornwallis	k ɔ ɹ n w ɔ l ə s
correctional	k ɹ ɛ k ʃ ə n ə l
corte	k ɔ ɹ t
cortes	k ɔ ɹ t ɛ z
cosmetics	k ɑ z m æ t ɪ k s
cossack	k ɑ z æ k
cotton	k ɑ d ə n
course	k ɔ ɹ z
course's	k ɔ ɹ s ɪ z
courses	k ɔ z ɪ z
court	k ɔ ɹ d
covell	k ʌ v ə l
coverage	k ʌ v ɝ ɪ dʒ
coverage	k ɑ v ɹ ɪ dʒ
coverage	k ʌ f ɹ ɪ dʒ
coverings	k ʌ v ɹ ɪ ŋ z
coverts	k ɑ v ɝ t s
cowry	k aʊ ɝ i
crafted	k ɹ æ f t ɪ d
crafting	k ɹ æ f t ɪ ŋ
crafts	ɡ ɹ æ f s
craftsman	k ɹ æ f s m ə n
craig	k ɹ æ ɡ
craig	ɡ ɹ ɛ ɡ
cranberry	k ɹ æ m b ɛ ɹ i
crappie	k ɹ æ p i
crater	ɡ ɹ eɪ t ɝ
crater	k ɹ eɪ d ɝ
credibility	k ɹ ɛ d ə b ɪ l ɪ t i
cremated	k ɹ ɪ m eɪ t ɪ d
cremona	k ɹ ɪ m oʊ n ə
crevices	k ɹ ɛ f ə s ɪ z
crippling	k ɹ ɪ p l ɪ ŋ
crocheted	k ɹ oʊ ʃ eɪ t
cronos	k ɹ oʊ n oʊ z
crooked	k ɹ ʊ k d
cross	k ɹ ɔ z
crossing	k ɹ ɔ s ɪ n
crossover	k ɹ ɔ s oʊ v ɚ
cuenca	k w æ ŋ k ə
cullimore	k ʌ l i m ɔ ɹ
cultivar	k ʌ l t i v ɑ ɹ
curling	k ɝ l ɪ n
curtin's	k ɝ t ɪ ŋ z
cushing	k ʊ ʃ ɪ n
cynwyd	s ɪ n w ɪ t
cypriots	s ɪ p ɹ i ə t s
dallas	d ɛ l ə s
dams	d æ n z
danzig	d æ n s ɪ ɡ
dardanelles	d ɑ ɹ d ə n æ l z
darden	d ɑ ɹ d ə n
darius	d ɛ ɹ i ə s
darrell	d æ ɹ ə l
daryl	d ɛ ɹ ə l
data	d ɛ t ə
date	t eɪ t
davis	d eɪ v ɪ z
deaconess	d i k ə n ɛ s
deborah	d ɛ b ɹ ə
decentralized	d i s ɛ n t ɹ ə l aɪ z d
declarer	d i k l ɛ ɹ ɝ
decoding	d ɪ k oʊ t ɪ ŋ
decorative	d ɛ k ɝ ə t ɪ v
decrease	d ɪ k ɹ i s
decreased	d ɪ k ɹ i s t
defender	d ɪ f ɛ n t ɝ
deidre	d i d ɹ ə
delphine	d ɛ l f ɪ n i
delphine	d ɛ l f ɪ n
delphinus	d ɛ l f ɪ n ə s
demetrius	d ɪ m i t ɹ i ə s
demme	d æ n
deng	d æ ŋ
denslow	d ɛ n z l oʊ
denver	d æ n f ɝ
derbyshire	d ɝ b ɪ ʃ ɝ
dern	t ɝ n
desecrate	d ɛ s ə k ɹ eɪ t
deserve	d ɪ s ɝ v
designated	d ɛ s ɪ ɡ n eɪ t ɪ d
desirable	d ɪ z aɪ ɝ ə b ə l
detailed	d i t eɪ l d
detailing	d i t eɪ l ɪ ŋ
dethroned	d ɪ θ ɹ oʊ n d
detonate	d ɛ d ə n eɪ t
detroit	d ɪ t ɹ ɔɪ t
devonport	d æ v ə n p ɔ ɹ t
dewey	d u ɪ
dexterity	d ɛ k s t ɛ ɹ ə t i
dhaka	d ʌ k ə
diabetes	d aɪ ə b i d i z
diagnosed	d aɪ ə ɡ n oʊ z t
diagnosed	d aɪ ə ɡ n oʊ z d
diaries	d aɪ ɚ i z
differently	d ɪ f ɝ ə n t l i
dinwiddie	d ɪ n w ɪ t i
diocese	d aɪ ə s ɪ s
diocese	d aɪ ə s i s
dire	d aɪ ɝ
direct	d ɪ ɹ ɛ k t
direct	d ɚ ɛ k t
disbanded	d ɪ s p æ n d ɪ d
disbanding	d ɪ s p æ n d ɪ ŋ
discontinued	d ɪ z k ə n t ɪ n j u d
disguise	d ɪ s k aɪ z
disguises	d ɪ s k aɪ z ɪ z
disintegrated	d ɪ z ɪ n t ə ɡ ɹ eɪ t ɪ d
disrepair	d ɪ s ɹ i p ɛ ɹ
diverse	d ɪ v ɝ z
dizdar	d ɪ s d ɑ ɹ
do	t u
documentaries	d ɑ k j ə m ɛ n t ɹ i z
dodo	d oʊ t oʊ
dodson	d ɑ t s ə n
doer	d u ɝ
does	d ʌ s
donovan	d ʌ n ə v ə n
dorms	d ɔ ɹ m z
dowden's	d aʊ t ə n z
downside	d aʊ n s aɪ t
dowry	d aʊ ɝ i
dresden	t ɹ ɛ z t ə n
drew	t ɹ u
dried	t ɹ aɪ d
drill	t ɹ ɪ l
drs	t ɝ z
drury	d ɹ ʊ ɹ i
ducks	d ɑ k s
dudes	t u d z
dudley's	d ʌ t l i z
duet	d u æ t
dutiful	d u t ɪ f ə l
each	ɪ tʃ
earmarked	ɪ ɹ m ɑ ɹ k t
earphones	ɪ ɹ f oʊ n z
ebook	i b ʊ k
eckert	ɛ k ɝ d
econometric	ɪ k ɑ n ə m ɛ t ɹ ɪ k
ecuador's	ɛ k w ə d ɔ ɹ z
ed's	ɛ d s
eddinger	ɛ t ɪ ŋ ɝ
eddings	æ d ɪ ŋ z
eddy	æ d i
edelmann	æ d ə l m ə n
eden	i t ə n
edison	æ d ɪ s ə n
edney	ɛ t n i
edwardian	ɛ d w ɔ ɹ d i ə n
effect	ə f æ k t
efficiently	i f ɪ ʃ ə n t l i
egg	æ ɡ
eight	eɪ d
eisner	aɪ z n ɝ
eject	ɪ dʒ æ k t
el	æ l
elaborately	ɪ l æ b ɝ ə t l i
elba	æ l b ə
elbe	ɛ l p
elbing	æ l b ɪ ŋ
elbow	æ l b oʊ
electric's	ɪ l ɛ k t ɹ ɪ k s
electrons	ɪ l ɛ k t ɹ ɑ n z
elementary	ɛ l ə m ɛ n t ɹ i
elementary	ɛ l ə m ɛ n t ɝ i
elena	ɛ l i n ə
elise	ɛ l i z
elisha	ɪ l ɪ ʃ ə
elites	ɪ l i d z
ella	æ l ə
elman	æ l m ə n
emerald	ɛ m ɝ ə l d
emerald	ɛ m ɹ ə l d
emeralds	æ m ɝ ə l d z
emerson	æ m ɝ s ə n
emir	i m ɪ ɹ
emma	æ m ə
emmy	æ m i
empathy	æ m p ə θ i
emphasis	ɛ n f ə z ɪ s
empty	æ n t i
encores	ɑ n k ɔ ɹ z
end	æ n d
endemic	æ n d ɛ m ɪ k
endicott	ɛ n t ɪ k ɑ t
eng	ɛ n
engel	æ ŋ ɡ ə l
engelberg	æ ŋ ɡ ə l b ɝ ɡ
engels	æ ŋ ɡ ə l z
engravings	ɪ n ɡ ɹ eɪ v ɪ n z
enjoy	æ n dʒ ɔɪ
enquiry	ɪ n k w aɪ ɝ i
enron's	ɛ n ɹ ɑ n z
ensured	ɪ n ʃ ʊ ɹ d
ensures	ɪ n ʃ ʊ ɹ z
entwine	æ n t w aɪ n
envisaged	ɛ m v ɪ z ɪ dʒ d
epsilon	æ p s ə l ɑ n
equal	ɪ k w ə l
equality	i k w ɑ l ə t i
era	ɪ ɹ ə
erasmus	ɪ ɹ æ s m ə s
erdrich	ɝ d ɹ ɪ k
erhard	ɛ ɹ h ɑ ɹ d
erie	i ɹ i
ernesto	ɝ n æ s t oʊ
error	ɛ ɹ
eruptions	ɪ ɹ ʌ p ʃ ə n z
esoteric	æ s ə t ɛ ɹ ɪ k
esther	ɛ s θ ɝ
ether	æ θ ɝ
etruscan	i t ɹ ʌ s k ə n
etzel	ɛ t s ə l
eucharist	j u k ɝ ɪ s t
eugen	j u dʒ ɪ n
euro	j ʊ ɹ ə
euro	j ʊ ɹ oʊ
eurydice	j ʊ ɹ ɪ d ɪ s
euthanasia	j u θ ə n eɪ ʃ ə
evaluation	i v æ l j u eɪ ʃ ə n
evaporating	i v æ p ɝ eɪ t ɪ ŋ
evasive	ɪ v eɪ s ɪ v
eventually	i v ɛ n tʃ u l i
ever	æ v ɝ
evoke	ɪ v oʊ k
evoking	ɪ v oʊ k ɪ ŋ
excised	æ k s aɪ z d
exemplar	ɪ ɡ z ɛ m p l ɝ
exits	ɛ k z ɪ t s
expanded	ɪ k s p ɛ n d ɪ d
expansions	ɪ k s p ɛ n ʃ ə n z
expenses	ɪ k s p æ n s ɪ z
expensive	ɪ k s p æ n s ɪ v
expertise	ɛ k s p ɝ t i s
exports	ɛ k s p ɔ ɹ t s
expressionism	ɪ k s p ɹ ɛ ʃ ə n ɪ z ə m
expressionistic	ɪ k s p ɹ ɛ ʃ ə n ɪ s t ɪ k
expulsion	ɪ k s p ʌ l ʒ ə n
falls	f ɔ l s
fame	f eɪ n
fans	v æ n z
farber	f ɑ ɹ b ɝ
farner	f ɑ ɹ n ɝ
farnsworth	f ɑ ɹ n z w ɝ θ
faroe	f ɛ ɹ oʊ
farrah	f ɛ ɹ ə
fatality	f ə t æ l ə t i
faulted	f ɔ l d ɪ d
favorite	f eɪ v ɝ ə t
federalists	f ɛ d ɹ ə l ɪ s
federally	f ɛ d ɹ ə l i
federative	f ɛ d ɹ ə t ɪ v
feed	f i t
feeder	f i t ɝ
feminist	f æ m ə n ɪ s t
fetal	f i d ə l
feuded	f j u t ɪ d
field	f ɪ l d
fighters	f aɪ d ɝ z
figurine	f ɪ ɡ j ɝ ɪ ŋ
fijians	f ɪ dʒ i ə n z
filipe	f ɪ l i p
financier	f ɪ n æ n s i ɝ
firemen	f aɪ ɝ m ə n
firewood	f aɪ ɝ w ʊ d
fireworks	f aɪ ɝ w ɝ k s
firing	f aɪ ɝ ɪ ŋ
fissile	f ɪ z ə l
fissionable	f ɪ ʒ ə n ə b ə l
flabbergasted	f l æ p ɝ ɡ æ s t ɪ d
flint	f l ɪ n d
florey	f l ɔ ɹ i
florida	f l ɔ ɹ d ə
florida's	f l ɔ ɹ ɪ d ə z
fluoresce	f l ɔ ɹ ɛ s
flux	f l ɑ k s
fodder	f ɑ t ɝ
following	f ɑ l oʊ ɪ n
foods	f u d s
for	f ɹ
for	f ɚ ɹ
for	f ɝ ɹ
forage	f ɔ ɹ ɪ dʒ
fords	f ɔ ɹ t s
forecasts	f ɔ ɹ k æ s
foreigner	f ɔ ɹ ə n ɝ
foreigners	f ɔ ɹ ə n ɝ z
forensic	f ɝ ɛ n z ɪ k
forfeiture	f ɔ ɹ f ɪ tʃ ɝ
format	f ɔ ɹ m æ d
forming	f ɔ ɹ m ɪ n
formulas	f ɔ ɹ m j ə l ə s
forni	f ɔ ɹ n i
forte	f ɔ ɹ t
fossils	f ʌ s ə l z
foster	f ɔ s t ɝ
fourths	f ɔ ɹ s
fracture	f ɹ æ k ʃ ɝ
frances	f ɹ æ n s ɪ s
francis	f ɹ æ n s ɪ z
franklinville	f ɹ æ ŋ k l ɪ n v ɪ l
franz	f ɹ æ n s
fraser	f ɹ eɪ ʒ ɝ
fraternity	f ɹ ə t ɝ n ɪ t i
frazier	f ɹ eɪ z ɝ
freed	f ɹ i t
freelancing	f ɹ i l æ n s ɪ ŋ
freeport's	f ɹ i p ɔ ɹ t s
fremantle	f ɹ i m æ n t ə l
frenulum	f ɹ ɛ n j ə l ə m
frequenting	f ɹ i k w ə n t ɪ ŋ
fresheners	f ɹ ɛ ʃ n ɝ z
fresno	f ɹ ɛ s n oʊ
frisco	f ɹ ɪ s k oʊ
frost	f ɹ ʌ s t
funkadelic	f ʌ ŋ k ə d æ l ɪ k
fursey	f ɝ z i
furthest	f ɝ ð ə s t
fuselage	f j u s ə l ɑ ʒ
gaddafi	k ə d æ f i
gain	ɡ eɪ ŋ
gain	ɡ eɪ m
galician	ɡ ə l i ʃ ə n
gallas	ɡ æ l ə s
gallipoli	k ə l ɪ p ə l i
game	k eɪ n
games	ɡ eɪ n z
games	k eɪ m z
garnered	k ɑ ɹ n ɝ d
garratt	ɡ ɛ ɹ ə t
garrison	ɡ ɛ ɹ ɪ s ə n
gateshead	ɡ eɪ t s h ɛ d
gatun	ɡ ɛ t ə n
geller	ɡ ɛ l ɝ
gemma	dʒ æ m ə
gender	dʒ ɛ n t ɝ
gene	dʒ ɪ n
general's	dʒ ɛ n ɝ ə l z
generalization	dʒ ɛ n ɝ ə l ɪ z eɪ ʃ ə n
generalizations	dʒ ɛ n ɝ ə l ɪ z eɪ ʃ ə n z
genetic	dʒ ɪ m ɛ t ɪ k
getty	ɡ ɛ d i
ghats	k ɑ t s
ghetto	ɡ æ t oʊ
girder	ɡ ɝ t ɝ
gisborne	ɡ ɪ z b ɝ n
glabrous	ɡ l æ b ɝ ə s
glaciers	ɡ l eɪ s ɝ z
glasgow	ɡ l æ s ɡ oʊ
glasgow	ɡ l æ z ɡ oʊ
glasgow	ɡ l æ z k oʊ
glaston	k l æ s t ə n
glen	ɡ l æ n
glen	k l ɛ n
glencoe	ɡ l æ n k oʊ
globose	ɡ l oʊ b oʊ z
gnat	m æ t
gnu	k ə n u
goitre	ɡ ɔɪ d ɝ
goldberg	ɡ oʊ l d b ɝ k
golf	ɡ ʌ l f
goliath	k ə l aɪ ə θ
gonzalez	ɡ ɑ n z ɑ l ə s
gosden	ɡ ɑ z d ə n
goslar	ɡ ɑ z l ɝ
gotcha	ɡ ʌ tʃ ə
governance	ɡ ʌ v ɝ m ə n s
government	ɡ ʌ v ɝ n m ə n t
governments	ɡ ʌ v ɝ n m ə n t s
grade	ɡ ɹ eɪ t
grading	ɡ ɹ eɪ t ɪ ŋ
graeme	ɡ ɹ ɛ m
graffiti	ɡ ɹ ə f i d i
grainger	ɡ ɹ eɪ n dʒ ɝ
grammatical	k ɹ ə m æ t ɪ k ə l
grand	ɡ ɹ æ n t
granite	ɡ ɹ ɛ n ɪ t
grant	ɡ ɹ æ n d
grattan	ɡ ɹ ɛ t ə n
graybeard	ɡ ɹ eɪ b ɪ ɹ d
great	ɡ ɹ eɪ d
greek	k ɹ i k
green	ɡ ɹ ɪ n
greenland	k ɹ i n l ə n d
greeting	ɡ ɹ i d ɪ ŋ
grenadine	ɡ ɹ æ n ə d i n
griswold	ɡ ɹ ɪ z w oʊ l d
gritty	ɡ ɹ i t i
gritty	ɡ ɹ ɪ d i
groceries	ɡ ɹ oʊ s ɝ i z
groups	k ɹ u p s
guadeloupe	ɡ w ɑ t ə l u p
guantanamo	k w ɑ n t ɑ n ə m oʊ
guitar	k ə t ɑ ɹ
guitar	k ɪ t ɑ ɹ
gulf	ɡ ɑ l f
gustaf	ɡ u s t ɑ v
gustav	ɡ u s t ɑ v
gymnasium	dʒ ɪ m n eɪ z i ə n
habsburg	h æ b s b ɝ ɡ
half	h æ v
hamburg	h ɛ m b ɝ ɡ
hamburger	h æ m b ɝ k ɝ
hampden	h æ m p t ə n
hardening	h ɑ ɹ d ə n ɪ ŋ
harper	h ɑ ɹ b ɝ
harrah's	h ɛ ɹ ə s
harriet's	h ɛ ɹ i ə t z
harron	h ɛ ɹ ə n
hartnell	h ɑ ɹ t n ə l
hartwood	h ɑ ɹ t w ʊ d
harvested	h ɑ ɹ v ə s t ɪ d
has	h ɛ z
haslam	h æ z l ə m
have	h eɪ f
hawker	h ɑ k ɝ
hawtrey	h ɔ d ɹ i
he	ɪ
he	h ɪ
he's	h ɪ s
head	h æ t
header	h ɛ t ɝ
headquartered	h ɛ d k w ɔ ɹ t ɝ d
heads	h æ d z
hear	h ɪ ɹ
heart	h ɑ ɹ d
heck	h æ k
heenan	h ɪ n ə n
hefner	h æ f n ɝ
heim's	h aɪ n z
held	h ɛ l t
helena	h ɛ l i n ə
helical	h ɪ l ɪ k ə l
helsinki	h æ l s ɪ ŋ k i
hempstead	h æ m p s t ɛ d
hendrickson	h ɛ n d ɹ ɪ k s ə n
henley's	h æ n l i z
henniker	h æ n ɪ k ɝ
henri	ɑ n ɹ i
henson's	h æ n s ə n z
her	h ɚ
herb	ɝ p
herb	h ɝ p
herbarium	h ɝ b ɛ ɹ i ə n
herbarium	ɝ b ɛ ɹ i ə n
heroism	h i ɹ oʊ ɪ z ə m
herrera	h ɝ ɛ ɹ ə
hers	ɝ z
herself	ɝ s ɛ l f
hes	h i s
hetmans	h ɛ d m ə n z
hexagonal	h ɛ ɡ z æ ɡ ə n ə l
hiatus	h aɪ eɪ d ə s
hierarchic	h aɪ ɝ ɑ ɹ k ɪ k
hierarchy	h aɪ ɝ ɑ ɹ k i
higher	h aɪ ɚ
hilo	h ɪ l oʊ
hinsley	h ɪ n z l i
hire	h aɪ ɝ
hiring	h aɪ ɝ ɪ n
hiro	h i ɹ oʊ
his	h i z
historically	h ɪ s t ɔ ɹ ɪ k ə l i
hit	h ɪ d
holyhead	h oʊ l i h æ d
hondas	h ɑ n d ə z
hooded	h u d ɪ d
hopkinton	h ɑ b k ɪ n t ə n
hornless	h ɔ ɹ m l ə s
horror	h ɔ ɹ
hour	aʊ ɝ
hours	aʊ ɝ z
house	h aʊ z
housed	h aʊ z d
houses	h aʊ z ɪ z
housing	h aʊ s ɪ ŋ
hub	h ɑ p
hub	h ʌ p
hubbard	h ʌ b ɝ t
hubbell	h ɑ b ə l
hubley	h ɑ b l i
huddersfield	h ʌ t ɝ z f i l d
hughes	j u s
humanitarian	h j u m æ n ɪ t ɛ ɹ i ə n
humor	j u m ɝ
humour	j u m ɝ
humphries	h ʌ m f ɹ i z
hungary	h ʌ ŋ ɡ ɹ i
hunger	h ʌ ŋ k ɝ
hurtle	h ɝ d ə l
hurtled	h ɝ d ə l d
husband	h ʌ s b ə n d
hustle	h ɑ s ə l
hutton	h ʌ d ə n
ice	aɪ z
idiosyncratic	ɪ d i oʊ s ɪ ŋ k ɹ æ t ɪ k
iglesias	ɪ ɡ l eɪ s i ə z
ika	i k ə
iki	i k i
illness	i l n ə s
illusory	ɪ l u z ɝ i
ima	i m ə
impediment	ɪ n p ɛ d ə m ə n t
imperturbable	ɪ m p ɝ t ɝ b ə b ə l
imprisonment	ɪ n p ɹ ɪ z ə n m ə n t
in	ɪ m
in	ɪ ŋ
in	i n
inaptitude	ɪ n ɛ p t ə t u d
inaugural	ɪ n ɔ ɡ ɝ ə l
incipit	ɪ n s ɪ p ɪ d
inconsistent	ɪ ŋ k ə n s ɪ s t ə n t
indices	ɪ n d ɪ s ɪ s
indices	ɪ n d ɪ s ɪ z
indonesia	ɪ n d ə n ɪ ʃ ə
infield	ɪ n f ɪ l d
ingram	ɪ n ɡ ɹ ə m
initiated	ɪ n ɪ s i eɪ t ɪ d
inputs	ɪ m p ʊ t s
inquiry	ɪ n k w aɪ ɝ i
insignificant	ɪ ŋ s ɪ ɡ n ɪ f ɪ k ə n t
insley	ɪ n z l i
intercourse	ɪ n ɝ k ɔ ɹ s
interdisciplinary	ɪ n t ɝ d ɪ s ə p l ə n ɛ ɹ i
interests	ɪ n t ɝ ɛ s t s
interfere	ɪ n t ɝ f ɪ ɹ
international	ɪ n t ɝ n æ ʃ ə n ə l
iota	aɪ oʊ d ə
ira	i ɹ ə
iran	ɪ ɹ æ m
irrationality	ɪ ɹ æ ʃ ə n æ l ə t i
irredentism	ɪ ɹ ə d ɛ n t ɪ z ə m
irreverent	ɪ ɹ ɛ v ɝ ə n d
is	ɪ s
is	i z
isabella	ɪ s ə b ɛ l ə
isan	i s ə n
isidoro	i s i d ɔ ɹ oʊ
islamic	ɪ s l æ m ɪ k
islington	aɪ z l ɪ ŋ t ə n
issa	i z ə
istanbul	ɪ s t æ m b ʊ l
ivory	aɪ v ɹ i
jacques	ʃ ɑ k
jaffrey	dʒ ɛ f ɹ i
james	dʒ eɪ n z
january	dʒ ɛ n j u ɛ ɹ i
jarrett	dʒ ɛ ɹ ɪ t
jarry	dʒ ɛ ɹ i
jazz	dʒ ɛ z
jed	dʒ ɛ t
jeering	dʒ ɪ ɹ ɪ ŋ
jeers	dʒ ɪ ɹ z
jennifer	dʒ ɛ n ɪ f ɝ
jenny	dʒ ɛ m i
jet	dʒ ɛ d
jettisoned	dʒ ɛ d ɪ s ə n d
jew's	dʒ u s
joseph's	dʒ oʊ s ə f s
jubilee	dʒ u p ə l
jubilee	dʒ u p ə l i
judicial	dʒ u d ɪ s ə l
jutta	dʒ ɑ t ə
kachin	k æ tʃ i n
kanji	ɡ æ n dʒ i
kannada	ɡ æ n ə d ə
karate	k ɝ ɑ d i
karelian	k ɝ ɪ l i ə n
karsh	k ɑ ɹ ʃ
kashmir	k æ ʃ m ɪ ɹ
kashmir	k æ ʒ m ɪ ɹ
kashmiri	k æ ʃ m ɪ ɹ i
keble	k æ b ə l
keighley	k eɪ k l i
keil	k ɪ l
keir	k ɪ ɹ
keirsey	k ɪ ɹ s i
kelland	k æ l ə n d
kelly	k æ l i
kelso	k æ l s oʊ
kemp	k æ m p
ken	k æ n
kennedys	k æ n ə d i z
kent	k æ n t
kenya	k æ n j ə
keppel	k æ p ə l
keratin	k ɛ ɹ ə t ə n
kessell	k æ s ə l
keta	k æ t ə
kevin	k æ v ə n
keyboard	k ɪ b ɔ t
kherson	k ɝ ʃ ə n
kidd's	k ɪ d s
kidder	k ɪ t ɝ
kidding	k ɪ t ɪ ŋ
kids	k ɪ t s
kiesling	k i s l ɪ ŋ
killigrew	k ɪ l ɪ ɡ ɝ u
kimiko	k ɪ m i k oʊ
kindergarten	k ɪ n d ɝ ɡ ɑ ɹ d ə n
kinnear	k ɪ n i ɝ
kirghiz	k ɝ ɡ ɪ z
kirkpatrick	k ɝ k p æ t ɹ ɪ k
kisan	k i s ə n
kisan	k ɪ s ə n
knotted	n ɑ d ɪ d
knowsley	n oʊ z l i
koenigs	k oʊ n ɪ k s
korda	k ɔ ɹ d ə
korean	k ɝ i ə n
kourou	k u ɹ u
krabbe	k ɹ æ b
kravitz	k ɹ æ v ɪ t s
krebs	k ɹ æ b z
kremer	k ɹ ɪ m ɝ
kreutzer	k ɹ ɔɪ t s ɝ
krishna	k ɹ ɪ s n ə
kristine	k ɹ ɪ s t i n
l	æ l
lab	l æ p
ladder	l æ t ɝ
lagging	l ɛ ɡ ɪ ŋ
lambert	l æ m b ɝ d
lancashire	l æ ŋ k ə ʃ aɪ ɝ
landfills	l æ n d f i l z
lange	l æ n
lansdown	l æ n s t aʊ n
lansdowne	l æ n z d aʊ n
lanza	l æ m z ə
laparoscopic	l æ p ɹ ə s k ɑ p ɪ k
lars	l ɑ ɹ s
lary	l ɛ ɹ i
last	l ɛ s t
lastra	l æ s t ɹ ə
late	l eɪ d
lathe	l eɪ θ
latter	l æ d ɝ
latvia	l æ t f i ə
laverty	l æ v ɝ d i
league	l i k
leagues	l i k s
leagues	l ɪ ɡ z
leak	l i ɡ
learnt	l ɝ n d
leased	l i z d
lebaron	l ə b ɛ ɹ ə n
led	l ɛ t
leipzig	l aɪ p s ɪ k
leisurely	l i ʒ ɝ l i
lemon	l æ m ə n
lending	l æ n d ɪ ŋ
lens	l æ n z
lenses	l ɛ n s ɪ z
leroy	l ɪ ɹ ɔɪ
lesbian	l ɛ s b i ə n
lesbian	l ɛ s p i ə n
less	l æ s
letter	l æ t ɝ
levy	l ɛ f i
liberalize	l ɪ b ɝ ə l aɪ z
liberalized	l ɪ b ɝ ə l aɪ z d
lime	l aɪ n
limerick	l ɪ m ɹ ɪ k
limited	l ɪ m ɪ t ɪ t
lindsay	l ɪ n s i
literature	l ɪ t ɝ tʃ ɝ
lithgow	l ɪ θ k aʊ
little	l ɪ d ə l
live	l aɪ f
live	l i v
lives	l aɪ f s
lock	l ɑ ɡ
logo	l oʊ k oʊ
logos	l oʊ ɡ oʊ s
logs	l ɑ k s
lolled	l ʌ l d
london	l ʌ n t ə n
longevity	l ɔ ŋ dʒ ɛ v ə t i
longitudinal	l ɑ ŋ dʒ ə t u d ə n ə l
loral	l ɔ ɹ ə l
loral's	l ɔ ɹ ə l z
lortie	l ɔ ɹ t i
lose	l u s
lotus	l oʊ d ə s
louis	l u ɪ
louis	l u i z
louisa	l u i s ə
lubricants	l u b ɹ ɪ k ə n t s
lucian	l u s i ə n
ludwig	l ʌ d w ɪ k
luxembourg	l ʌ k s ə n b ɝ ɡ
luxury	l ʌ k ʒ ɝ i
lynden	l ɪ n t ə n
m	ɛ n
madagascar	m æ t ə ɡ æ s k ɝ
madison	m ɛ d ə s ə n
madox	m æ t ə k s
makati	m ə k ɑ t i
malaysia	m ə l eɪ ʃ ə
malhotra	m æ l h ɑ t ɹ ə
malt	m ʌ l t
malta	m ʌ l t ə
maltravers	m ɛ l t ɹ æ v ɝ z
mankins	m æ n k ɪ n z
manoeuvre	m ə n u v ɝ
manvers	m æ n f ɝ z
mapes	m eɪ b s
marathon	m ɛ ɹ ə θ ə n
marathons	m ɛ ɹ ə θ ɑ n z
marcia	m ɑ ɹ ʃ i ə
marcoux	m ɑ ɹ k u
margaret's	m ɑ ɹ ɡ ɝ ɪ t s
marian	m ɑ ɹ i ə n
marilyn	m ɛ ɹ ə l ɪ n
marital	m ɛ ɹ ɪ t ə l
marius	m ɑ ɹ i ə s
marjorie	m ɑ ɹ dʒ ɝ i
marjory	m ɑ ɹ dʒ ɝ i
market	m ɑ ɹ k ə d
markets	m ɑ ɹ k ə t s
markup	m ɑ ɹ k ə p
marla	m ɑ ɹ l ə
marlins	m ɑ ɹ l ə n z
marlon	m ɑ ɹ l ə n
marotta	m ɝ ɑ d ə
mars	m ɑ ɹ s
marse	m ɑ ɹ z
martel	m ɑ ɹ t ɛ l
martin	m ɑ ɹ t ə n
maryland	m ɛ ɹ i l ə n d
maryville	m ɛ ɹ i v ɪ l
mascot	m æ s ɡ ɑ t
massif	m æ s ɪ v
massimo	m æ s i m oʊ
matador	m æ d ə d ɔ ɹ
matlock	m ɛ t l ɑ k
maurice	m ɔ ɹ ɪ s
may's	m eɪ s
mayer	m eɪ ɹ
mayor	m eɪ ɹ
mayor	m ɛ ɹ
mccartney	m ə k ɑ ɹ t n i
mccord	m ə k ɔ ɹ d
mccormick	m ə k ɔ ɹ m ɪ k
mccrory	m ə k ɹ ɔ ɹ i
mcdonagh	m ə k d ɑ n ə
mcfarlane	m ə k f ɑ ɹ l ə n
mckenna	m ə k æ n ə
mckinsey	m ə k ɪ n s i
mckinstry	m ə k ɪ n s t ɹ i
mclaren	m ə k l ɛ ɹ ə n
mcnary	m ə k n ɛ ɹ i
me	n
medal	m ɛ t ə l
medici	m ɛ d ɪ s i
medicine	m ɛ d ə s ə m
medieval	m ɪ d i i v ə l
member	n ɛ m b ɝ
men	m æ n
men's	m ɛ n s
mena	n i n ə
menges	m ɛ n dʒ i z
menk	m æ ŋ k
mentor	m ɛ n t ɹ
meos	m i oʊ s
merchandise	m ɝ tʃ ə n d aɪ s
merging	m ɝ dʒ ɪ n
mersey	m ɝ z i
mesmerism	m ɛ z m ɝ ɪ z ə m
messin	m ɛ s ɪ ŋ
metacarpals	m ɛ t ə k ɑ ɹ p ə l z
metal	m ɛ d ə l
metastatic	m æ d ə s t æ t ɪ k
meteor	m i d i ɝ
meteorites	m i d i ɝ aɪ t s
meteorology	m i d i ɝ ɑ l ə dʒ i
mets	m æ t s
metz	m æ t s
mezzanine	m ɛ s ə n i n
michigan	m ɪ ʃ ɪ k ə n
mikko	m i k oʊ
mila	m i l ə
mildred	m ɪ l d ɹ ɪ d
miller	m i l ɝ
mills	n ɪ l z
minamoto	m i n ə m oʊ t oʊ
minas	m ɪ n ə s
ministerial	m ɪ n ɪ s t ɪ ɹ i ə l
minnesota	m ɪ n ə z oʊ t ə
miramax	m ɪ ɹ ə m æ k s
miramichi	m ɪ ɹ ə m i ʃ i
missing	m ɪ s ɪ n
missouri	m ɪ s ɝ i
misspent	m ɪ s p æ n d
misto	m i s t oʊ
mitry	m i t ɹ i
mizrahi	m ɪ z ɝ ɑ h i
modem	m oʊ t ə m
molas	m oʊ l ə s
molly's	m ɑ l ɪ z
mom	m ʌ m
monger	m ɑ ŋ ɡ ɝ
monkton	m ɑ ŋ k t ə n
monogamy	m ə n ɑ k ə m i
montgomery	m ɑ n t ɡ ʌ m ɝ i
month	m ʌ ŋ θ
moore	m ɔ ɹ
morden	m ɔ ɹ t ə n
moriarty	m ɔ ɹ i ɑ ɹ d i
morningstar	m ɔ ɹ n ɪ ŋ s t ɑ ɹ
morris	m ɔ ɹ ə s
morris	m ɔ ɹ ɪ z
moses	m oʊ z ɪ s
motifs	m oʊ t ɪ v z
mottram	m ɑ t ɹ ə m
mulatto	m ə l ɑ d oʊ
mulligan	m ɑ l ɪ ɡ ə n
multiparty	m ʌ l t i p ɑ ɹ t i
muncie	m ʌ ŋ s i
mundo	m ɑ n d oʊ
murder	m ɝ t ɝ
muslim	m ʌ s l ə m
muslims	m ʌ s l ə m z
muslims	m ɑ z l ə m z
mysteries	m ɪ s t ɹ i z
mysteriously	m ɪ s t ɪ ɹ i ə s l i
n	æ n
nag	m æ ɡ
namibia	n ə m i b i ə
nan	m æ n
nanjing	m æ n dʒ ɪ ŋ
narcisse	n ɑ ɹ s i s
narcissism	n ɑ ɹ s ɪ s ɪ z ə m
nathalie	n æ d ə l i
native	n eɪ t i v
naturalism	n æ tʃ ɝ ə l ɪ z ə m
naturalists	n æ tʃ ɝ ə l ɪ s t s
naturalization	n æ tʃ ɝ ə l ɪ z eɪ ʃ ə n
naturalized	n æ tʃ ɝ ə l aɪ z d
naturally	n æ tʃ ɹ ə l i
naturals	n æ tʃ ɝ ə l z
needs	n i t z
needs	m i d z
nehru	n ɛ ɹ u
netware	n ɛ t w ɛ ɹ
newark	n u ɹ k
newton	n u d ə n
nez	n ɛ s
niches	n i ʃ ɪ z
nikita	n ɪ k i d ə
nikita	m ɪ k i t ə
nils	n i l z
nilsen	n i l s ə n
nilsson	n i l s ə n
nina	m i n ə
nine	m aɪ n
nippon	n ɪ p ɑ ŋ
nirvana	n ɝ v æ n ə
nissen	n i s ə n
node	n oʊ t
nodes	n oʊ t z
nonetheless	n ʌ n θ ə l ɛ s
nordic	n ɔ t ɪ k
northup	n ɔ ɹ θ ə p
northwestern's	n ɔ ɹ θ w ɛ s t ɝ n z
not	n ɑ d
noteworthy	n oʊ t w ɝ θ i
novels	n ɑ v ə l s
novgorod	n ɑ v ɡ ɹ ɑ d
numeric	n u m ɛ ɹ ɪ k
nut	n ɑ t
nyssa	n i s ə
obstacle	ɑ p s t ə k ə l
obtained	ə p t eɪ n d
of	ʌ f
of	ɔ f
off	ʌ v
off	ʌ f
offering	ɔ f ɹ ɪ ŋ
offers	ʌ f ɝ z
offices	ɔ f ə s ə s
ogeechee	oʊ k i tʃ i
olney	oʊ l m i
olympos	oʊ l ɪ m p oʊ s
on	ʌ m
once	w ʌ n z
one	w ɑ n
online	ɔ n l aɪ ŋ
opera's	ɑ p ɝ ə z
operas	ɑ p ɝ ə z
operated	ʌ p ɝ eɪ t ɪ d
operating	ʌ p ɹ eɪ t ɪ ŋ
opportunity	ɑ p ɚ t u n ə t i
optical	ɑ b t ɪ k ə l
options	ɑ b ʃ ə n z
or	ɹ
orated	ɹ eɪ t ɪ d
orcas	ɔ ɹ k ə z
orchard	ɔ ɹ tʃ ɝ t
order	ɔ ɹ t ɝ
originally	ɚ ɪ dʒ ə n ə l i
oscar	ɑ s k ɝ
ose	oʊ s
osgoode	ɑ z ɡ ʊ d
oslo	ɑ s l oʊ
osman	ɑ z m ə n
osmond	ɑ z m ə n d
osmotic	ɑ z m ɑ d ɪ k
oswell	ɑ z w ɛ l
other	ɑ ð ɝ
ottery	ɑ d ɝ i
otto	ɑ d oʊ
ottoman	ɑ d ə m ə n
our	aʊ ɝ
overgrown	oʊ v ɚ ɡ ɹ oʊ n
overseeing	oʊ v ɚ s i ɪ ŋ
oviparous	oʊ v i p ɝ ə s
oxford	ɑ k s f ɝ t
paddle	p æ t ə l
pagnell	p ɛ ɡ n ɛ l
pains	p eɪ n s
pallet	p æ l ə d
palm	p ʌ m
palos	p ɑ l oʊ s
panoramas	p æ n ɝ æ m ə z
paper	b eɪ p ɝ
paracelsus	p ɛ ɹ ə s ɛ l s ə s
parachuting	p ɛ ɹ ə ʃ u t ɪ ŋ
paralympic	p ɛ ɹ ə l ɪ m p ɪ k
parametric	p ɛ ɹ ə m ɛ t ɹ ɪ k
parenting	p ɛ ɹ ə n t ɪ ŋ
parisian	p ɝ i ʒ ə n
parkfield	p ɑ ɹ k f i l d
parkland	p ɑ ɹ k l æ n d
parliamentary	p ɑ ɹ l ə m ɛ n t ɝ i
parliamentary	p ɑ ɹ l ə m ɛ n t ɹ i
parrish	p æ ɹ ɪ ʃ
parsers	p ɑ ɹ s ɝ z
part	p ɑ ɹ d
part	p ʌ t
partially	p ɑ ɹ ʃ l i
particularly	p ə t ɪ k j ə l ɝ l i
partied	p ɑ ɹ t ɪ d
partisan	p ɑ ɹ t ə s ə n
partying	p ɑ ɹ t i ɪ ŋ
pass	b æ s
pass	b ɛ s
passenger	p ɛ s ə n dʒ ɝ
patras	p ɛ t ɹ ə s
patrice	p ə t ɹ i s
patted	p æ d ɪ d
patty	p æ d i
pay	b eɪ
payson	p eɪ s ə n
pearce	p ɪ ɹ s
pedagogic	p ɛ t ə ɡ ɑ dʒ ɪ k
pedagogy	p ɛ t ə ɡ ɑ dʒ i
pedals	p ɛ t ə l z
pedersen	p æ t ɝ s ə n
pediatric	p i d i æ t ɹ ɪ k
pedigree	p ɛ t ə ɡ ɹ i
peirce	p ɪ ɹ s
pembina	p æ m b i n ə
pending	b ɛ n d ɪ ŋ
peninnah	p ə n i n ə
pentagon	p ɛ n t ə k ɑ n
pentre	p ɛ n t ɹ
penumbra	p ɪ n ɑ m b ɹ ə
peppercorn	p ɛ p ɝ k ɔ ɹ n
peralta	b ɝ ɑ l t ə
pershing	p ɝ ʒ i n
peter	p i ɾ ɝ
pettibone	p ɛ t i b oʊ n
pharmaceuticals	f ɑ ɹ m ə s u t ɪ k ə l z
phone	f oʊ m
phones	f oʊ m z
phonetic	f ə n æ t ɪ k
phosphor	f ɑ s f ɝ
phrenological	f ɹ ɪ n ə l ɑ dʒ ɪ k ə l
piazza	p i ɛ t s ə
piazza	p i ɑ s ə
picture	p ɪ tʃ ɝ
pier	p i ɝ
piers	p i ɹ z
pisidia	p ɪ s ɪ d i ə
piso's	p i z oʊ z
placid	p l æ s ɪ t
planetarium	p l æ n ə t ɛ ɹ i ə n
planetarium	p l æ n ɪ t ɛ ɹ i ə m
planeteer	p l æ n ə t ɪ ɹ
plant	p l æ n d
plaque	p l ʌ k
players	p l eɪ ɹ z
playing	p l eɪ ɪ n
plays	p l eɪ s
plotters	p l ɑ d ɝ z
poison	p ɔɪ s ə n
police	p ə l ɪ z
poor	p ɔ
portals	p ɔ ɹ d ə l z
portico	p ɔ ɹ t ɪ k oʊ
portion	b ɔ ɹ ʃ ə n
posterior	p ɑ s t ɪ ɹ i ɝ
potentials	p ə t ɛ n s ə l z
pottery	p ɑ d ɝ i
poured	b ɔ ɹ d
power	p aʊ ɚ
practiced	p ɹ æ k t ə z d
practiced	p ɹ æ k t ə s d
practising	p ɹ æ k t ə s ɪ ŋ
pradesh	p ɹ ə d ɛ ʃ
praised	b ɹ eɪ z t
preakness	p ɹ i k n ə s
precede	p ɹ ɪ s ɪ d
preceded	p ɹ i s i d ə d
preceded	p ɹ ɪ s i d ə d
precedes	p ɹ i s i d z
precinct	p ɹ i s ɪ ŋ k
precincts	p ɹ i s ɪ ŋ k t s
preclinical	p ɹ i k l ɪ n ɪ k ə l
predetermined	p ɹ i d ɪ t ɝ m ə n d
predictions	p ɹ ɪ d ɪ k ʃ ə n z
predominant	p ɹ i d ɑ m ə n ə n t
predominantly	p ɹ i d ɑ m ə n ə n t l i
premier	p ɹ i m ɪ ɹ
premier	p ɹ i m i ɹ
preparatory	p ɹ ɛ p ɝ ə t ɔ ɹ i
preschool	p ɹ i s k u l
prescriptive	p ɹ i s k ɹ ɪ p t ɪ v
presented	p ɹ i z ɛ n ə d
presenter	p ɹ i z ɛ n t ɝ
presenter	p ɹ ɪ z ɛ n t ɝ
presenters	p ɹ i z ɛ n t ɝ z
presiding	p ɹ ɪ z aɪ d ɪ ŋ
preterm	p ɹ i t ɝ m
primitive	p ɹ ɪ m ə t ɪ v
prinz	p ɹ ɪ n s
prix	p ɝ i
probabilities	p ɝ ɑ b ə b ɪ l ə t i z
probability	p ɹ ɑ b ə b ɪ l ə t i
proceeds	p ɹ ə s i d z
processes	p ɹ ɑ s ɛ s i z
processor	p ɹ ɑ s ɛ s ɝ
product's	p ɹ ɑ d ə k s
products	p ɹ ɑ d ə k s
promising	p ɹ ɑ m ə s ɪ ŋ
prompts	p ɹ ɑ m p t s
propagation	p ɹ ɑ p ə k eɪ ʃ ə n
prosecute	p ɹ ɑ s ə k j u t
prospect	p ɹ ɔ s b ɛ k t
prospector	p ɹ ɑ s p ɛ k t ɝ
prosperity	p ɹ ɑ s p ɛ ɹ ə t i
protectionist	p ɹ ə t ɛ k ʃ ə n ɪ s t
protestants	p ɹ ɑ d ə s t ə n t s
protests	p ɹ ə t ɛ s
province's	p ɹ ɑ v ə n s ɪ z
pub	p ʌ p
pub	p ɑ p
pubescent	p j u b ɛ s ə n t
pudding	p ʊ t ɪ ŋ
puerto	p ɔ ɹ t ɝ
pun	p ɑ n
pundit	p ɑ n d ə t
purim	p ʊ ɹ ə m
purportedly	p ɝ p ɔ ɹ t ɪ d l i
pursuit	p ɝ s u d
put	b ʌ t
quarters	k ɔ ɹ d ɝ z
quintana	k w ɪ n t æ n ə
quirky	k w ɝ k ɪ
raced	ɹ eɪ z d
raced	ɹ eɪ z t
racer	ɹ eɪ z ɝ
rackets	ɹ æ k ə t s
rafting	ɹ æ f t ɪ n
rahm	ɹ ɑ m
raised	ɝ eɪ z d
rally	ɹ ɛ l i
ramsay	ɹ æ m z i
ramsgate	ɹ æ m z ɡ eɪ t
ramzi	ɹ æ m z i
randell	ɹ æ n d ɛ l
randi	ɹ æ n d i
randleman	ɹ æ n d ə l m ə n
randy	ɹ ɛ n d i
randy's	ɹ ɛ n d i z
ranking	ɹ æ ŋ k ɪ n
rankings	ɹ æ ŋ k ɪ ŋ z
rankings	ɹ æ ŋ k ɪ n z
ransdell	ɹ æ n s t ə l
rapids	ɹ æ p ə d z
raptor	ɹ æ p t ɝ
raptors	ɹ æ p t ɝ z
raster	ɹ æ s t ɝ
rating	ɝ eɪ t ɪ ŋ
ravenna	ɹ ə v ɛ n ə
ravenna	ɹ ə v æ n ə
rays	ɝ eɪ z
razing	ɹ eɪ s ɪ ŋ
reading	ɹ ɛ t ɪ ŋ
readings	ɹ i d ɪ ŋ z
reardon	ɹ ɪ ɹ d ə n
rearmament	ɹ i ɑ ɹ m ə m ə n t
rebalancing	ɹ i b æ l ə n s ɪ ŋ
rebel	ɹ i b ɛ l
rebel	ɹ ɪ b ɛ l
rebellion	ɹ i b ɛ l j ə n
reboard	ɹ i p ɔ ɹ d
recalls	ɹ ɪ k ɔ l z
recede	ɹ i s i d
receptor	ɹ i s ɛ p t ɝ
receptors	ɹ i s ɛ p t ɝ z
recession	ɹ i s ɛ ʃ ə n
recessional	ɹ i s ɛ ʃ ə n ə l
recluse	ɹ i k l u s
reconnaissance	ɹ ɪ k ɑ n ə s ə n s
reconnects	ɹ i k ə n ɛ k t s
recounted	ɹ ɪ k aʊ n t ɪ d
recounts	ɹ ɪ k aʊ n t s
recoveries	ɹ ɪ k ʌ v ɹ i z
recovery	ɹ ɪ k ʌ v ɝ i
recuperate	ɹ i k u p ɝ eɪ t
recurs	ɹ ɪ k ɝ z
redacted	ɹ ɪ d æ k t ɪ d
redeem	ɹ i d i m
redeemed	ɹ i d i m d
redevelopment	ɹ i d ɪ v ɛ l ə p m ə n t
redistricting	ɹ i d ɪ s t ɹ ɪ k t ɪ ŋ
redraw	ɹ i d ɹ ɔ
reducible	ɹ ɪ d u s ə b ə l
redundancy	ɹ i d ʌ n d ə n s i
redundant	ɹ i d ʌ n d ə n t
reenactment	ɹ i ɪ n æ k t m ə n t
reestablished	ɹ i i s t æ b l ɪ ʃ t
references	ɹ ɛ f ɹ ə n s ɪ z
referendum	ɹ ɛ f ɝ æ n d ə m
refitted	ɹ i f ɪ t ɪ d
reforma	ɹ ɪ f ɔ ɹ m ə
refueling	ɹ i f j u l ɪ ŋ
refueling	ɹ ɪ f j u l ɪ ŋ
refurbishment	ɹ i f ɝ b ɪ ʃ m ə n t
refuses	ɹ i f j u z ɪ z
regatta	ɹ ɪ ɡ æ d ə
regime	ɹ eɪ z i m
region	ɝ ɪ dʒ ə n
regional	ɝ ɪ dʒ ə n ə l
regionally	ɝ ɪ dʒ ə n ə l i
register	ɹ ɛ dʒ ɪ s t ɹ
rehearsal	ɹ ɪ h ɝ s ə l
rehearsals	ɹ ɪ h ɝ s ə l z
rehearse	ɹ ɪ h ɝ s
rehearsing	ɹ ɪ h ɝ s ɪ ŋ
reichstag	ɹ aɪ k s t æ k
reinhold	ɹ aɪ n h oʊ l t
reinventing	ɹ i ɪ n v ɛ n t ɪ ŋ
relapses	ɹ i l æ p s ɪ z
relativistic	ɹ ɛ l ə t ɪ v ɪ s t ɪ k
relentless	ɹ i l ɛ n t l ə s
reliably	ɹ ɪ l aɪ ə b l i
relied	ɹ i l aɪ d
relies	ɹ i l aɪ z
relinquished	ɹ ɪ l ɪ ŋ k w ɪ ʃ t
rely	ɹ ɪ l aɪ
remember	m ɛ m b ɝ
reminds	ɹ i m aɪ n d s
remittances	ɹ ɪ m ɪ t ə n s ɪ z
removable	ɹ i m u v ə b ə l
removal	ɹ i m u v ə l
remy	ɹ æ m i
rendition	ɹ æ n d ɪ ʃ ə n
rene	ɹ ɪ n
renew	ɹ i n u
rennet	ɹ æ n ɪ t
renuzit	ɹ ɪ n u z ɪ t
repair	ɹ i p ɛ ɹ
repaired	ɹ i p ɛ ɹ d
repealed	ɹ ɪ p i l d
repeated	ɹ i p ɪ t ɪ d
repeats	ɹ i p i t s
repentance	ɹ i p ɛ n t ə n s
replacement	ɹ i p l eɪ s m ə n t
reportable	ɹ ɪ p ɔ ɹ t ə b ə l
reported	ɹ ɪ p ɔ ɹ d ɪ d
repository	ɹ ɪ p ɑ z ə t ɔ ɹ i
repression	ɹ ɪ p ɹ ɛ ʃ ə n
repudiated	ɹ ɪ p j u d i eɪ t ɪ d
requests	ɹ ɪ k w ɛ s
require	ɹ i k w aɪ ɝ
requiring	ɹ i k w aɪ ɹ ɪ ŋ
rerir	ɹ ɪ ɹ ɝ
residential	ɹ ɛ z ɪ d ɛ n ʃ ə l
resigned	ɹ i z aɪ n d
resigned	ɹ i s aɪ n d
resin	ɹ ɛ z ə n
resins	ɹ ɛ z ə n z
resistors	ɹ ɪ z ɪ s t ɝ z
resort	ɹ i z ɔ ɹ t
resort	ɹ ɪ z ɔ ɹ t
resorted	ɹ i z ɔ ɹ t ɪ d
resorting	ɹ i z ɔ ɹ t ɪ ŋ
resorts	ɹ i z ɔ ɹ t s
resource	ɹ i z ɔ ɹ s
resources	ɹ i z ɔ ɹ s ɪ z
restricted	ɹ i s t ɹ ɪ k t ɪ d
retaliate	ɹ i t æ l i eɪ t
retaliated	ɹ i t æ l i eɪ t ɪ d
retaliates	ɹ i t æ l i eɪ t s
retief	ɹ ɪ t i f
retire	ɹ i t aɪ ɝ
retirement	ɹ i t aɪ ɝ m ə n t
retiring	ɹ i t aɪ ɝ ɪ ŋ
retrieved	ɹ ɪ t ɹ i v d
rev	ɹ æ v
revealed	ɹ i v i l t
revered	ɹ i v ɪ ɹ d
reverend	ɹ ɛ v ɝ ə n t
reverts	ɹ ɪ v ɝ t z
revision	ɹ ɪ v ɪ ʒ ə n
revisions	ɹ ɪ v ɪ ʒ ə n z
revue	ɹ i v j u
reworked	ɹ i w ɝ k t
rewritten	ɹ i ɹ ɪ d ə n
rhetoric	ɹ ɛ d ɝ ɪ k
rhetoric	ɹ ɛ t ɹ ɪ k
rhetoric	ɹ ɛ t ɝ ɪ k
rhodesia	ɹ oʊ d i ʃ ə
rhythmic	ɹ ɪ θ m ɪ k
ricard	ɹ ɪ k ɑ ɹ d
rich's	ɹ ɪ tʃ ɪ s
rickson	ɹ ɪ k s ə n
ridden	ɹ ɪ t ə n
riddler	ɹ ɪ d l ɝ
rideau	ɹ i d oʊ
rider	ɹ aɪ t ɝ
ridge	ɹ i dʒ
riding	ɹ aɪ t ɪ ŋ
ridings	ɹ aɪ t ɪ ŋ z
rieder	ɹ i d ɝ
rigger	ɝ ɪ ɡ ɝ
rink	ɹ ɪ ŋ ɡ
rinne	ɹ ɪ n
rita	ɹ i d ə
rivera	ɹ i v ɛ ɹ ə
riverine	ɹ ɪ v ɝ ɪ n
rives	ɹ i v z
roberta	ɹ ə b ɝ t ə
robot	ɹ oʊ b ɑ t
rodrigo	ɹ ɑ d ɹ i k oʊ
romanesque	ɹ oʊ m ə n æ s k
romanoff	ɹ oʊ m ə n ɔ v
ron	ɹ ʌ n
roofs	ɹ u v s
roofs	ɹ u v z
ropp	ɹ ɑ p
rotary	ɹ oʊ d ɝ i
rotis	ɹ oʊ t i z
rotor	ɹ oʊ d ɝ
rotors	ɹ oʊ d ɝ z
route	ɹ u d
routes	ɹ u d z
rowdy	ɹ aʊ t i
roxbury	ɹ ʌ k s b ɛ ɹ i
rubberneck	ɹ ʌ b ɝ n æ k
rudder	ɹ ʌ t ɝ
rudman	ɹ ʌ d m ə n
rudolf	ɹ u d ɑ l f
ruins	ɹ u ə n z
rummell	ɹ ɑ m ə l
runoff	ɹ ɑ n ɔ f
runoff	ɹ ʌ n ɔ f
rupert	ɹ u b ɝ t
rural	ɹ u ɹ ə l
ruskin's	ɹ ʌ ʃ k ɪ n z
russian	ɹ ɑ ʃ ə n
russian	ɹ ɑ ʃ ə m
rustling	ɹ ʌ s l ɪ ŋ
rutherford	ɹ ʌ ð ɝ f ɝ d
rutherford	ɹ ʌ ð ɝ f ɝ t
safari	s ə v ɑ ɹ i
said	s ɛ t
said	s æ d
salamander	s ɛ l ə m æ n d ɝ
salmon	s ɛ m ə n
salvatore	s æ l v ə t ɔ ɹ i
salvatore	s æ l v ə t ɔ ɹ
sam's	s æ m s
sami	s æ n i
sami	s ɛ m i
sanitarium	s æ n ə t ɛ ɹ i ə n
sanskrit	s æ m s k ɹ ɪ t
saracen	s ɛ ɹ ə s ə n
sarafina	s ɛ ɹ ə f i n ə
saran	s ɝ ɛ n
sardinian	s ɑ ɹ d ɪ n i ə n
satisfactorily	s æ t ə s f æ k t ɝ ə l i
saudi	s aʊ t i
sayers	s eɪ ɹ z
says	s æ z
scarab	s k ɛ ɹ ə b
scarecrow	s k ɛ ɹ k ɹ oʊ
scene	s i m
scene	s ɪ ŋ
schneerson's	ʃ n ɪ ɹ s ə n z
schram	ʃ ɹ æ m
science	s aɪ ə n z
scions	s aɪ ə n s
screen	s k ɹ i m
scripted	s k ɹ ɪ p t ɪ d
seaboard	s i p ɔ ɹ t
seaford	s i f ɝ t
seamless	s i n l ə s
seastrand	s i s t ɹ æ n d
seating	s i d ɪ ŋ
seats	s i d z
secombe	s ɪ k ə m
secretion	s ɪ k ɹ i ʃ ə n
sedatives	s ɛ t ə t ɪ v z
see	s ɪ
see	ʃ i
seeded	s i t ɪ d
segment	s ɛ k m ə n t
sekhar	s æ k ɑ ɹ
seleucia	s ə l u s i ə
selma	s æ l m ə
semantic	s ɪ m ɛ n t ɪ k
semaphore	s æ m ə f ɔ
semaphore	s æ m ə f ɔ ɹ
semmering	s æ m ɝ ɪ ŋ
semtex	s æ m t æ k s
senatorial	s æ n ə t ɔ ɹ i ə l
sensors	s ɛ n s ɝ s
sent	s ɛ n d
servants	s ɝ f ə n t s
servers	s ɝ f ɝ z
serves	s ɝ v s
service	s ɝ f ə s
service	s ɝ v ə z
services	s ɝ f ə s ə z
serving	s ɝ v ɪ n
setback	s ɛ d b æ k
sevens	s ɛ v ə n s
severn	s ɛ v ə n
shafran	ʃ ɛ f ɹ ə n
shakespeare	ʃ eɪ k s p ɪ ɹ
shakespeare's	ʃ eɪ k s p ɪ ɹ z
shapira	ʃ ə p ɪ ɹ ə
shaquille	ʃ ə k ɪ l
she	s i
shed	ʃ ɛ t
shedding	ʃ ɛ t ɪ ŋ
sheerness	ʃ ɪ ɹ n ə s
shenandoah	ʃ æ n ə n d oʊ ə
sheri	ʃ ɛ ɹ i
shibuya	ʃ i b u j ə
ship	ʃ i p
shire	ʃ aɪ ɝ
shires	ʃ aɪ ɝ z
shirin	ʃ ɪ ɹ ə n
show's	ʃ oʊ s
shuswap	ʃ u s w ɑ p
shuswap	s u ʃ w ɑ p
siblings	s ɪ p l ɪ ŋ z
side	s aɪ t
sides	s aɪ t s
sieg	s i k
sigel	s i k ə l
sikkim	s ɪ k i m
silvestri	s ɪ l v ɛ s t ɹ i
simone	s i m oʊ n
singapore	s ɪ ŋ ə p ɔ ɹ
sires	s aɪ ɝ z
sister	s ɪ s t ɹ
sizes	s aɪ s ɪ z
skid	s k ɪ t
skier	s k i ɹ
skittles	s k ɪ d ə l z
slapper	s l æ p ɝ
slater	s l eɪ d ɝ
snigger	s n ɪ k ɝ
soccer	s ʌ k ɝ
sociologists	s oʊ ʃ i ɑ l ə dʒ ɪ s t s
sociology	s oʊ ʃ i ɑ l ə dʒ i
sodom	s ɑ t ə m
software	s ɔ f t w ɛ
sombre	s ɑ m b ɝ
sombre	s ɑ m b ɹ
sondra	s ɑ n d ɹ ə
song	ʃ ɔ ŋ
song	s ʌ ŋ
song	s ɑ n
song	s ɔ n
sonic	s ɑ m ɪ k
sonning	s ʌ n ɪ ŋ
soviet	s oʊ f i ɛ t
soybean	s ɔɪ b i m
spanned	s p ɛ n t
speaking	s p i k ɪ n
spearheaded	s p ɪ ɹ h ɛ d ɪ d
species	s p i s ɪ z
specifying	s p ɛ s ə f aɪ ɪ n
spectrometry	s p ɛ k t ɹ ɑ m ə t ɹ i
specular	s p ɛ k j ə l ɝ
spell	s p æ l
spelled	s p ɛ l t
spherical	s f ɪ ɹ ɪ k ə l
spinoza	s p ɪ n oʊ z ə
spinoza's	s p ɪ n oʊ s ə z
spire	s p aɪ ɝ
spires	s p aɪ ɝ z
spitzer	s p ɪ t s ɝ
spoiled	s p ɔɪ l t
sporadic	s p ɝ æ t ɪ k
sporadically	s p ɝ æ t ɪ k l i
spouses	s p aʊ s ɪ z
sprit	s p ɹ ɪ
sproull	s p ɹ u l
squire	s k w aɪ ɚ
sri	ʃ ɹ i
sta	s t ɑ
stabilized	s t eɪ p ə l aɪ z d
stamford	s t æ n f ɝ d
stanislaus	s t æ n ɪ s l ɔ z
staples	s t eɪ b ə l z
stardust	s t ɑ ɹ d ə s t
starred	s t ɑ ɹ t
started	s t ɑ d ɪ d
stat	s t æ d
state	s t eɪ d
steer	s t i ɹ
stein	ʃ t aɪ n
stena	s t æ n ə
sterling	s t ɝ l ɪ n
steward	s t u ɝ t
stewardship	s t u ɝ t ʃ ɪ p
stillborn	s t ɪ l b ɔ ɹ n
stolberg	ʃ t oʊ l b ɝ ɡ
strasbourg	s t ɹ æ z b ɔ ɹ ɡ
strasburg	s t ɹ æ z b ɝ ɡ
strasser	s t ɹ æ s ɝ
strathspey	s t ɹ æ θ s b i
streaker	s t ɹ i k ɝ
street	ʃ t ɹ i t
stresses	s t ɹ ɛ s ə s
stringed	s t ɹ ɪ ŋ d
striptease	s t ɹ ɪ p t i z
stroop	s t ɹ u p
stroudsburg	s t ɹ aʊ d s b ɝ ɡ
stuck	s t ɑ k
study	s t ɑ d i
stukas	s t u k ə s
stuttgart	s t ʊ d ɡ ɑ ɹ t
subplots	s ʌ b p l ʌ t s
subspecies	s ʌ b s p i s i z
substandard	s ʌ b s t æ n d ɝ d
sufferings	s ʌ f ɹ ɪ ŋ z
sulfuric	s ə l f j ʊ ɹ ɪ k
summerside	s ʌ m ɝ s aɪ t
sun	s ʌ m
sunni	s u m i
supermarkets	s u p ɝ m ɑ ɹ k ɪ t s
superstars	s u p ɝ s t ɑ ɹ z
supremacist	s u p ɹ ɛ m ə s ɪ s t
surat	s ɹ ɑ t
surfaces	s ɝ v ə s ə z
surfing	s ɝ f ɪ n
surrounded	s ɚ aʊ n d ɪ d
swami	ʃ w ɑ m i
swimwear	s w ɪ m w ɛ ɹ
swinging	s w ɪ n ɪ ŋ
swithun's	s w ɪ ð ə n z
symphony	s ɪ n f ə n i
syracusan	s ɪ ɹ ə k j u s ə n
syracuse	s ɪ ɹ ə k j u s
taffeta	t æ f ə d ə
taggart	t ɛ ɡ ɝ t
tait	t eɪ d
taken	t eɪ k ə ŋ
talmud	t æ l m ə t
tan's	t ɛ n z
tandem	d æ n d ə m
tang	t ɛ n
tangier	t æ n dʒ ɪ ɹ
tanning	t ɛ n ɪ ŋ
tantric	t ɛ n t ɹ ɪ k
tara	t ɛ ɹ ə
tardiness	t ɑ ɹ d ɪ n ə s
tatiana	t æ t i ɛ n ə
tatum	t eɪ d ə m
team	t i n
team	t ɪ m
tear	t ɛ ɹ
technetium	t æ k n i ʃ i ə m
teen	t i m
teenage	t ɪ n eɪ dʒ
teenager	t i m eɪ dʒ ɝ
teenagers	t i m eɪ dʒ ɝ z
teens	t i m z
telemarketing	t ɛ l ə m ɑ ɹ k ə t ɪ ŋ
telemetry	t ə l æ m ə t ɹ i
telugu	t æ l u ɡ u
telugu	t ɛ l u ɡ u
terasawa	t ɛ ɹ ə s ɑ w ə
termini	t ɝ m i n i
terminology	t ɝ m ə n ɑ l ə dʒ i
terrain	t ɹ eɪ n
terror	t ɛ ɹ
test	t æ s t
tet	t ɛ d
texas	t æ k s ə s
text	t æ k s t
texts	t æ k s
thamyris	t æ m ɪ ɹ ɪ z
thamyris	t æ m ɪ ɹ ɪ s
than	ð ɛ n
that	θ æ t
thats	ð æ t s
the	ð
the	θ i
the	θ ə
the	θ ɪ
their	θ ɛ ɹ
them	ð ə n
them	ð ɛ n
theme	θ i n
theorem	θ i ɝ ə m
theorems	θ i ɝ ə m z
theories	θ ɪ ɝ i z
theory	θ ɪ ɝ i
therapists	θ ɛ ɹ ə p ɪ s t s
there	ð ɛ
these	ð ɪ s
these	ð i s
these	ð ɪ z
thessalian	θ ɛ s eɪ l i ə n
thessaly	θ ɛ s ə l i
thin	θ ɪ ŋ
this	θ ɪ s
thom	t ɑ n
thracian	θ ɝ eɪ ʃ ə n
thus	θ ʌ s
thwarted	θ w ɔ ɹ t ɪ d
tibetan	t ɪ p ɛ t ə n
tidal	t aɪ t ə l
tiers	t ɪ ɹ z
timing	t aɪ m i ŋ
timms	t ɪ n z
timor	t ɪ m ɔ ɹ
timur	t i m ɝ
tin	t ɪ m
tissue	t ɪ ʃ j u
tito	t ɪ t oʊ
to	d ɪ
to	d u
to	d i
toledo	t ə l i t oʊ
toman	t ɑ m ə n
tong	t ɔ n
top	t ɑ b
torre	t ɔ ɹ
tosh	t ʌ ʃ
total	t oʊ d ə l
tour	t ɔ
tourist	t ʊ ɹ ə s t
tourists	t ʊ ɹ ə s t s
tours	t ɔ ɹ z
town	d aʊ n
trader	t ɹ eɪ t ɝ
traders	t ɹ eɪ t ɝ z
transcanada	t ɹ æ n z k æ n ə d ə
transcendental	t ɹ æ n s ə n d ɛ n ə l
transgender	t ɹ æ n z dʒ ɛ n d ɝ
transit	t ɹ æ m z ɪ t
transliterated	t ɹ æ n z l ɪ t ɝ eɪ t ɪ d
transliteration	t ɹ æ n z l ɪ t ɝ eɪ ʃ ə n
translucency	t ɹ æ n z l u s ə n s i
transmitter	t ɹ æ n z m ɪ t ɝ
transmitters	t ɹ æ n z m ɪ t ɝ z
transmitting	t ɹ æ n z m ɪ t ɪ ŋ
transport	t ɹ æ n s p ɔ t
trek	t ɹ æ k
trekkers	t ɹ æ k ɝ z
tremor	t ɹ æ m ɝ
tremors	t ɹ æ m ɝ z
tremp	t ɹ ɛ n p
trends	t ɹ ɛ n d s
trinidad	t ɹ ɪ n i d æ d
trinity	t ɹ ɪ n ɪ d i
trumbull	t ɹ ɑ m b ə l
trump	t ɹ ɑ m p
tubas	t u b ə s
tudor	t u t ɝ
tuned	t u m d
turmeric	t ɝ m ɹ ɪ k
turn	t ɝ m
twelve	t w ɛ l f
tyne	t aɪ m
tyres	t aɪ ɝ z
ulterior	ɑ l t ɪ ɹ i ɝ
umbrella	ə n b ɹ ɛ l ə
unborn	ʌ n b ɔ ɹ n
uncle	ɑ n k ə l
undemocratic	ə n d ɛ m ə k ɹ æ t ɪ k
unpleasant	ɑ n p l ɛ z ə n t
unread	ə n ɹ ɛ d
unreleased	ʌ n ɹ i l i s t
unrepentant	ʌ n ɹ ɪ p ɛ n t ə n t
unscripted	ə n s k ɹ ɪ p t ɪ d
urdu	ɹ d u
urine	j ʊ ɹ ə n
usable	j u s ə b ə l
used	j u s d
usher	ɑ ʃ ɝ
using	j u z ɪ n
usurping	j u z ɝ p ɪ ŋ
utica	j u d ɪ k ə
valdivian	v ɑ l d ɪ v i ə n
valerian	v ə l ɪ ɹ i ə n
validity	f ə l ɪ d ɪ t i
vampire	v æ m p aɪ ɝ
vampires	v æ m p aɪ ɝ z
van	v ɛ n
vance	v æ n z
vargas	v ɑ ɹ ɡ ə s
various	v ɛ ɹ i ə ʃ
varma	v ɑ ɹ m ə
varney's	f ɑ ɹ n i z
varzi	v ɑ ɹ z i
vassal	v ɛ s ə l
vatican	v æ d ɪ k ə n
vendor	v æ n d ɝ
venezuela	v ɛ n ɪ s w eɪ l ə
venezuelan	v ɛ n ɪ s w eɪ l ə n
venue	v æ n j u
verbose	v ɝ b oʊ s
verdugo	v ɝ d u k oʊ
vernon	f ɝ n ə n
vero	f ɛ ɹ oʊ
verse	f ɝ s
vertically	v ɝ t ɪ ɡ l i
very	f ɛ ɹ i
vesicles	v ɛ s ɪ k ə l z
veto	v i d oʊ
viana	v i ɛ n ə
video	v i d i oʊ
viennese	v i ɛ n i z
vietnam	v i æ t n ɑ m
vigour	v ɪ ɡ ɝ
vince	v ɪ m s
vis	v ɪ z
vision	v ɪ ʃ ə n
visionary	v ɪ ʃ ə n ɛ ɹ i
vital	f aɪ t ə l
vocals	f oʊ k ə l z
waded	w eɪ t ɪ d
wading	w eɪ t ɪ ŋ
wagner	v ɑ ɡ n ɝ
waiting	w eɪ d ɪ ŋ
walking	w ɔ k ɪ n
walmart	w ɔ l m ɑ ɹ t
walmsley	w ɔ l m z l i
ward	w ɔ ɹ t
warwickshire	w ɔ ɹ w ɪ k ʃ aɪ ɝ
water	w ɔ ɾ ɝ
water	w ɔ t ɚ
waterman	w ɔ d ɝ m ə n
waters	w ɑ t ɝ z
web	w ɛ p
week	w ɪ k
wees	w i s
weever	w i v ɝ
wesley's	w ɛ s l i z
wesleyan	w ɛ s l i ə n
wha	w ɑ
where	w ɛ ɹ
where's	w ɛ ɹ z
whereas	w ɛ ɹ æ z
wherein	w ɛ ɹ ɪ n
wherever	w ɛ ɹ ɛ v ɝ
whichever	w ɪ tʃ ɛ v ɝ
whittling	w ɪ d ə l ɪ ŋ
wicked	w ɪ k d
wide	w aɪ t
wilder	w ɪ l d ɝ
willamette	w ɪ l ə m æ t
willesden	w ɪ l s t ə n
wimbledon	w ɪ m b ə l t ə n
wind	w ɪ m d
wingo	w ɪ ŋ ɡ oʊ
wings	w ɪ n z
winslow	w ɪ n z l oʊ
winslow's	w ɪ n z l oʊ z
winter	w ɪ n ɝ
winterbourne	w ɪ n t ɝ b ɔ ɹ n
wireless	w aɪ ɝ l ə s
wires	w aɪ ɝ z
wisner	w ɪ z n ɝ
without	w ɪ θ aʊ t
wolverhampton	w ʊ l f ɝ h æ m p t ə n
wooded	w u d ɪ d
wreck	ɹ æ k
wrestler	ɹ ɛ s l ɝ
wrestlers	ɹ ɛ s l ɝ z
wrestling	ɹ ɛ s l ɪ n
writer	ɹ aɪ d ɝ
writing	ɹ aɪ d ɪ ŋ
written	ɹ ɪ d ə n
xander	z æ n d ɝ
xavier	s eɪ v j ɝ
xtra	ɛ k s t ɹ ə
yakin	j æ k i n
yeah	j ɛ
years	j ɪ ɚ z
yiddish	j ɪ t ɪ ʃ
yogurt	j oʊ ɡ ɝ d
yorkshire	j ɔ ɹ k ʃ ɝ
yorkshire	j ɔ ɹ k ʃ aɪ ɝ
you	j ʊ
you're	j ʊ ɹ
young	j ʌ n
youre	j u ɹ
z	s
z	s ɛ d
zambia	s æ m b i ə
zambian	s æ m b i ə n
zander	s æ n d ɝ
zani	s ɑ n i
zappa	s æ p ə
zero	z i ɹ oʊ
zia	s i ə
ziegler	z ɪ ɡ l ɝ
zimmer	s ɪ m ɝ
zimmerman	s ɪ m ɝ m ə n
zone	s oʊ n
zoned	s oʊ n d
zoo	s u
zoology	s u ɑ l ə dʒ i
