a	ʌ
a	ɛ
abdomen	æ p d ə m ə n
abdomens	æ b d ə m ə n z
abe	eɪ p
abelian	ə b ɪ l i ə n
abercromby	æ p ɝ k ɹ ɑ m b i
aberdeen	æ p ɝ d i n
aberdeenshire	æ b ɝ d i n ʃ aɪ ɝ
aberrations	æ p ɝ eɪ ʃ ə n z
abingdon	æ p ɪ ŋ d ə n
able	eɪ p ə l
abnormalities	æ b n ɔ ɹ m æ l ə d i z
aborigines	æ b ɝ ɪ dʒ ə n i s
aborted	ə b ɔ ɹ d ɪ d
above	ə b ʌ f
abroad	ə b ɹ ɔ t
absalom	æ p s ə l ə m
absent	æ p s ə n t
abutted	ə b ʌ d ɪ d
abutting	ə b ʌ d ɪ ŋ
academicians	æ k ə d ə m i ʃ ə n z
academy's	ə k æ d ə m ɪ s
acarnania	ɑ k ɑ ɹ m eɪ n i ə
acceleration	æ ɡ s ɛ l ɝ eɪ ʃ ə n
accepting	ɪ k s ɛ p t ɪ n
accidental	ɛ k s ə d ɛ n ə l
accra	æ k ɝ ə
accreted	ə k ɹ i t ɪ d
acetylene	ə s ɛ t ə l ɪ ŋ
achieve	ə tʃ i f
achilles	ə k i l i z
acid	æ s ɪ t
acidic	ə s ɪ t ɪ k
acidic	ə s i t ɪ k
acids	æ s ə t z
acids	æ s ɪ t s
acme	æ k n i
acquire	ə k w aɪ ɹ
acquisition	æ k w ə s ɪ ʃ ə n
acres	eɪ k ɝ s
acres	eɪ ɡ ɝ z
act	ɛ k t
action	æ k s ə n
activist	æ k t ɪ f ɪ s t
actor	ɛ k t ɝ
acts	ɛ k s
acuity	ə k j u ə d i
adam	æ t ə m
adams	æ t ə m z
add	æ t
added	æ d ɪ t
added	ɛ d ɪ d
adders	æ t ɝ z
addict	ɛ d ɪ k t
addington	æ t ɪ ŋ t ə n
addison	ɛ d ɪ s ə n
additionally	ə d ɪ s ə n ə l i
additive	ɛ d ə t ɪ v
additives	æ d ɪ d ɪ v z
addressed	ə t ɹ ɛ s t
adds	æ d s
adherents	æ d h ɪ ɹ ə n t s
adidas	ə d i t ə s
adidas	ə d i d ə z
adirondack	æ t ɝ ɑ n d æ k
adirondacks	æ t ɝ ɑ n d ɛ k s
adjoint	ə dʒ ɔɪ n d
adkins	æ t k ɪ n z
adler	æ t l ɝ
administration	æ d m ɪ n ɪ s t ɹ eɪ s ə n
admire	æ d m aɪ ɝ
admired	æ d m aɪ ɝ d
adolescence	æ t ə l ɛ s ə n s
adriatic	eɪ t ɹ i æ t ɪ k
adrienne	æ d ɝ i ɛ n
advances	ə d v æ n s i z
adventure	ə d v ɛ n tʃ ɝ
adverb	æ t f ɝ b
adversarial	æ d v ɝ s ɛ ɹ i ə l
advert	æ d f ɝ t
advertorial	æ d v ɝ t ɔ ɹ i ə l
advertorials	æ d v ɝ t ɔ ɹ i ə l z
adverts	æ d f ɝ t s
adverts	æ d v ɝ d z
advice	æ d v aɪ z
advise	æ d v aɪ s
aegyptus	ɪ dʒ ɪ p t ə s
aeration	ɹ eɪ ʃ ə n
aero	æ ɹ oʊ
aerobatic	ɛ ɹ ə b æ t ɪ k
aerobatic	æ ɹ ə b ɛ t ɪ k
aerobatic	æ ɹ ə b æ t ɪ k
aerobatics	ɛ ɹ ə b æ t ɪ k s
aerobatics	æ ɹ ə b æ t ɪ k s
aerosol	ɛ ɹ ə s ɔ l
aerosol	æ ɹ ə s ɔ l
aesthetic	æ s θ ɛ t ɪ k
aesthetic	ə s θ ɛ t ɪ k
aesthetics	æ s θ ɛ t ɪ k s
affect	ə f ɛ k d
affiliated	ə f i l i eɪ t ɪ d
affordable	ə f ɔ ɹ t ə b ə l
afghan	æ f k ə n
afire	ə f aɪ ɝ
africa	æ f ɹ i k ə
african	æ f ɹ ɪ ɡ ə n
african	æ f ɹ ə ɡ ə n
africans	æ f ɹ ɪ k ə n z
africans	ɛ f ɹ ɪ k ə n z
afrikaner	æ f ɹ ə k ɑ n ɝ
after	æ v t ɝ
aftermath	ɛ f t ɝ m æ θ
afterwards	æ f t ɚ w ɝ d z
again	ə ɡ æ n
aggregate	æ ɡ ɹ ə ɡ eɪ d
aggregations	ɛ ɡ ɹ ə ɡ eɪ ʃ ə n z
agnes	æ ɡ n i z
agnostic	æ k n ɑ s t ɪ k
agoutis	ə ɡ u t i z
aguinaldo	ɑ ɡ w ɪ n ɑ l d oʊ
ahmed	ɑ m æ d
ahmeek	ɑ m i k
ahmet	ɑ m ə d
aid	eɪ t
aids	eɪ t s
ainsworth	eɪ n z w ɝ θ
air	æ
air	æ ɹ
airborne	ɛ ɹ b ɔ ɹ m
airbus	ɛ ɹ b ə s
aircraft's	ɛ ɹ k ɹ æ f t s
aircrafts	ɛ ɹ k ɹ æ f t s
airdrop	ɛ ɹ d ɹ ɑ p
airdrops	ɛ ɹ d ɹ ɑ p s
aired	ɛ ɹ t
aires	ɛ ɹ i z
airfields	ɛ ɹ f i l d z
airforce	ɛ ɹ f ɔ ɹ s
airing	ɛ ɹ ɪ n
airlifted	ɛ ɹ l ɪ f t ɪ d
airplane	ɛ ɹ p l eɪ ŋ
airport's	ɛ ɹ p ɔ ɹ t s
airspeed	ɛ ɹ s p i d
airstrip	ɛ ɹ s t ɹ ɪ p
airworthiness	ɛ ɹ w ɝ ð i n ə s
akira	ə k ɪ ɹ ə
akron	æ k ɝ ə n
al	ɛ l
alabamas	æ l ə b æ m ə z
alameda	æ l ə m i t ə
alan	ɛ l ə n
alastair	æ l ə s t ɝ
albatross	æ l p ə t ɹ ɑ s
albemarle	æ l b ə m ɑ ɹ ə l
albert	æ l b ɝ d
alberta	ɛ l b ɝ t ə
alberton	æ l b ɝ t ə n
album	æ l b ə n
album	ɛ l b ə m
album	æ l p ə m
albums	ɛ l p ə n s
albuquerque	æ l p ə k ɝ k i
alcatraz	æ l k ə t ɹ æ s
alcohol	ɛ l k ə h ɔ l
aldrin	ɔ l d ɹ ɪ n
alegre	ə l ɛ ɡ ɹ
aleister	æ l ɪ s t ə
aleksander	æ l ə ɡ z æ n d ɝ
aleksandr	æ l ə ɡ z æ n d ɝ
aleksandr	ɛ l ə ɡ z æ n d ɝ
alesia	ə l i ʒ ə
aleta	æ l i t ə
aleut	ə l u d
alexander	æ l ə ɡ s æ n d ɝ
alexander	æ l ə ɡ z æ n d ɹ
alexandra's	æ l ə ɡ z æ n d ɹ ə s
alf	ɛ l f
alfonso's	æ l f ɑ n s oʊ s
alfre	æ l f ɹ i
alfre	æ l f ɹ
alfred	æ l f ɹ ɪ t
alfredo	ɛ l f ɹ eɪ d oʊ
algorithm	æ l k ɝ ɪ ð ə m
ali	ɛ l i
alice	ɛ l ə s
alicia	ə l i ʃ i ə
alicia's	ə l ɪ s ə z
alie	ɛ l i
alison	ɛ l ɪ s ə n
allan	ɛ l ə n
allen	ɛ l ə n
allen's	æ l ə m z
allergies	æ l ɝ dʒ i z
alliance	ə l aɪ ə n z
allocated	æ l ə ɡ eɪ t ɪ d
allyson	ɛ l ɪ s ə n
alma	ɛ l m ə
almsgiving	ɑ l m z ɡ ɪ v ɪ ŋ
alnwick	æ l m w ɪ k
alomar	æ l ə m ɑ ɹ
alone	ə l oʊ m
alongside	ə l ɔ n s aɪ d
alphanumeric	æ l f ə n u m ɛ ɹ ɪ k
alps	æ l b s
also	ɔ l z oʊ
alternate	ɔ l t ɝ m eɪ t
althea's	ɛ l θ i ə z
altos	æ l t oʊ s
alva's	æ l f ə z
alvarez	æ l f ɝ ɛ z
alveolar	æ l v i l ɝ
amar	ə m ɑ ɹ
amas	ɑ m ə s
ambassador	æ m b æ s ə t ɝ
ambivalence	ɛ m b ɪ v ə l ə n s
ambivalent	ɛ m b ɪ v ə l ə n t
ambrose	æ m b ɹ oʊ s
amended	ə m æ n d ɪ d
amendment	ə m æ n d m ə n t
amendments	ə m æ n d m ə n t s
america's	ə m ɛ ɹ ɪ k ə s
american	ə m ɛ ɹ ɪ k ə n
americas	ə m ɛ ɹ ɪ k ə s
ames	eɪ n z
amick	ɛ m ɪ k
amiga	ə m i k ə
amir	ɑ m ɪ ɹ
amir	ə n ɪ ɹ
amma	ɛ m ə
amma	ɑ m ə
ammonium	ə m oʊ m i ə m
amnesty	ɛ m n ə s t i
amos	eɪ m ə z
amphetamine	æ m f ɛ d ə m i n
amphetamines	ɛ m f ɛ d ə m i n z
amphetamines	æ m f ɛ d ə m i n z
amplifier	æ m p l ə f aɪ ɚ
amsterdam	æ m s t ɚ d æ m
amtrak	æ m t ɹ æ k
amtrak	æ n t ɹ æ k
amtrak's	æ m t ɹ æ k s
amtrak's	ɛ m t ɹ ɛ k s
amylin	ɛ m ə l ɪ n
an	ɛ n
an	æ m
an	ɛ m
an	æ ŋ
ana	ɛ n ə
anaheim	æ n ə h aɪ n
analog	æ m ə l ɑ ɡ
analyses	ə n æ l ɪ s ɪ s
analysis	ə n æ l ɪ s ɪ z
ananas	ə n æ n ə s
anceps	ɛ n s ɛ p s
anchorages	æ ŋ k ɝ ɪ dʒ ɪ z
anchorman	æ ŋ ɡ ɝ m ə n
and	ɛ n d
and	æ n t
and	æ m t
and	ɛ n t
and	æ m d
and	ə n t
andalusian	æ n d ə l u ʒ ə n
andersen	ɛ n d ɝ s ə n
anderson	ɛ n d ɝ s ə n
andorra	ɛ n d ɔ ɹ ə
andover	ɛ n d oʊ v ɝ
andreotti	æ n d ɹ i ɑ t i
andretti	æ n d ɹ ɛ t i
andretti	æ n d ɹ ɛ d i
andrew	æ n t ɹ u
androgynous	ɛ n d ɹ ɑ dʒ ə n ə s
android	æ n d ɹ ɔɪ t
android	ɛ n d ɹ ɔɪ d
andros	æ ŋ d ɹ oʊ z
andy	æ n d ɪ
angela	æ ŋ dʒ ə l ə
angela's	æ n dʒ ə l ə s
angeles	æ n dʒ ə l i z
angeles	æ n dʒ ə l i s
anger	æ ŋ k ɝ
angered	æ ŋ k ɝ d
angie	ɛ n dʒ i
angier	ɛ n dʒ ɪ ɹ
anglers	æ ŋ k l ɝ z
anglican	æ ŋ ɡ l ɪ ɡ ə n
angola	æ n ɡ oʊ l ə
angst	ɛ ŋ k s t
anguilla	æ ŋ ɡ w i l ə
anguissola	æ n ɡ w ɪ z oʊ l ə
angus	æ n ɡ ə s
anime	ɛ n ə m
animus	ɛ n i m ə s
anita	ə n i d ə
anjitsu	æ n dʒ ɪ t s u
anjou	ɛ n dʒ u
ankles	æ ŋ ɡ ə l z
ankrom	æ ŋ k ɹ ə m
ann	æ m
ann	ɛ n
anna	ɛ n ə
anne	ɛ n
annett	ə n æ t
annexation	æ n ɛ k z eɪ ʃ ə n
annie	ɛ n i
anorexia	æ n ɝ æ k s i ə
another	æ n ʌ ð ɝ
another	ə m ʌ ð ɝ
another	ə n ɑ ð ɝ
ansaldo	æ n s ɑ l t oʊ
ansari	ɑ n s ɑ ɹ i
anson	æ n s ə m
answer	æ n s ə
ant	æ n d
antarctic	æ n ɑ ɹ t ɪ k
antennas	æ n t ɛ n ə s
anthem	ɛ n θ ə n
anthropometric	æ n θ ɹ ə p ə m æ t ɹ ɪ k
antiballistic	æ n t i p ə l ɪ s t ɪ k
antietam	æ n t i d ə m
antietam	æ n t i t ə n
antifreeze	æ n t i f ɹ i z
anting	æ n t i ŋ
antipas	æ n t i p ə s
antiques	æ n t ɪ k s
antiquities	æ n t ɪ k w ə t i s
antiwar	æ n t i w ɔ ɹ
anwar	æ n w ɑ ɹ
anywhere	ɛ n i w ɛ ɹ
aortic	eɪ ɔ ɹ d ɪ k
aphelion	ə f i l i ə n
apodictic	æ p ə t ɪ k t ɪ k
appeal	ə p ɪ l
appeals	ə p i l s
appearance	ə p ɪ ɹ ə n z
appellate	ə p æ l ə t
apple	ɛ p ə l
applegate	æ b ə l ɡ eɪ t
appleshare	æ p ə l ʃ ɛ ɹ
application	æ p l ə ɡ eɪ ʃ ə n
applications	æ p l ə k eɪ ʃ ə n s
applied	ə p l aɪ t
apprenticeship	ə p ɹ ɛ n t ɪ s ʃ ɪ p
approach	ə b ɹ oʊ tʃ
apraxia	ə p ɹ æ k s i ə
apricots	æ p ɹ ə k ɑ t s
apse	æ b z
aquatic	ə k w ɛ t ɪ k
aquatic	ə k w ɑ d ɪ k
arab	ɛ ɹ ə b
arabella	ɛ ɹ ə b ɛ l ə
arable	ɛ ɹ ə b ə l
aragon	ɛ ɹ ə ɡ ə n
aragon	ɛ ɹ ə k ə n
aragua	ɹ ɑ k w ə
arak	ɛ ɹ ə k
aramaic	æ ɹ ə m eɪ ɪ k
aramid	ɛ ɹ ə m ɪ t
aran	ɛ ɹ ə n
aras	ɑ ɹ ə s
arbitron	ɑ ɹ b ə t ɹ ɑ n
arboretum	ɑ ɹ b ɝ i d ə m
arboretum	ɑ ɹ p ɝ i d ə m
arbutus	ɑ ɹ b ə d ə s
arby's	ɑ ɹ b i z
arcand	ɑ ɹ k ə n d
archaeological	ɑ ɹ ɡ i ə l ɑ dʒ ɪ k ə l
arctic	ɑ ɹ t ɪ k
ardrey	ɑ ɹ d ɝ i
are	ɹ
are	æ ɹ
are	ʌ ɹ
are	ɛ ɝ
area's	ɛ ɹ i ə z
areas	ɛ ɹ i ə s
arena	ɹ ɪ n ə
arena	ɹ i n ə
aretha	ɹ i θ ə
argentinian	ɑ ɹ dʒ ə n t ɪ n i ə n
argos	ɑ ɹ ɡ oʊ s
argued	ɑ ɹ k j u d
argument	ɑ ɹ ɡ j u m ə n t
arianism	ɛ ɹ i ə n ɪ z ə m
arians	ɛ ɹ i ə n z
arias	ɑ ɹ i ə s
arid	ɛ ɹ ɪ d
aris	ɹ i s
arise	ɚ aɪ z
arises	ɹ aɪ z ɪ z
arista	ɝ i s t ə
aristaeus	ɹ ɪ s t eɪ ə s
aristippus	ɹ ɪ s t ɪ p ə s
aristocrat	ɹ ɪ s t ə k ɹ æ t
aristocrat	ɛ ɹ ɪ s t ə k ɹ æ t
arithmetic	ɛ ɹ ɪ θ m æ t ɪ k
arity	ɛ ɹ ɪ t i
arleta	ɑ ɹ l i d ə
arm	ɑ n
armada	ɑ ɹ m ɑ t ə
arman	ɑ ɹ m ə n
armani	ɑ ɹ m ɑ n i
armature	ɑ ɹ m ə tʃ ɝ
armey	ɑ ɹ m i
arming	ɑ ɹ m i n
arminianism	ɑ ɹ m ɪ n i ə n ɪ z ə m
armond	ɑ ɹ m ə n d
armonk	ɑ ɹ m ə ŋ ɡ
arms	ɑ n s
armstrong	ɑ ɹ m ʃ t ɹ ɔ ŋ
army	ɑ ɝ m i
arnaz	ɑ ɹ n æ z
arney	ɑ ɹ n i
arnie	ɑ ɹ n i
arnstein	ɑ ɹ n s t i n
aromas	ɹ oʊ m ə z
aronowitz	ɹ ɑ n ə w ɪ t s
aroostook	ɝ u s t u k
arose	ɹ oʊ z
around	ɹ aʊ n d
around	ɚ aʊ n d
around	ɝ aʊ n t
arquette	ɑ ɹ k ɛ t
arran	ɛ ɹ ə n
arranged	ɹ eɪ n dʒ d
arranged	ɚ eɪ n dʒ d
arrangements	ɚ eɪ n dʒ m ə n t s
arras	ɛ ɹ ə s
array	ɹ eɪ
arrays	ɹ eɪ z
arrested	ə ɝ ɛ s t ɪ d
arrested	ɚ ɛ s t ɪ d
arrests	ɹ ɛ s t s
arrhythmias	ɝ ɪ θ m i ə z
arrivals	ɹ aɪ v ə l z
arrived	ɚ aɪ v d
arrow	ɛ ɹ oʊ
arrow's	ɛ ɹ oʊ z
arrowhead	ɛ ɹ oʊ h ɛ d
arrowheads	æ ɹ oʊ h ɛ d s
arrows	ɛ ɹ oʊ z
arrowsmith	ɛ ɹ oʊ s m ɪ θ
arsenio	ɑ ɹ s ɪ n i oʊ
arslan	ɑ ɹ z l ə n
arsonist	ɑ ɹ s ə n ɪ s t
arsonists	ɑ ɹ s ə n ɪ s t s
arsons	ɑ ɹ s ə n z
artemis	ɑ ɹ t ə m i z
artemis	ɑ ɹ t ə m i s
arthritis	ɑ ɹ θ ɹ aɪ d ə s
arthritis	ɑ ɹ θ ɝ aɪ t ə s
arthropod	ɑ ɹ θ ɹ ə p ɑ d
arthropods	ɑ ɹ θ ɹ ə p ɑ d z
artie	ɑ ɹ d i
artifact	ɑ ɹ t ə f ɛ k t
artifacts	ɑ ɹ t ə f ɛ k t s
artis	ɑ ɹ t i z
artisans	ɑ ɹ t ə s ə n z
artist's	ɑ ɹ t ə s t s
arts	ɑ d s
artworks	ɑ ɹ t w ɝ k s
arup	ɹ u p
as	ə z
as	ɛ s
as	ɛ ʃ
asakusa	æ s ə k u s ə
asbestos	ɛ s p ɛ s t ə s
asby	æ z b i
ascended	ə s ɛ n t ə d
ash	æ s
ashes	æ s ɪ z
ashikaga	æ ʃ i k ɑ ɡ ə
asia	eɪ ʃ ə
asian	eɪ ʃ ə n
asiatic	eɪ z i æ t ɪ k
asker	ɛ s k ɝ
asma	æ s m ə
aspirated	æ s p ɝ eɪ d ɪ d
aspire	ə s p aɪ ɝ
aspires	ə s p aɪ ɝ z
aspirin	æ s p ɝ ɪ n
aspiring	ə s p aɪ ɝ ɪ ŋ
assay	ɛ s eɪ
assayed	ɛ s eɪ d
assays	ɛ s eɪ z
assemblyman	ə s ɛ m b l ɪ m ə n
assertion	ə s ɝ s ə n
assessment	ə s æ s m ə n t
asset	æ s ɪ d
associate	ə s oʊ s i ə t
associated	ə s oʊ ʃ i eɪ t ə d
associating	ə s oʊ ʃ i eɪ t ɪ ŋ
association	ə s oʊ s i eɪ ʃ ə n
assonance	æ s ə m ə n s
assumed	ə z u m d
astaire	ə s d ɛ ɹ
astaire	ə s t ɛ ɹ
astana	ɛ s t ɑ n ə
asteroid	æ s t ɹ ɔɪ d
asteroids	æ s t ɹ ɔɪ d z
asteroids	æ ʃ t ɹ ɔɪ d z
asthma	æ s m ə
aston	æ ʃ t ə n
astor	æ s t ɹ
astronaut	æ s t ɹ ə n ɑ d
astronautics	æ s t ɹ ə n ɑ t ɪ k s
at	æ d
ataturk	æ d ə t ɝ k
athenian	ə θ ɪ n i ə n
athlete	æ θ l ɪ t
athlete	æ θ l i d
athleticism	æ θ l ɛ t ɪ s ɪ s ə m
atlantic	ɛ t l æ n ɪ k
atlas	ɛ t l ə s
atlases	æ t l ə s i z
atom	æ d ə m
atoms	æ d ə m z
atrophies	æ t ɹ ə f i z
atta	æ d ə
attacks	ə d æ k s
attacks	ə t ɛ k s
attend	ə d ɛ n d
attend	ə t ɛ n t
attendances	ə t ɛ n d ə n s i z
attica	æ d ɪ k ə
attila	ə t i l ə
attitudes	æ t ə d u d z
attleboro	æ d ə l b ɝ oʊ
attributed	ə t ɹ ɪ p j u t ɪ d
auburn	ɔ b ɝ n
auctions	ʌ k ʃ ə n z
audio	ɔ t i oʊ
audit	ɔ d ɪ d
augurs	ɔ ɡ ə s
augustine's	ɔ ɡ ə s t ɪ n z
aunt	æ n d
aurora	ɹ ɔ ɹ ə
author	ɔ ð ə
authoritarianism	ə θ ɔ ɹ ə t ɛ ɹ i ə n ɪ z ə m
automatic	ɔ d ə m æ t ɪ k
automobile	ɔ t ə m oʊ b ɪ l
autry	ɔ t ɹ i
avenue	ɛ f ə n j u
average	æ v ɝ ɪ dʒ
averaging	æ f ɹ ɪ dʒ ɪ ŋ
avery	eɪ v ɹ i
avid	æ f ə d
avondale	æ f ə n d eɪ l
avonlea	ɛ v ə n l i
award	ə w ɔ ɹ t
awesome	ɔ s ə n
ax	ɛ k s
axes	ɛ k s ɪ z
axes	æ k s ɪ s
ayer	eɪ ɹ
ayrton	eɪ ɝ t ə n
azov	ɑ z ɑ v
aztec	æ s t ɛ k
azteca	æ s t ɛ k ə
aztecs	æ s t ɛ k s
azure	ə z ɝ
bab	b æ p
babe	b eɪ p
babs	b æ p s
babylonian	b ɛ b ə l oʊ n i ə n
bacardi	b ə k ɑ ɹ t i
baccata	p ə k ɑ t ə
bach's	b ʌ k s
bachelor	b æ tʃ ə l ɝ
bachelor	p æ tʃ l ɝ
back	b æ ɡ
backdrop	b æ ɡ d ɹ ɑ p
backdrop	b æ k t ɹ ɑ p
backhouse	b ɛ k h aʊ s
backing	b æ k ɪ n
backing	b æ k i n
backlash	b æ k l æ s
backpacks	b æ ɡ p æ k s
backs	b æ ɡ z
backup	b ɛ k ʌ p
backup	b æ k ʌ b
bacterial	p ɛ k t ɪ ɹ i ə l
bad	b æ t
badlands	b æ t l æ n d z
badminton	b æ d m ɪ n d ə n
bag	b æ k
baguettes	b ɛ ɡ ɛ t s
bailey	b eɪ l ɪ
bailiwick	b eɪ l i w ɪ k
bait	p eɪ t
bait	b eɪ d
baitings	b eɪ d ɪ ŋ z
baldric	b ɔ l t ɹ ɪ k
baldry	b ɔ l d ɹ i
baldwin	b ɔ l t w ɪ n
balfour	b ɛ l f ɔ ɹ
balk	b ʌ l k
ballads	b æ l ə d s
ballads	b æ l ə t s
ballance	b æ l ə n z
ballas	b ɛ l ə s
ballet	b æ l i
balliol	b ɛ l i ə l
balloch	b ɛ l ə k
ballot	b æ l ə d
ballots	b æ l ə d s
bam	b æ n
bamberg	b æ n b ɝ ɡ
bamboo	b æ n b u
bamfield	b æ n f i l d
banbury	b ɛ n b ɝ i
banbury	b æ n b ɝ i
bancroft	b æ ŋ k ɹ ɔ f t
band	b ɛ n d
band	b æ n t
bandanna	b ɛ n d æ n ə
bands	b ɛ n d z
bands	b ɛ n d s
bandung	b æ n d u ŋ
bangkok	b æ n k ɑ k
bangladesh	b æ ŋ ɡ l ə d æ ʃ
bangladesh	b æ ŋ k l ə d æ ʃ
bangladesh	b æ ŋ ɡ l ə t ɛ ʃ
bangladesh	b æ ŋ k l ə d ɛ ʃ
banish	b æ n ɪ s
bank	p æ ŋ k
bankrupt	b æ ŋ k ɹ ɑ p t
bankruptcy	p æ ŋ k ɹ ə p s i
banned	b æ m d
banned	p æ n d
baptist	b æ p t ə s
baptista	b æ p t i s t ə
baptistery	b æ p t ə s t ɹ i
barbados	b ɑ ɹ b eɪ d oʊ z
barbados	b ɑ ɹ b eɪ t oʊ s
barbara	b ɑ ɹ b ɹ ə
barbells	b ɑ ɹ b ɛ l z
barbie's	b ɑ ɹ b i z
barbier	b ɑ ɹ b ɪ ɹ
barbra	b ɑ ɹ b ɝ ə
barbuda	b ɑ ɹ b u d ə
barclay	b ɑ ɹ k l i
bard	b ɑ ɹ t
bards	b ɑ ɹ t s
bari	b ɛ ɹ i
barked	p ɑ ɹ k t
barmen	b ɑ ɹ n ə n
barna	b ɑ ɹ n ə
barnett	b ɑ ɹ n ɛ t
barnhill	b ɑ ɹ n h ɪ l
barnsley	b ɑ ɹ n z l i
barnstorming	b ɑ ɹ n s t ɔ ɹ m ɪ ŋ
baroness	b ɛ ɹ ə n ɛ s
baroque	b ɹ oʊ k
baroque	b ɝ oʊ ɡ
barrel	b ɛ ɹ ə l
barrels	b ɛ ɹ ə l z
barrels	p ɛ ɹ ə l z
barren	b ɛ ɹ ə n
barrens	b ɛ ɹ ə n z
barret	b ɛ ɹ ɪ t
barrett	b ɛ ɹ ɪ t
barrick	b ɛ ɹ ɪ k
barrie	b æ ɹ i
barrie	p ɛ ɹ i
barring	b ɛ ɹ ɪ ŋ
barring	b ɑ ɹ ɪ ŋ
barrington	b ɛ ɹ ɪ ŋ t ə n
barrington's	b ɛ ɹ ɪ ŋ t ə n z
barringtons	b ɛ ɹ ɪ ŋ t ə n z
barris	b ɛ ɹ ɪ s
barrister	b ɛ ɹ ɪ s t ɝ
barristers	b ɛ ɹ ɪ s t ɝ z
barrow	b ɛ ɹ oʊ
barrows	b ɛ ɹ oʊ z
barry	b ɛ ɹ i
barrymore	b ɛ ɹ i m ɔ ɹ
barrymore's	b ɛ ɹ i m ɔ ɹ z
bart	b ɑ ɹ d
barthel	b ɑ ɹ θ ə l
bartz	b ɑ ɹ t s
basal	b eɪ z ə l
base	b eɪ z
base	p eɪ s
based	b eɪ z t
based	b eɪ s d
basel	b ɑ ʃ ə l
bases	b eɪ s ə s
bashing	b æ ʃ ɪ n
bashir	b ə ʃ ɪ ɹ
basilicas	b ə z ɪ l ɪ k ə s
basin	b eɪ z ə n
basis	b eɪ s ə z
bassam	b æ s ə n
basses	b æ s ɪ s
bassett's	b æ s ɪ t z
bassoon	p ə s u n
bastille	b æ s t i l
bastrop	b æ ʃ t ɹ ə p
bat	b æ d
bat	b ɛ t
batchelder	b ɛ tʃ ɛ l d ɝ
bates	b eɪ d z
bath	b ɛ θ
bathe	b eɪ θ
bathwater	b æ θ w ɔ t ɝ
batista	p ə t i s t ə
batman	b æ d m æ n
batonga	b æ t ɑ ŋ ɡ ə
bats	p æ t s
battalion	p ə t æ l j ə n
batted	b æ d ɪ d
batter	b ɛ t ɝ
batter's	b ɛ t ɝ s
batteries	b æ d ɹ i z
batteries	b æ t ɝ i s
batting	b æ d ɪ ŋ
batting	b æ d ɪ n
battle	b ɛ t ə l
battle	b æ d ə l
battled	b æ d ə l d
battles	b ɛ t ə l z
battles	b æ d ə l z
baxter	b ɛ k s t ɝ
bay's	b eɪ s
bayamo	p aɪ ɑ m oʊ
bayer	b eɪ ɹ
bays	b eɪ s
bayside	b eɪ s aɪ t
bayswater	b eɪ z w ɔ t ɝ
be	b ɪ
beach	p i tʃ
beaches	p i tʃ ɪ z
beadle	b i t ə l
beaked	p ɪ k t
beale	b ɪ l
beam	b i n
beams	b i n z
bean	b i ŋ
bear	b ɛ
beardstown	b ɪ ɹ d z t aʊ n
bears	b ɛ ɝ z
beasley	b i s l i
beat	b i d
beaten	b ɪ t ə n
beath	b i θ
beating	b ɪ d ɪ ŋ
beatles	b i d ə l z
beatrice	b i ə t ɹ i s
beatrice	b i ə t ɹ i z
beatrix	b i ə t ɹ ɪ k s
beats	b i d z
beattie	b i d i
beatty	b i d i
beauce	b oʊ z
beautiful	p j u t ə f ə l
became	b i k eɪ m
became	b ɪ ɡ eɪ m
because	b ɪ k ɔ s
bechtel	b æ k t ɛ l
beck	b æ k
become	b i k ʌ m
becomes	b i k ʌ m z
bed	b æ t
bed	b æ d
bed	b ɛ t
bede	b ɪ d
bedford	b ɛ t f ɝ t
beds	b æ d z
bedwell	b ɛ t w ɛ l
been	b i ŋ
been	p ə n
beer	b i ɹ
beer	b i
beers	p ɪ ɹ z
beetle	b i d ə l
beetles	b i d ə l z
beets	p i t s
before	b i f ɔ
beg	b æ ɡ
began	b i ɡ æ n
began	b ɪ ɡ æ m
began	b ɪ ɡ ɛ n
beggar	b ɛ k ɝ
beginning	b ɪ ɡ ɪ n ɪ n
behalf	b ɪ h æ v
behnke	b æ ŋ k
being	b i n
being	b i ɪ n
being	b ɪ n
being	b ɪ ɪ ŋ
beirut	b eɪ ɹ u d
belarus	b ɛ l ə ɹ u z
belarusian	b ɛ l ə ɹ ɑ ʃ ə n
belcourt	b ɛ l k ɔ ɹ t
belgian	b ɛ l dʒ ə m
belgium	b ɛ l dʒ ə n
belief	p ə l i f
belief	b ɪ l i v
belize	b ə l i s
bell's	b ɛ l s
bellcore	b ɛ l k ɔ ɹ
belle	b æ l
belt	b æ l t
belts	b ɛ l d z
belts	b ɛ l t z
belvoir	b ɛ l f w ɑ ɹ
bembo's	b æ m b oʊ z
bemis	b i m ə z
bemused	b i m j u z d
ben	b æ n
bench	b æ ŋ tʃ
bend	b æ n d
bender	b æ n d ɝ
bendigo	b ɛ n d i ɡ oʊ
bending	p ɛ n d ɪ ŋ
bendix	b ɛ n d i k s
benefice	b ɛ n ə f ɪ ʃ
benefited	b ɛ n ə f ɪ t ɪ t
benga	b æ ŋ ɡ ə
bengal	b æ ŋ ɡ ə l
bengal	b ɛ n ɡ ə l
bengali	b ɛ n ɡ ɑ l i
bengali	b æ ŋ ɡ ɑ l i
bengali	p ɛ n ɡ ɑ l i
bengals	b æ ŋ ɡ ə l z
benghazi	b ɛ ŋ ɡ ɑ z i
benito	b ə n i d oʊ
bensley	b ɛ n z l i
bentham	b ɛ n θ ə n
benz	b æ n s
bequeathed	b ɪ k w i θ d
berbice	b ɝ b i s
berenice	b ɛ ɹ ə n i s
beretta	b ɝ ɛ d ə
berg	b ɝ k
bergman's	b ɝ k m ə n z
bergson	b ɝ k s ə m
berkshire	b ɝ k ʃ aɪ ɝ
berkshires	b ɝ ɡ ʃ aɪ ɝ z
berlin	b ɝ l ɪ ŋ
berlioz	b ɝ l i oʊ s
bermuda	b ɝ m j u t ə
bernd	b ɝ n d
bernhard	b ɝ n h ɑ ɹ d
bernice's	b ɝ n i s ɪ z
bernini	b ɝ n ɪ n i
berryman	b ɛ ɹ i m ə n
berserk	b ɝ z ɝ k
berserk	b ə z ɝ k
bertelsmann	b ɝ d ə l z m ə n
bertelsmann	b ɝ t ə l s m ə n
bertie	b ɝ d i
bertrand	p ɝ t ɹ ə n d
berwickshire	b ɝ w ɪ k ʃ aɪ ɝ
beside	b i s aɪ d
bespoke	b ɪ s p oʊ ɡ
bess	b æ s
best	b æ s t
beswick	b ɛ z w ɪ k
bet	b æ t
beta	b eɪ d ə
betancourt	b ɛ t ə n k ɔ ɹ t
beth	b ɛ d
bethesda	b ə θ ɛ s t ə
bethlehem	b ɛ θ l ə h æ m
betray	b i t ɹ eɪ
betrayal	b i t ɹ eɪ ə l
bets	b ɛ d z
betsy	p æ t s i
better	b ɛ ɾ ɝ
betting	b æ d ɪ ŋ
betting	b ɛ d ɪ ŋ
betty	b æ t i
bewick	b i w ɪ k
bezel	b ɛ s ə l
bianco	b i ɑ ŋ k oʊ
biblical	b ɪ p l ɪ k ə l
bicester	b ɪ s t ɝ
bickers	b i k ɝ z
bickerton	p ɪ k ɝ t ə n
bid	b ɪ t
biddell	b ɪ t ə l
bidder	b ɪ t ɝ
bidders	b ɪ t ɝ z
bidding	b ɪ t ɪ ŋ
bids	b ɪ t z
bids	b ɪ t s
biennial	b aɪ æ n i ə l
biennially	b aɪ æ n i ə l i
bierley	b ɪ ɹ l i
biermann	b ɪ ɹ m ə n
big	b ɪ k
big	b i k
big	p ɪ ɡ
biggleswick	b ɪ k ə l z w ɪ k
bihar	b i h ɑ ɹ
bihar	b i h ɑ
bihari	b ɪ h ɑ ɹ i
bike	p aɪ k
billboard's	b ɪ l b ɔ ɹ d z
billed	b ɪ l t
biloxi	b ə l ɑ k s i
binary	b aɪ n ɝ ɪ
bing	b ɪ n
bios	b aɪ oʊ z
bird	b ɝ t
birdwood	b ɝ t w ʊ d
bisbee	b ɪ s p i
bisbee	b ɪ z b i
bisley	b ɪ s l i
bismillah	b ɪ z m i l ə
bistre	b i s t ɝ
bit	b ɪ d
bit	p ɪ t
bit	b i t
bits	p i d z
bitterroot	b ɪ t ɝ ɹ u d
blackbird	b l æ ɡ b ɝ t
blacks	b l ɛ k s
blacksmithing	b l æ k s m ɪ θ ɪ ŋ
bladder	b l æ t ɝ
blade	b l eɪ t
blair	b l æ ɹ
blake's	p l eɪ k s
blanco	b l æ n k oʊ
blaney	p l eɪ n i
blaze	p l eɪ s
blaze	p l eɪ z
bleaching	p l i tʃ ɪ ŋ
bleeding	p l i d ɪ ŋ
bleeding	b l ɪ t ɪ ŋ
blend	b l æ n d
blessed	b l ɛ s d
bleyer	b l eɪ ɹ
blighted	b l aɪ d ɪ d
block	b l ʌ k
block	b l ɑ ɡ
blockbuster	b l ɑ k b ʌ s t ɝ
blodgett	b l ʌ dʒ ɪ t
blog	b l ɑ k
blog	p l ɑ k
blom	b l ʌ m
blomfield	b l ɑ n f i l d
blomfield	b l ʌ m f i l d
blood	b l ɑ t
blood	p l ɑ t
bloodied	b l ʌ d ɪ d
bloodshed	b l ʌ d ʃ ɛ t
blot	b l ʌ t
blowing	b l oʊ ɪ n
blue	p l u
blues	b l u s
blues	p l u z
blumberg	p l ʌ m b ɝ ɡ
blunderbuss	b l ʌ n d ɝ b ʌ s
blvd	b ʊ l ə v ɑ ɹ d
blyth	b l aɪ θ
blythe	b l aɪ θ
board	b ɔ ɹ t
board	b ɔ t
boarded	b ɔ ɹ t ɪ d
boarder	b ɔ ɹ t ɝ
boarders	b ɔ ɹ t ɝ z
boardwalk	b ɔ t w ɔ k
boasted	p oʊ s t ɪ d
boating	b oʊ d ɪ ŋ
bob	b ɑ p
bobcats	b ɑ b k æ t s
boddington	b ɑ t ɪ ŋ t ə n
bodman	b ɑ t m ə n
body	b ɑ d ɪ
bogart	b oʊ ɡ ɑ ɹ d
bogue	b oʊ k
boise	b ɔɪ s i
boisterous	b ɔɪ s t ɝ ə s
bomb	b ɑ n
bombed	b ʌ m d
bombs	b ʌ n z
bong	b ɑ n
bongo	b ɑ ŋ k oʊ
bonham	b ʌ ŋ h ə m
bonita	b oʊ n i d ə
bonkers	b ʌ ŋ ɡ ɝ z
boogie	b u k i
boogie	b ʊ k i
boogie	p ʊ k i
book	b u k
booke	b u k
books	b u k s
bookstore	b ʊ k s d ɔ
bookstore	b ʊ k s d ɔ ɹ
boole	b ʊ l
boom	b u n
boomerang	b u m ɝ æ n
booming	b u m ɪ n
boon	p u n
boone	b u m
boosey	b u z i
boot	b u d
boothe	b u θ
bootlegs	b u t l ɛ k s
booz	b u s
boral	b ɔ ɹ ə l
borda	b ɔ ɹ d ə
boreas	b ɔ ɹ i ə s
borkum	p ɔ ɹ k ə m
borman	b ɔ ɹ m ə n
born	p ɔ ɹ n
boron	b ɔ ɹ ɑ n
borough	b ɹ oʊ
bosman	b ɑ z m ə n
bosnia	b ɑ s n i ə
bosnia	b ɑ z m i ə
bostic	b ɑ s d ɪ k
boston	b ʌ s t ə n
bot	b ɑ d
botanic	p ə t æ n ɪ k
botanical	p ə t æ n ɪ k ə l
botanists	b ɑ d ə n ɪ s t s
botany	b ɑ d n i
bothe	b oʊ θ
bothersome	b ʌ ð ɝ s ə m
botswana	b ʌ t s w ɑ n ə
bottle	b ʌ t ə l
bottler	b ɑ t ə l ɝ
bottling	b ɑ d ə l ɪ ŋ
bottom	b ʌ t ə m
bottom	b ɑ d ə m
botts	b ʌ t s
bought	b ʌ t
boulevard	b u l ə v ɑ ɹ d
boulevard	b ʊ l ə f ɑ t
bounce	b aʊ n z
bounced	b aʊ n s d
bouncing	b aʊ n z ɪ ŋ
bound	b aʊ n t
boundaries	b aʊ n d ɝ i z
boundary	b aʊ n d ɝ i
bourgeois	b u ɹ ʒ w ɑ
bourn	b ɔ ɹ n
bourse	b ɔ ɹ z
bowling	b oʊ l ɪ n
boxley	b ʌ k s l i
boy's	b ɔɪ s
boyce	b ɔɪ z
boycotted	b ɔɪ k ɑ d ɪ d
boyd	p ɔɪ t
boys	b ɔɪ s
brabant	b ɹ æ b ə n d
brackets	b ɹ æ k ə t s
brad	b ɹ ɛ d
bradford	b ɹ ɛ d f ɝ d
bradlee	b ɹ æ d l i
bradner	b ɹ æ d n ɝ
brahms	b ɹ ɑ n z
bram	b ɹ æ n
bramblett	b ɹ æ m b l ɪ t
brand	b ɹ æ n t
brandeis	b ɹ ɛ n d aɪ s
branden	b ɹ æ n d ə n
brandes	b ɹ æ n d ɪ s
brandle	b ɹ æ n d ə l
brandt	b ɹ æ n t
brandy	b ɹ ɛ n d i
braniff	b ɹ æ n ɪ f
branner	b ɹ æ n ɝ
branson	b ɹ æ n s ə m
branson's	b ɹ æ n s ə n z
brantley	b ɹ æ n t l i
brashear	b ɹ æ ʃ ɪ ɹ
brasil	b ɹ ə z ɪ l
brasilia	b ɹ ə s ɪ l j ə
brasses	p ɹ æ s ɪ z
braswell	b ɹ æ s w ɛ l
brattleboro	b ɹ æ d ə l b ɝ oʊ
brattleboro	b ɹ ɛ t ə l b ɝ oʊ
bratty	b ɹ ɛ d i
breadcrumb	b ɹ ɛ d k ɹ ʌ m
breast	p ɹ ɛ s t
breastfed	b ɹ ɛ s t f ɛ d
brecker	b ɹ ɛ k ɝ
brede	b ɹ ɪ d
breech	b ɹ ɪ tʃ
breed	b ɹ i t
breeden	b ɹ i d ə n
breeding	b ɹ ɪ d ɪ n
breese	b ɹ i s
bremen	b ɹ æ m ə n
bremer	b ɹ ɪ m ɝ
brendan	b ɹ æ n d ə n
brenden	b ɹ æ n d ə n
brennan	b ɹ æ n ə n
brent	b ɹ ɛ n d
brent	b ɹ æ n t
brest	b ɹ ɛ ʃ t
bret	b ɹ ɛ d
bret	b ɹ æ t
bretheren	b ɹ ɛ ð ɹ ə n
brewed	p ɹ u d
breweries	b ɹ u ɝ i z
brewers	b ɹ u ɹ z
brewery	b ɹ u ɚ i
breza	b ɹ ɛ s ə
briana	b ɹ i æ n ə
brice	p ɹ aɪ s
brick	b ɹ i k
brick	b ɹ ɪ ɡ
bricker	b ɹ ɪ k ɝ
bride	p ɹ aɪ t
bridlington	b ɹ i t l ɪ ŋ t ə n
brierley	b ɹ aɪ ɹ l i
brig	p ɹ ɪ ɡ
bright	b ɹ aɪ d
bringing	b ɹ i n ɪ ŋ
brinsmead	b ɹ ɪ n z m i d
brisbane	b ɹ ɪ s b eɪ n
brisbane	b ɹ ɪ s p eɪ n
brisbane	b ɹ ɪ s b ə n
britain	b ɹ i d ə m
british	b ɹ ɪ t ɪ s
britney's	b ɹ ɪ t n ɪ s
broadcaster's	b ɹ ɔ d k æ s t ɝ z
broadcasters	b ɹ ɔ d k æ s t ɝ z
broadview	b ɹ ɔ d v j u
brockwell	b ɹ ɑ k w ɛ l
brodie	b ɹ oʊ d i
brodie's	b ɹ oʊ d i z
brodsky	b ɹ ɑ d s k i
brokerage	b ɹ oʊ k ɹ ɪ dʒ
bromham	b ɹ ʌ m h ə m
bromide	b ɹ oʊ m aɪ t
bromm	b ɹ ɑ m
bromwich	b ɹ ʌ m w ɪ tʃ
bronchus	b ɹ ɑ ŋ k ə z
bronstein	b ɹ ɑ n s t i n
bronzes	b ɹ ɑ n s ɪ z
brook	b ɹ u k
brooklime	b ɹ ʊ k l aɪ n
brooklyn	b ɹ u k l ɪ n
brooklyn's	b ɹ ʊ k l ɪ n z
brooks	b ɹ ʊ ɡ s
brooks	b ɹ ʊ k z
brooks's	b ɹ u k s
brooks's	b ɹ ʊ k s
brooksville	b ɹ ʊ k s v ɪ l
broomall	b ɹ u m ə l
brother	b ɹ ɑ ð ɝ
brought	b ɹ ɔ d
broussard	b ɹ u s ɑ ɹ d
brownies	b ɹ aʊ n ɪ z
brubeck	b ɹ u b æ k
bruce	b ɹ u z
bruckman	b ɹ ʌ k m ə n
bruckner	b ɹ ɑ k n ɝ
bruford	b ɹ u f ɝ d
brummitt	b ɹ ʌ m ɪ t
brunhilda	b ɹ u n h ɪ l d ə
brunswick	b ɹ ʌ n z w i k
brunswick	b ɹ ʌ n s w ɪ k
bryce	b ɹ aɪ z
bryn	b ɹ ɪ ŋ
buccaneer	b ʌ k ə n ɪ ɹ
buccaneering	b ʌ k ə n ɪ ɹ ɪ ŋ
buccaneers	b ʌ k ə n ɪ ɹ z
buck	b ʌ ɡ
buckden	b ʌ k t ə n
buckle	b ɑ k ə l
bucknell	b ə ɡ n ɛ l
bud	b ʌ t
budapest	b u d ə p æ s t
buddha's	b u d ə s
buddies	b ɑ d i z
buddy	b ʌ t i
buddy	b ɑ d i
buffering	b ʌ f ɹ ɪ ŋ
buffy	b ʌ f ɪ
bug	b ʌ k
bugs	b ɑ ɡ z
build	b ɪ l t
builder	b ɪ l t ɝ
building	b ɪ l d ɪ n
builds	b ɪ l t s
builds	b ɪ l d s
built	b ɪ l d
bull	b u l
bulletins	p ʊ l ə t ə n z
bullhorn	b ʊ l h ɔ ɹ n
bullitt	b ʊ l ɪ t
bulls	b ʊ l s
bum	b ɑ m
bumpety	b ɑ m p ə d i
bunder	b ʌ n t ɝ
bundestag	b u n d ə s t ɑ ɡ
burdell	b ɝ d æ l
buren	b j ʊ ɹ ə n
burglar	b ɝ k l ɝ
burgos	b ɝ ɡ oʊ s
burke	b ɝ ɡ
burkina	p ɝ k i n ə
burned	b ɝ n t
burnett	b ɝ n ə d
burnham	b ɝ n h æ n
burns	b ɝ n s
burnt	b ɝ n d
burrow	b ɹ oʊ
burundi	b ɝ ɑ n d i
busch	p ʊ ʃ
busch's	b ʊ s ɪ z
buses	b ʌ z ɪ z
busey	b j u s i
bush	b u ʃ
bushido	b u ʃ i d oʊ
bushido	p u ʃ i d oʊ
bushveld	b ʊ ʃ f ɛ l d
business	b ɪ s n ɪ s
businesses	b ɪ z n ɪ z ɪ z
businesses	b ɪ z n ɪ s ɪ s
businesses	b ɪ s n ɪ s ɪ z
busted	b ʌ s t ɪ t
busy	b ɪ s i
busy	b i s i
busy	b i z i
but	b ɑ t
but	p ʌ t
butrick	b ʌ t ɹ ɪ k
butter	b ɑ d ɝ
butter	b ʌ ɾ ɝ
butters	b ʌ d ɝ z
butthead	b ʌ d h ɛ d
butting	b ʌ d ɪ ŋ
buy	p aɪ
buyers	p aɪ ɝ z
by	p aɪ
byng	b i ŋ
cab	k æ p
cabarets	k æ p ɝ eɪ z
cabezas	k ə b eɪ z ə s
cabin	k æ p ə n
cabin	k æ p ɪ n
cable	k eɪ p ə l
cabotage	k æ p ə t ɪ dʒ
cabral	ɡ æ b ɹ ə l
cabs	k æ p s
cache	ɡ æ ʃ
caching	ɡ æ ʃ ɪ ŋ
cadbury	k æ t b ɛ ɹ i
caddie	k æ t i
cadence	k eɪ d ə n z
cadillac	k æ t ə l æ k
cadmium	k ɛ t n i ə n
cadmus	k æ d n ə s
cady	k eɪ t i
caer	k eɪ ɝ
cafeteria	k æ v ə t ɪ ɹ i ə
caicos	k aɪ k oʊ s
cairn	k æ ɹ n
cairns	k ɛ n z
cajetan	k ɛ dʒ ə t ə n
calcasieu	k æ l k ə s u
calcite	k æ l s aɪ d
cali	ɡ ɑ l i
caliber	k æ l ɪ b ɝ
calibre	k æ l ə b ɝ
californica	k æ l ɪ f ɔ ɹ n ɪ k ə
caliph	k æ l i f
calkins	k ɛ l k ɪ n z
call	ɡ ɔ l
called	k ɔ l t
calm	k ʌ m
calvin	k ɛ l v ɪ n
cam	k ɛ m
cambodia	k æ n b oʊ d i ə
cambric	k æ m b ɹ ɪ ɡ
cambyses	k æ m b i s i z
camden	k æ m t ə n
camden	k æ n d ə n
cameraman	k æ m ɹ ə m ə n
cameras	k æ m ɝ ə s
cameras	k ɛ m ɝ ə s
cameron	k æ m ɹ ə n
cameron	k æ n ɹ ə n
cameron	k ɛ m ɹ ə n
cameron's	k æ m ɹ ə n z
camille	k ə m ɪ l
camouflage	k æ m ə f l ɑ ʃ
camouflaged	k æ m ə f l ɑ ʃ d
camp	ɡ æ m p
camp	k æ m b
camp	k æ n b
campaign	k æ n p eɪ n
campanile	k æ m p ə n i l
campbell	k æ m p ə l
campbell	k ɛ m p ə l
camping	k æ m p ɪ n
campos	k æ m p oʊ s
campus	k æ m p ə ʃ
campus	k æ n p ə s
campuses	k æ m p ə s ə s
camry	k æ m ɹ i
can	k ə m
can	k æ m
can	ɡ æ n
canada's	k æ n ə d ə s
canberra	k æ n b ɝ ə
canberra	k æ m b ɛ ɹ ə
canberra	k ɛ n b ɝ ə
candelabra	k æ n d ə l ɑ b ɹ ə
candida	k æ n d i d ə
candida	ɡ æ n d i d ə
candidates	k æ n t ə d eɪ t s
candy	k æ n t i
cane	k eɪ m
canfield	k ɛ n f i l d
canned	ɡ æ n t
canned	k æ n t
canning	k ɛ n ɪ ŋ
canon	ɡ æ n ə n
canopy	k æ n ə b i
cantankerous	k ɛ n t æ ŋ k ɝ ə s
cantatas	k æ n t ɑ t ə s
canton	k æ m t ə n
canton	k æ n t ə m
canvassers	k æ m v ə s ɝ z
canyons	k ɛ n j ə n z
cap	ɡ æ b
capital	k æ b ɪ t ə l
capitals	k æ p ə t ə l s
capitan	k æ p i t ə n
caprica	k æ p ɹ ɪ k ə
captive	k æ p t ɪ f
capuchin	k æ p ə tʃ i n
carabao	k ɛ ɹ ə b aʊ
caravelle	k ɛ ɹ ə v ɛ l
caraway	k ɛ ɹ ə w eɪ
carbon	k ɑ ɹ p ə n
carbon	k ɑ p ə n
card	k ɑ ɹ t
card	k ɑ t
card	ɡ ɑ ɹ d
card	ɡ ɑ d
cardamom	k ɑ ɹ d ə m ə n
cardamom	k ɑ ɹ t ə m ə m
cardenio	k ɑ ɹ d ɪ n i oʊ
cardiac	k ɑ ɹ t i æ k
cardiff	k ɑ ɹ t ɪ f
cardiff	k ɑ ɹ d ɪ v
cardiff	k ɑ ɹ t ɪ v
cards	k ɑ ɹ t s
care	k ɛ
care	ɡ æ
career	k ɝ i ɹ
career	k ɝ i ɝ
career	k ɚ ɪ ɹ
careers	k ɝ i ɹ z
carew	k ɛ ɹ u
carey	k æ ɹ i
carillon	k ɛ ɹ ə l ɑ n
carinus	k ɑ ɹ ɪ n ə s
carleen	k ɑ ɹ l i n
carling	k ɑ ɹ l ɪ n
carlos	k ɑ ɹ l oʊ z
carlsbad	k ɑ ɹ l z b æ d
carlsson	k ɑ ɹ l s ə n
carmel	k ɑ ɹ m ə l
carnell	k ɑ ɹ n ə l
carnitine	k ɑ ɹ n ə t i n
caroline	k ɛ ɹ ə l i n
caroling	k ɛ ɹ ə l ɪ ŋ
carport	k ɑ ɹ p ɔ ɹ t
carr	k ɑ ɝ
carrie	k æ ɹ i
carried	k ɛ ɹ ɪ d
carrier	k ɛ ɹ i ə
carrington	k ɛ ɹ ɪ ŋ t ə n
carrion	k ɛ ɹ i ə n
carrock	k ɛ ɹ ə k
carroll	k ɛ ɹ ə l
carroll's	k ɛ ɹ ə l z
carrollton	k ɛ ɹ ə l t ə n
carry	k ɛ ɹ i
cars	k ɑ ɹ s
carshalton	k ɑ ɹ s ə l t ə n
cartier	k ɑ ɹ d i ɝ
cartland	k ɑ ɹ t l ə n d
carved	k ɑ ɹ f d
carver	k ɑ ɹ f ɝ
casas	k ɑ s ə s
casbah	k æ ʃ p ə
case	ɡ eɪ s
case	k eɪ z
casey's	k eɪ s ɪ z
cash	k æ s
cash	ɡ æ ʃ
cash	ɡ æ s
cash	k ɛ ʃ
casimir	k æ s ɪ m ɪ ɹ
casimir	k æ z ɪ m ɪ ɹ
casings	k eɪ s i n z
casino	k ə z i n oʊ
casinos	k ə s i n oʊ z
caspar	k æ s b ɝ
casper	ɡ æ s p ɝ
cassidy	k æ s ə t i
cassidy	k æ s ɪ t i
cast	ɡ æ s t
cast	k ʌ s t
casting	ɡ æ s t ɪ ŋ
casting	k æ s t ɪ n
castle	ɡ æ s ə l
castleford	k æ s ə l f ɝ t
castro	k æ ʃ t ɹ oʊ
casual	k æ ʃ ə l
casualty	k æ ʃ ə l t i
caswell	k æ s w ɛ l
cat	ɡ æ t
catches	k ɛ tʃ ɪ z
catchment	k ɛ tʃ m ə n t
catenary	k æ d ə n ɛ ɹ i
cater	ɡ eɪ t ɝ
catherine	k æ θ ɹ ə n
catherine	k æ θ ɹ i n
catherwood	k æ θ ɝ w ʊ d
cathy	ɡ æ θ i
catskill	k æ t s ɡ ɪ l
caudal	k ɑ t ə l
caught	k ɑ d
caught	ɡ ɑ t
causa	k ɔ s ə
cause	k ɔ s
caused	k ɔ s t
caused	k ɔ z t
caused	k ɔ s d
causes	k ɔ s ɪ z
causes	k ɔ s ɪ s
causing	k ɔ s ɪ ŋ
cavalier	k æ v ə l i ɹ
cavan	k ɛ v ə n
cave	k eɪ f
cavendish	k æ f ə n d ɪ ʃ
cavern	k æ v ɝ ə n
caves	k eɪ v s
cd	s ɪ t i
cds	s ɪ t i z
cease	s i z
ceased	s i z d
cebu	s ɪ b u
cecilia	s ɪ s ɪ l j ə
cedar	s i t ɝ
celeb	s ə l æ b
celery	s æ l ɝ i
celia	s ɪ l j ə
celia's	s ɪ l j ə z
cell	s æ l
celtic	k æ l t ɪ k
cemetery	s ɛ m ə t ɝ i
cenotaph	s ɪ n ə t æ f
census	s ɛ n s ə z
census	s æ n s ə s
centaurus	s ɛ n t ɔ ɹ ə s
centenary	s æ n t ɛ n ɝ i
center	s ɛ n t ɹ
center	s æ n ɝ
center	s æ n t ɝ
centerville	s ɛ n t ɝ v i l
centralism	s ɛ n t ɹ ə l ɪ z ə m
centre	s ɛ n t ɹ
centre	s ɛ n d ɝ
centres	s ɛ n t ɝ s
centrist	s ɛ n t ɹ ɪ s t
centrists	s ɛ n t ɹ ɪ s t s
centro	s ɛ n t ɝ oʊ
centromere	s ɛ n t ɹ ə m ɪ ɹ
centronics	s ɛ n t ɹ ɑ n ɪ k s
cephalopod	s ɛ v ə l ə p ɑ d
ceramic	s ɝ æ n ɪ k
ceramic	s ɝ ɛ m ɪ k
cerebellar	s ɛ ɹ ə b ɛ l ɝ
certain	s ɝ d ə m
cervantes	s ɝ v æ n t ɪ s
cervantes	s ɝ v æ n t i z
cervical	s ɝ f ɪ k ə l
chad	tʃ æ t
champions	tʃ æ m p i ə n ʃ
championships	tʃ æ m p i ə n s ɪ p s
chancellor	tʃ æ n s l ɝ
chang	tʃ æ n
chantry	tʃ æ n t ɝ i
chapelain	tʃ ɛ p ə l eɪ n
chapman	tʃ ɛ p m ə n
character	k æ ɹ ə k t ɝ
charismatic	k ɛ ɹ ɪ z m æ t ɪ k
charity	tʃ ɛ ɹ ɪ d i
charleston	tʃ ɑ ɹ ə l z t ə n
charney	tʃ ɑ ɹ m i
charted	tʃ ɑ ɹ d ɪ d
chartered	tʃ ɑ ɹ t ɝ t
charts	tʃ ɑ ɹ t z
chasing	tʃ eɪ s ɪ n
chasma	k æ s m ə
chassis	tʃ æ s ɪ
chassis	tʃ ɛ s ɪ s
chassis	tʃ ɛ s ɪ
chassis	tʃ æ s ɪ z
chatfield	tʃ æ t f ɪ l d
chatham	tʃ ɛ t ə m
chattanooga	tʃ æ t ə n u k ə
cheadle	tʃ i t ə l
cheadle	tʃ ɪ d ə l
checks	tʃ æ k s
cheddar	tʃ æ t ɝ
cheddar	tʃ ɛ t ɝ
cheder	tʃ æ t ɝ
cheetah	tʃ i d ə
chef	ʃ æ f
chelmsford	tʃ æ l m z f ɝ d
chelmsford	tʃ ɛ l m z f ɝ d
chemical	k æ m ə k ə l
chen	tʃ æ n
cherish	tʃ ɛ ɹ i ʃ
chess	tʃ æ s
chet	tʃ æ t
cheves	tʃ i f s
chevron	ʃ æ v ɹ ə n
chevron	ʃ ɛ f ɹ ə n
chevron	ʃ ɛ v ɝ ə n
chevron's	ʃ ɛ v ɹ ə n z
chevy	tʃ ɛ f i
cheyenne	ʃ aɪ æ n
cheyennes	ʃ aɪ æ n z
chicken	tʃ i k ə n
child	tʃ aɪ l t
childeric	tʃ ɪ l t ɹ ɪ k
chile	tʃ i l i
chillis	tʃ ɪ l i z
chilperic	tʃ ɪ l p ɝ ɪ k
chinook	ʃ ɪ n u k
chinsurah	tʃ ɪ n s ɝ ə
chios	tʃ i oʊ s
chiswick	tʃ ɪ s w ɪ k
chivalry	ʃ ɪ v ə l ɹ i
chloris	ɡ l ɔ ɹ i s
choate	tʃ oʊ d
choice	tʃ ɔɪ z
choir	k w aɪ ɹ
choirs	k w aɪ ɝ z
cholesterol	k ə l ɛ s t ɹ ə l
cholesterol	k ə l æ s t ɝ ə l
chook	tʃ u k
chord	k ɔ ɹ t
chorus	k ɔ ɹ ə z
chose	tʃ oʊ s
chowder	tʃ aʊ t ɝ
chris	ɡ ɹ i s
chris	ɡ ɹ ɪ ʃ
chrisman	k ɹ ɪ s m ə n
chrisp	k ɹ ɪ s p
chromosome	k ɹ oʊ m ə z oʊ m
chromosomes	k ɹ oʊ m ə z oʊ m z
chronological	k ɹ ɑ m ə l ɑ dʒ ɪ k ə l
chubby	tʃ ɑ b i
chuck	tʃ ɑ k
chukar	tʃ ʌ k ɝ
chumash	k u m ə ʃ
chun	tʃ ɑ n
chun	tʃ ʌ ŋ
ciara	s i ɛ ɹ ə
cibber	s ɪ p ɝ
cid	s i d
cinema	s i n ə m ə
circuit	ʃ ɝ k ə t
circumference	s ɝ k ɑ m f ɹ ə n s
cistercians	s ɪ s t ɝ ʒ ə n z
citadel	s ɪ t ə d æ l
cited	s aɪ d ɪ d
cities	s i t i z
cities	s ɪ d ɪ z
citing	s aɪ d ɪ ŋ
citizenship	s ɪ t ɪ s ə n ʃ i p
citrus	s i t ɹ ə s
city	s ɪ t ɪ
city	s ɪ d i
city	s i d i
city	s i t i
civil	s ɪ f ə l
cladding	k l æ t ɪ ŋ
claims	k l eɪ n z
clallam	k l ɛ l ə m
clancy	k l ɛ n s i
clandestine	k l æ n d ɛ s t i n
clara	k l ɛ ɹ ə
clara's	k l æ ɹ ə z
clarey	k l ɛ ɹ i
clarifies	k l æ ɹ ə f aɪ z
clarinetist	k l ɛ ɹ ə n ɛ t ɪ s t
clarity	k l ɛ ɹ ɪ t i
clarkston	k l ɑ ɹ k s t ə n
clashing	k l æ ʃ ɪ n
class	ɡ l æ s
classes	k l æ s ɪ s
classmate	k l æ s m eɪ d
claus	k l ɔ s
cleaned	k l i m d
cleanliness	k l ɛ n l ɪ n ə s
clear	k l ɪ ɚ
clemson	k l ɛ m z ə n
cleveland	k l ɪ v l ə n d
cleverest	k l ɛ v ɝ ə s t
clicks	k l i k s
climbing	k l aɪ n ɪ ŋ
clinton	k l ɪ n d ə n
clinton	k l ɪ ŋ t ə n
cloaked	k l oʊ k d
clock	k l ɑ ɡ
clones	k l oʊ m z
close	k l oʊ s
closed	k l oʊ s t
closely	k l oʊ z l i
closer	k l oʊ z ɝ
closest	k l oʊ z ə s t
closure	k l oʊ z ɝ
clothing	k l oʊ θ ɪ ŋ
clotting	k l ɑ d ɪ ŋ
club	k l ʌ p
club	k l ɑ b
club	k l ɑ p
club's	k l ʌ b s
clumping	k l ɑ m p ɪ ŋ
clusters	k l ʌ s t ɝ s
clyde	k l aɪ t
clydesdale	k l aɪ d s t eɪ l
clypeus	k l ɪ p i ə s
coagulum	k oʊ æ k j ə l ə m
coast	ɡ oʊ s t
coats	k oʊ d s
cobb	k ɑ p
cochin	k oʊ tʃ i n
cochlear	k ɑ k l i ɹ
cochran	k ɑ k ɹ ə m
cockatrice	k ɑ k ə t ɹ i z
cockerill	k ɑ k ɹ ɪ l
cockpit	k ɑ k b ɪ t
cocksureness	k ɑ k ʃ ɝ n ə s
cod	k ɑ t
code	k oʊ t
coded	k oʊ t ɪ d
codes	k oʊ t s
codified	k oʊ t ə f aɪ d
coding	k oʊ t ɪ ŋ
coding	k oʊ d ɪ n
cody	k oʊ t i
coed	k oʊ æ d
coercion	k oʊ ɝ ʒ ə n
coffee	ɡ ɔ f i
cog	k ɑ k
cogswell	k ɑ ɡ z w ɛ l
coherence	k oʊ h i ɹ ə n s
cohesion	k oʊ h i ʃ ə n
coitus	k ɔɪ d ə s
cold	k oʊ l t
cole	ɡ oʊ l
coliseum	k ɑ l ə z i ə m
collaborative	k ə l æ b ɹ ə t ɪ v
collaborative	k ə l æ b ɝ ə t ɪ v
collar	k ʌ l ɝ
collateral	k ə l ɛ t ɝ ə l
colleague	k ɑ l ɪ k
collegiate	k ə l ɪ dʒ i ə t
collier	k ɑ l i ɝ
collinear	k ə l ɪ n i ɝ
collision	k ə l ɪ ʃ ə n
collisions	k ə l ɪ ʃ ə n z
colombo	k ə l ɑ m b oʊ
colonel's	ɡ ɝ n ə l z
colonies	k ɑ l ə m i z
colony	k ɑ l ə m i
color	k ɑ l ɝ
colorado	k ɑ l ɝ ɑ t oʊ
colorist	k ɑ l ɝ ɪ s t
colors	k ɑ l ɝ z
colour	k ɑ l ɝ
coloured	k ɑ l ɝ d
colt	k oʊ l d
coltman	ɡ oʊ l d m ə n
column	k ɑ l ə n
columnist	k ɑ l ə n ɪ s t
combat	k ɑ n b æ t
combat	k ʌ m b æ t
combat	k ɑ m b ɛ t
combatant	k ɑ m p ə t ə n t
combined	k ə m p aɪ n d
combs	k oʊ n z
comby	k ʌ m b i
comeback	k ɑ m b æ k
comedian	k ə m ɪ d i ə n
comedic	k ə m i t ɪ k
comedic	k ə m ɪ t ɪ k
comest	k ʌ m ə s t
comics	k ʌ m ɪ k s
comics	k ɑ m ɪ ɡ z
coming	k ʌ m ɪ n
coming	ɡ ʌ m ɪ ŋ
command	k ə m ɛ n d
commanded	k ə m ɛ n d ɪ d
commandeered	k ɑ m ə n d ɪ ɹ d
commanderies	k ə m æ n d ɝ i s
commando	k ə m ɛ n d oʊ
commemorative	k ə m ɛ m ɝ ə t ɪ v
commendatory	k ə m æ n d ə t ɔ ɹ i
commended	k ə m æ n d ɪ d
commentaries	k ɑ m ə n t ɛ ɹ i z
committed	k ə m ɪ d ɪ d
committee	k ə m ɪ d i
committees	k ə m i t i z
committing	k ə m ɪ t ɪ n
commons	k ɑ m ə n s
compact	k ɑ n p æ k t
compaction	k ə m p ɛ k ʃ ə n
comparable	k ɑ m p ɹ ə b ə l
comparable	k ə m p ɛ ɹ ə b ə l
comparator	k ə m p ɛ ɹ ə t ɝ
compass	k ɑ m p ə s
compensation	k ɑ n p ə n s eɪ ʃ ə n
compete	k ə n p i t
competed	k ə m p ɪ t ɪ d
competition	k ɑ m p ə d ɪ ʃ ə n
complementary	k ɑ m p l ə m ɛ n t ɝ i
complications	k ɑ n p l ə k eɪ ʃ ə n z
composure	k ə m p oʊ ʃ ɝ
comrades	k ɑ m ɝ æ d z
con	k ɑ m
concave	k ɑ ŋ k eɪ v
conceded	k ə n s i t ɪ d
concern	k ə n s ɝ m
concerned	k ə n s ɝ n t
concertos	k ə n tʃ ɛ ɹ t oʊ s
conciliatory	k ə n s ɪ l j ə t ɔ ɹ i
concord	k ɑ n k ɔ ɹ d
concord	k ɑ ŋ k ɔ ɹ d
concord	k ɑ ŋ k ɝ d
concordant	k ə n k ɔ ɹ d ə n t
concordia	k ə m k ɔ ɹ d i ə
concourse	k ɑ ŋ k ɔ ɹ s
concrete	k ɑ ŋ k ɹ i t
concubines	k ɑ ŋ k j ə b aɪ n z
condemned	k ə n d ɛ m t
condoms	ɡ ɑ n d ə m z
condone	k ə n d oʊ m
condors	k ɑ n d ɝ s
conductors	k ə n d ʌ k t ɝ s
confederacies	k ə n f ɛ d ɝ ə s i z
confederation	k ə n f ɛ d ɹ eɪ ʃ ə n
confer	k ə m f ɝ
conferees	k ɑ n f ɹ i z
conference's	k ɑ n f ɹ ə n s ɪ z
conferencing	k ɑ n f ɹ ə n s ɪ ŋ
configure	k ə n f ɪ ɡ j ɝ
confirmation	k ɑ n f ɚ m eɪ ʃ ə n
conger	k ɑ ŋ ɡ ɝ
congo	k ɑ n ɡ oʊ
congolese	k ɑ ŋ ɡ ə l i z
congregation	k ɑ n ɡ ɹ ə ɡ eɪ ʃ ə n
congress	k ɑ n ɡ ɹ ə s
congressional	k ə ŋ ɡ ɹ ɛ ʃ ə n ə l
congruence	k ɑ n ɡ ɹ u ə n s
congruence	k ɑ ŋ k ɹ u ə n s
connectivity	k ə n æ k t ɪ v ɪ t i
conning	k ɑ n ɪ n
conon	k ɑ m ə n
conran	k ɑ n ɹ ə n
cons	k ɑ m z
cons	k ʌ n z
consciousness	k ɑ n ʃ ə s m ə s
conscript	k ɑ n s k ɹ ɪ p t
consensus	k ə n s ɛ n ʃ ə s
conservation	k ɑ n z ɝ v eɪ ʃ ə n
conserved	k ə n z ɝ v d
consortia	k ə n s ɔ ɹ ʃ ə
consortium	k ə n s ɔ ɹ ʃ ə n
consortium	k ə n s ɔ ɹ d i ə m
conspiring	k ə n s p aɪ ɹ ɪ ŋ
consuls	k ɑ n s ə l s
consulting	k ə n s ʌ l t ɪ n
consumer	k ə n s u m ə
contact	k ɑ n t ɛ k t
contacts	k ɑ n t ɛ k t s
contains	k ə n t eɪ n s
contains	k ə n d eɪ n z
contemporary	k ə m t ɛ m p ɝ ɛ ɹ i
contended	k ə n t ɛ n t ɪ d
contracting	k ɑ n t ɹ æ k t ɪ ŋ
contrada	k ɑ n t ɹ ɑ t ə
contrast	k ə n t ɹ æ s t
contrast	k ɑ n t ɹ ɛ s t
contrasts	k ə n t ɹ æ s t s
contributed	k ə n t ɹ ɪ b j u t ɪ t
controversies	k ɑ n t ɹ ə v ɝ ʃ i z
controversy	k ɑ n t ɹ ə v ɝ ʃ i
convention	k ə n f ɛ n ʃ ə n
convergence	k ə n v ɝ dʒ ə n z
converse	k ɑ n f ɝ s
converted	k ə n f ɝ t ɪ d
converting	k ə n v ɝ d ɪ n
converting	k ə n f ɝ t ɪ ŋ
convex	k ɑ n f ɛ k s
convocation	k ɑ n f ə k eɪ ʃ ə n
convulsions	k ə n v ʌ l ʒ ə n z
coogan	ɡ u ɡ ə n
cook	k u k
cooke	k u k
cooked	k u k t
cookery	k u k ɝ i
cookie	k u k i
coolant	k u l ə n d
cooper	k u b ɝ
cooperative	k oʊ ɑ p ɝ ə t i v
coote	k u d
cop	k ʌ p
cop	k ɑ b
cord	k ɔ ɹ t
cordell	k ɔ ɹ d ɛ l
cordless	k ɔ ɹ d l ə s
corduroy	k ɔ ɹ t ɝ ɔɪ
coren	k ɔ ɹ ə n
cornel	k ɔ ɹ n ə l
cornerback	k ɔ ɹ n ɝ b æ k
corners	k ɔ m ə s
corners	k ɔ ɹ n ɝ s
cornett	k ɔ ɹ n ɪ t
cornice	k ɔ ɹ n i s
cornwallis	k ɔ ɹ n w ɔ l ə s
coronal	k ɹ oʊ n ə l
corporatism	k ɔ ɹ p ɝ ə t ɪ z ə m
corps	k ɔ ɹ z
corps	k ɔ ɹ s
corr	k ɔ ɹ
correct	k ɚ ɛ k t
corrective	k ɝ æ k t ɪ v
corrupt	k ɹ ʌ p t
corte	k ɔ ɹ t
cortlandt	k ɔ ɹ t l ə n d
corydon	k ɔ ɹ i d ə n
cosgrave	k ɑ z ɡ ɹ eɪ v
cosimo	k oʊ s ɪ m oʊ
cosmetic	k ɑ z m æ t ɪ k
cosmetics	k ɑ z m æ t ɪ k s
cosmetics	k ɑ s m ɛ t ɪ k s
cosmic	k ɑ s m ɪ k
cosmos	k ɑ s m oʊ s
cost	ɡ ɔ s t
cotes	k oʊ d z
cotta	k ɑ d ə
cotton	k ʌ t ə n
cottrell	k ɑ t ɹ ɛ l
cougar	k u k ɝ
cougars	k u k ɝ z
count	k aʊ n d
counters	k aʊ m t ɝ z
counties	k aʊ n t ɪ s
country	k ɑ n t ɹ i
couple	k ɑ p ə l
coupling	k ɑ p l ɪ ŋ
courier	k ɝ i ɹ
course	k ɔ ɹ z
court	k ɔ ɹ d
court	k ɔ d
courts	k ɔ ɹ d s
courtyard	k ɔ ɹ t j ɑ ɹ t
cousin	k ʌ s ɪ n
covered	k ɑ v ɝ d
covers	ɡ ʌ v ɝ z
cows	k aʊ s
crafted	k ɹ æ f t ɪ d
crafted	ɡ ɹ æ f t ɪ d
crafting	k ɹ æ f t ɪ ŋ
crafts	k ɹ æ f s
craftsman	k ɹ æ f s m ə n
craftsmanship	k ɹ æ f s m ə n ʃ ɪ p
craig	k ɹ æ ɡ
cram	ɡ ɹ æ m
cramp	ɡ ɹ æ m p
cramps	ɡ ɹ æ m p s
crankshaft	k ɹ æ ŋ k ʃ æ f t
crankshafts	k ɹ æ ŋ k ʃ æ f t s
cranney	k ɹ æ n i
crapper	k ɹ æ p ɝ
crassus	k ɹ æ s ə z
crawford	k ɹ ɔ f ɝ t
cray	ɡ ɹ eɪ
craze	k ɹ eɪ s
creams	k ɹ i n z
crean	k ɹ ɪ n
credentials	k ɹ ə d ɛ n ʃ ə l z
credibility	k ɹ ɛ d ə b ɪ l ɪ t i
credibility	k ɹ ɛ t ə b ɪ l ɪ t i
credited	k ɹ ɛ d ɪ d ɪ d
creepy	k ɹ ɪ p i
cremated	k ɹ i m eɪ d ɪ d
cremation	k ɹ ɪ m eɪ ʃ ə n
crematorium	k ɹ ɛ m ə t ɔ ɹ i ə m
cremona	k ɹ ɪ m oʊ n ə
crepe	k ɹ æ p
crespo	k ɹ ɛ s b oʊ
crests	ɡ ɹ ɛ s t s
creswick	k ɹ ɛ z w ɪ k
cricket	k ɹ i k ɪ d
cricketer	k ɹ ɪ k ɪ t ɝ
crimean	k ɹ ɪ m i n
cringe	k ɝ ɪ n dʒ
crippling	k ɹ ɪ p l ɪ ŋ
crissey	k ɹ ɪ s i
criswell	k ɹ ɪ z w ɛ l
critique	k ɹ ə t i k
critiqued	k ɹ ɪ t i k t
critiqued	k ɹ ɪ t ɪ k t
critiquing	k ɹ ɪ t i k ɪ ŋ
crittenden	k ɹ ɪ d ə n d ə n
crockery	k ɹ ɑ k ɝ ɪ
crooked	k ɹ ʊ k d
crookston	k ɹ ʊ k s t ə n
crops	k ɹ ʌ p s
crosby	k ɹ ɔ s b i
cross	k ɹ ʌ s
crossing	k ɹ ɔ s ɪ n
crossing	k ɹ ɔ s i n
crossword	k ɹ ɔ s w ɝ d
crowds	k ɹ aʊ d s
crown	k ɹ aʊ m
crown	ɡ ɹ aʊ n
croydon	k ɹ ɔɪ t ə n
cruel	k ɹ u l
crusoe's	k ɝ u s oʊ z
crust	k ɹ ʌ ʃ t
cruz's	k ɹ u z ɪ z
crying	k ɹ aɪ ɪ n
cuban	k j u p ə n
cucumber	k j u k ʌ m b ɝ
cuddles	k ʌ t ə l z
cuddy	k ʌ t i
cullen	k ɑ l ə n
cult	k ɑ l t
culture	k ɑ l tʃ ɝ
cultus	k ɑ l t ə s
culver	k ɑ l v ɝ
cup	k ʌ b
cup	k ɑ p
cup	ɡ ʌ p
cups	k ɑ p s
curfew	k ɝ v j u
curio	k j u ɹ i oʊ
curiosity	k j ɝ i ɑ s ə t i
current	k ɑ ɹ ə n d
curry	k ɑ ɹ i
curry	k ɝ ɪ
curtis	k ɝ d ɪ s
curve	k ɝ f
cush	k u ʃ
cusp	k ɑ s p
cusps	k ɑ s p s
custom	k ɑ s t ə m
cut	k ɑ t
cut	ɡ ɑ t
cut	k ɑ d
cutler	k ɑ t l ɝ
cuts	k ʌ d s
cutting	k ʌ t ɪ n
cuttings	k ʌ t ɪ n z
cylindrical	s ɪ l ɪ n t ɹ ɪ k ə l
cylindrical	s ɪ l ɪ n d ɝ ɪ k ə l
cynthia	s ɪ m θ i ə
cyperus	s aɪ p ɹ ə s
cypriots	s ɪ p ɹ i ə t s
cyrillic	s ɹ ɪ l ɪ k
cystic	s ɪ s t ɪ ɡ
czar	s ɑ ɹ
czech	tʃ æ k
d	t i
d	t
d	d ɪ
dacian	d eɪ s i ə n
dad	d ɛ d
daddy	d ɛ t i
dado	d eɪ t oʊ
dairy	t ɛ ɹ i
daisy	d eɪ z ɪ
dal	d ɛ l
dallas	d ɛ l ə s
dam's	d æ m s
damming	d æ m i n
damping	t æ m p ɪ ŋ
dan	d ɛ n
danby	d æ m b i
dance	d æ n z
dance	t æ n z
dance	d ɛ n s
dancing	d æ n s i ŋ
dandenong	d æ n d ə n ɔ n
danger	d eɪ n dʒ ɚ
dani	d ɛ n i
danielle	d ɛ n j ɛ l
danny	t æ n i
danville	d ɛ n v ɪ l
danzig	d æ n z ɪ k
darden	d ɑ ɹ d ə n
darius	d ɛ ɹ i ə s
darla	d ɑ ɹ l ə
darlene	d ɑ ɹ l i n
darren	d ɛ ɹ ə n
darren	t ɛ ɹ ə n
darryl	d ɛ ɹ ə l
darwish	d ɑ ɹ w ɪ ʃ
daryl	d ɛ ɹ ə l
das	d ʌ s
data	t æ t ə
data	d eɪ d ə
date	t eɪ t
dates	t eɪ t s
dates	d eɪ t z
dates	d eɪ d s
dating	d eɪ t i n
dative	d eɪ t ɪ f
daughter	d ɑ t ɝ
daughter	d ɔ ɾ ɝ
davies	d eɪ v ɪ s
davies	d eɪ v i s
davies	d eɪ f i z
davis	d eɪ v i z
davis	d eɪ v ɪ z
davy	d eɪ v ɪ
days	d eɪ s
days	t eɪ z
de	d ɪ
de	t eɪ
deaconess	d i k ə n ɛ s
dead	d ɛ t
dead	d æ t
dead	d æ d
deaf	t ɛ f
dean	t i n
dean	d i m
dean	d ɪ n
dease	d i z
deb	d æ b
debated	t ə b eɪ t ɪ d
debbie	d æ b i
deborah	d ɛ b ɹ ə
debugging	d i b ʌ k ɪ ŋ
decapitated	d ɪ k æ p ə t eɪ t ɪ d
decapitates	d ɪ k æ p ə t eɪ t s
decentralized	d i s ɛ n t ɹ ə l aɪ z d
decision	d ɪ s ɪ ʃ ə n
decode	d i k oʊ d
decoding	d ɪ k oʊ t ɪ ŋ
decoding	d i k oʊ t ɪ ŋ
decorative	d ɛ k ɝ ə t ɪ v
decrease	d ɪ k ɹ i s
decrease	d ɪ k ɹ i z
decreased	d ɪ k ɹ i s t
decreases	d i k ɹ i s ɪ z
decreases	d ɪ k ɹ i z ɪ z
decree	d ɪ ɡ ɹ i
decrees	d ɪ k ɹ i s
decumbent	d i k ʌ m b ə n t
dedications	d ɛ t ə k eɪ ʃ ə n z
dedrick	d ɛ d ɹ ɪ k
dee	t i
deep	t i p
deer	d i ə
deerfield	d ɪ ɹ f ɪ l d
default	d i f ɔ l t
defaulted	d i f ɔ l t ɪ d
defense	d i f æ n z
deforestation	d i f ɔ ɹ ə s t eɪ ʃ ə n
deformation	d i f ɔ ɹ m eɪ ʃ ə n
defray	d i f ɹ eɪ
defuse	d ɪ v j u z
degenerate	d i dʒ ɛ n ɝ eɪ t
degenerates	d i dʒ ɛ n ɝ eɪ t s
degrades	d i ɡ ɹ eɪ d z
degree	d ɪ k ɹ i
degrees	d ɪ k ɹ i z
dehumanizing	d i h j u m ə n aɪ z ɪ ŋ
deidre	d i d ɹ ə
deist	t i ɪ s t
delayed	d ɪ l eɪ t
delayed	d i l eɪ d
delegate's	d ɛ l ə k ə t s
delegates	d ɛ l ə k ə t s
deletion	d ɪ l ɪ ʃ ə n
deletion	d ɪ l i ʒ ə n
delgado	d ɛ l ɡ ɑ t oʊ
delhi	d æ l i
deliberate	d ɪ l ɪ b ɹ eɪ t
deliberative	d ɪ l ɪ b ɝ ə t ɪ v
delineated	d i l ɪ n i eɪ t ɪ d
deliverable	d ɪ l ɪ v ɹ ə b ə l
delivery	d ɪ l ɪ v ɹ i
dell	d æ l
deller	t ɛ l ɝ
delmarva	d ɛ l m ɑ ɹ v ə
delmonico	d ɛ l m ɑ n ɪ k oʊ
delphos	d ɛ l f oʊ s
delusional	d ɪ l u ʃ ə n ə l
demetre	d ɛ m ɪ t ɝ
demetrius	d ɪ m i t ɹ i ə s
demobilisation	d i m oʊ b ə l ɪ z eɪ ʃ ə n
demobilize	d i m oʊ b ə l aɪ z
demobilized	d i m oʊ b ə l aɪ z d
demonstrating	d ɛ m ə n s t ɹ eɪ t ɪ n
denarii	d ɪ n ɛ ɹ i
denarius	d ɪ n ɑ ɹ i ə s
dendritic	d ɛ n t ɹ ɪ t ɪ k
deng	d æ ŋ
denise	d ə n i s
dennis	t ɛ n ɪ s
dennis	d æ n ɪ s
denotation	d i n oʊ t eɪ ʃ ə n
denote	d i n oʊ t
dense	d æ n s
dense	d ɛ n z
densmore	d ɛ n z m ɔ ɹ
denver	d ɛ n f ɝ
denys	d ɛ n i z
depart	d ɪ b ɑ ɹ t
depopulated	d i p ɑ p j ə l eɪ t ɪ d
deportation	d i p ɔ ɹ t eɪ s ə n
deported	d ɪ b ɔ ɹ t ɪ d
depression	d ɪ p ɹ ɛ ʃ ə m
derbyshire	d ɝ b ɪ ʃ ɝ
dermatitis	t ɝ m ə t aɪ t ə s
dervish	t ɝ f ɪ s
des	d ɪ s
descend	d ɪ s ɛ n t
descendant	d ɪ s ɛ n t ə n t
descending	d i s ɛ n d ɪ ŋ
desecrated	d ɛ s ə k ɹ eɪ t ɪ d
desecration	d ɛ s ə k ɹ eɪ ʃ ə n
deseret	d ɛ z ɝ ɛ t
desert	d ɪ z ɝ d
desertions	d ɪ s ɝ ʃ ə n z
deserving	d ɪ s ɝ v ɪ ŋ
deshler	d æ ʃ l ɝ
design	d ɪ s aɪ n
design	t ɪ s aɪ n
designated	d ɛ s ɪ ɡ n eɪ t ɪ d
designates	d ɛ s ɪ ɡ n eɪ t s
designed	d ɪ s aɪ n d
designer	d ɪ z aɪ n ɚ
designs	d ɪ s aɪ n z
desirability	d ɪ z aɪ ɹ ə b ɪ l ɪ t i
desmond	d ɛ s m ə n t
desperate	d ɛ s p ɹ eɪ t
detail	d ɪ t eɪ l
detailed	d i t eɪ l d
detailing	d i t eɪ l ɪ ŋ
detained	d i t eɪ n d
detect	d ɪ t æ k t
detention	d i t ɛ n ʃ ə n
determined	d ɪ t ɝ m ə n t
deterrent	d ɪ t ɝ ə n d
dethroned	d ɪ θ ɹ oʊ n d
dethrones	d ɪ θ ɹ oʊ n z
detrimental	d ɛ t ɹ ə m ɛ n t ə l
detritus	d ɛ t ɹ ə t ə s
detroit	d ɪ t ɹ ɔɪ t
deuterium	d u t ɪ ɹ i ə m
deuterons	d u d ɝ ɑ n z
devas	d ɛ v ə z
devi	d ɪ v i
device	d ɪ v aɪ z
devices	d ɪ v aɪ s ɪ s
devlin	d æ v l ɪ n
devolves	d i v ɑ l v z
devon	d æ v ə n
dewey	t u i
dexterity	d ɛ k s t ɛ ɹ ə t i
dhaka	t ɑ k ə
diabetes	d aɪ ə b i d i z
diagnosed	d aɪ ə ɡ n oʊ z d
diagnosed	d aɪ ə ɡ n oʊ z t
diagnosed	d aɪ ə ɡ n oʊ s d
dialects	d aɪ ə l æ k t s
diaspora	d aɪ æ s p ɹ ə
diatonic	d aɪ ə t ɑ m ɪ k
dibble	d ɪ p ə l
dickens	d i k ɪ n z
dickens	d i k ə n z
dickinson	d ɪ k ɪ n z ə n
dickinson	d i k ɪ n s ə n
did	d i d
did	d ɪ t
didi	d ɪ d i
dierks	d ɪ ɹ k s
diesel	d ɪ s ə l
diesels	d i s ə l z
dietrich	d i d ɹ ɪ k
differently	d ɪ f ɝ ə n t l i
differing	d ɪ f ɝ ɪ n
difficulties	d ɪ f ɪ k ə l t i s
diffusion	d ɪ f j u z ə n
digging	t ɪ ɡ ɪ ŋ
dillon	d i l ə n
dilution	d ɪ l u ʒ ə n
dimes	d aɪ n s
dinar	d ɪ n ɑ ɹ
dingbats	t ɪ ŋ b ɛ t s
diocese	d aɪ ə s ɪ s
diocese	d aɪ ə s i s
diocese	d aɪ ə ʃ i z
dionysus	d aɪ ə n i s ə s
diorama	d aɪ ɹ æ m ə
dire	d aɪ ɝ
direct	d ɪ ɹ ɛ k t
directed	d ɚ ɛ k t ɪ d
directly	d ɪ ɹ æ k l i
director	d ɝ æ k t ɝ
directorial	d ɝ ɛ k t ɔ ɹ i ə l
directors	d ɝ ɛ k t ɝ s
directors	d ɚ ɛ k t ɝ z
dirt	d ɝ d
dirty	d ɝ d i
disappeared	d ɪ z ə p ɪ ɹ d
disassociated	d ɪ s ə s oʊ ʃ i eɪ t ə d
disaster	d ɪ s æ s t ɝ
disbanded	d ɪ s p æ n d ɪ d
disbanding	d ɪ s p ɛ n d ɪ ŋ
disbelief	d ɪ s b ɪ l i v
disbursements	d ɪ s p ɝ s m ə n t s
discarded	d ɪ s k ɑ ɹ t ɪ d
disconnect	d ɪ s k ə n æ k t
disconsolately	d ɪ s k ə n s ɑ l ə d l i
discovered	d ɪ s k ɑ v ɝ d
discoveries	d ɪ s k ʌ v ɹ i z
discovering	d ɪ s k ʌ v ɹ ɪ ŋ
discussed	d ɪ s ɡ ʌ s t
disdained	d ɪ s t eɪ n d
disease	d ɪ s i z
disease	d ɪ s ɪ ʒ
disease	d i z i z
diseases	d ɪ s i s ɪ s
diseases	d ɪ z i s ɪ z
disgrace	d ɪ s k ɹ eɪ s
disgraced	d ɪ s k ɹ eɪ s t
disgruntled	d ɪ s k ɹ ʌ n t ə l d
disguised	d ɪ s k aɪ z d
dishes	d ɪ ʃ ɪ s
diskette	d ɪ s k æ t
disney	d ɪ s n i
disney	d ɪ z m i
disney	d ɪ ʃ n i
dispensary	d ɪ s p ɛ n s ɛ ɹ i
dispersion	d ɪ s p ɝ ʃ ə n
displays	d ɪ s p l eɪ s
disraeli	d ɪ s ɹ eɪ l i
disrepair	d ɪ s ɹ i p ɛ ɹ
disrespected	d ɪ s ɹ ɪ s p ɛ k t ɪ d
dissertation	d ɪ z ɝ t eɪ ʃ ə n
dissociate	d ɪ s oʊ ʃ i eɪ t
dissociation	d ɪ s oʊ ʃ i eɪ ʃ ə n
dissolution	d ɪ s ə l u ʒ ə n
dissolve	d ɪ s ɑ l v
dissolved	d ɪ s ɑ l v d
distance	d ɪ s d ə n s
distraught	d ɪ s t ɹ ɔ d
distress'd	d ɪ s t ɹ ɛ s t
distributed	d ɪ s t ɹ ɪ b j u t ɪ t
distributive	d ɪ s t ɹ ɪ b j u t ɪ v
ditka	d ɪ d k ə
ditties	d ɪ d i z
diverse	d ɪ v ɝ z
diversionary	d ɪ v ɝ ʒ ə n ɛ ɹ i
diversity	d ɪ v ɝ z ə t i
diverts	d ɪ v ɝ t z
divide	d ɪ f aɪ t
divided	d ɪ f aɪ d ɪ d
divides	d ɪ f aɪ d z
diving	d aɪ v ɪ n
division	d ɪ v ɪ ʃ ə n
division	d ɪ f ɪ ʃ ə n
division	d ɪ v ɪ z ə m
divisions	d ɪ f ɪ ʃ ə n s
do	t u
do	d ʊ
dobson	d ɑ p s ə n
dock	d ʌ k
docked	d ʌ k t
dockers	d ʌ k ɝ z
dockery	d ɑ k ɹ i
docks	d ʌ k s
doctoral	d ɑ k t ɹ ə l
doctorate	d ɑ k t ɹ ə t
doctorates	d ɑ k t ɹ ə t s
documentaries	d ɑ k j ə m ɛ n t ɹ i z
dodges	d ɑ dʒ ɪ s
dodo	d oʊ t oʊ
dodson	d ʌ d s ə n
dodsworth	d ɑ t s w ɝ θ
doer's	d ʊ ɝ z
does	d ʌ s
dog	d ʌ k
dog	t ɔ ɡ
dog	d ʌ ɡ
dogs	d ɔ k s
dogs	d ɑ k s
dogs	d ɑ k z
dogs	d ɔ ɡ s
doherty	d ɔ ɹ t i
doherty	d ɔ ɹ d i
doll	d ʌ l
dolls	t ɑ l z
dom	d ɑ n
dome	d oʊ n
domestic	d ə m æ s t ɪ k
domestica	d ə m æ s t ɪ k ə
don't	d oʊ n d
done	t ʌ n
done's	d ʌ m z
donegal	d ɑ n ɪ k ə l
donizetti's	d ɑ n ə z ɛ d i z
donna	d ʌ n ə
donne's	d ʌ n z
donnie	d ʌ ŋ i
donovan	d ɑ n ə v ɪ n
doonesbury	d u n z b ɛ ɹ i
doping	d oʊ b ɪ ŋ
doppler	d ɑ b l ɝ
doppler	t ɑ p l ɝ
dordogne	t ɔ ɹ d oʊ n
dorff	d ɔ ɹ f
doris	d ɔ ɹ ə s
dorms	d ɔ ɹ m z
dorney	d ɔ ɹ n i
dornier	d ɔ ɹ n ɪ ɹ
dorothy's	d ɔ ɹ ə θ i z
dorries	d ɔ ɹ i z
dorsally	d ɔ ɹ s ə l i
dosage	d oʊ ʃ ɪ dʒ
dosing	d oʊ z ɪ ŋ
dots	d ʌ t s
dowd	d aʊ t
dowdeswell	d aʊ t ə s w ɛ l
dowdy	d aʊ t i
downing	d aʊ n ɪ n
dowry	d aʊ ɝ i
dowsing	d aʊ s ɪ ŋ
doyle's	t ɔɪ l z
drabinsky	t ɹ ə b ɪ n s k i
draftees	d ɹ æ f t i z
drainage	t ɹ eɪ n ɪ dʒ
drastically	d ɹ ɛ s t ɪ k l i
draughty	d ɹ ɔ d i
dravecky	t ɹ ə v ɛ k i
drawers	d ɹ ɔ ɝ z
draws	t ɹ ɔ z
dream	d ɹ ɪ m
dream	t ɹ i m
dreamer	t ɹ i m ɝ
drearily	d ɹ ɪ ɹ ə l i
drechsler	d ɹ æ k s l ɝ
dredd	d ɹ ɛ d
dredge	d ɹ æ dʒ
drescher	d ɹ ɛ ʃ ɝ
dresden	d ɹ ɛ s t ə n
dresden	d ɹ ɛ z t ə n
dress	t ɹ ɛ s
dressen	d ɹ ɛ s ə n
dresser	t ɹ ɛ s ɝ
dressing	d ɹ ɛ s ɪ n
drew	t ɹ u
drexel	d ɹ æ k s ə l
dribble	d ɹ ɪ p ə l
dribbling	d ɹ ɪ b ə l ɪ ŋ
drinkable	d ɹ ɪ ŋ k ə b ə l
driscoll	t ɹ ɪ s k ə l
drood	t ɹ u t
dropped	d ɹ ɑ b d
drudgery	d ɹ ɑ d z ɝ i
drue	t ɹ u
drug	d ɹ ʌ k
drug	d ɹ ɑ k
drugs	t ɹ ʌ k s
drugs	d ɹ ʌ k s
drugs	d ɹ ɑ k s
drummer	d ɹ ɑ m ɝ
drummers	d ɹ ɑ m ɝ z
drury	d ɹ ʊ ɹ i
drusilla	t ɹ u s ɪ l ə
dry	t ɹ aɪ
dryden	d ɹ aɪ t ə n
dubbed	t ʌ b d
dubbed	d ɑ p t
dubbing	d ɑ b ɪ ŋ
dublin	d ɑ b l ɪ n
dubs	d ʌ b s
ducks	d ɑ k s
duddingston	d ʌ t ɪ ŋ s t ə n
dudley	d ʌ t l i
due	t u
duer	d ʊ ɝ
duker	t u k ɝ
dulwich	d ɑ l w ɪ tʃ
dumas	d u m ə s
dumas	t u m ə s
dumb	d ɑ m
dumfries	d ʌ m f ɹ i z
dummies	d ɑ m i z
dump	t ʌ m p
duncan	d ʌ n k ə n
dundas	d ʌ n d ə s
dundry	d ʌ n d ɹ i
dunes	d u n s
dunlop	d ʌ n l ʌ p
dunn	d ɑ n
dupont	d u p ɑ n d
durango	d ɝ æ n ɡ oʊ
durango	d ɹ æ ŋ ɡ oʊ
durham	d ɝ ə n
during	d ʊ ɹ ɪ n
during	d u ɹ ɪ ŋ
during	t ɝ ɪ n
during	t ɝ ɪ ŋ
dutton	d ɑ t ə n
dvorak	d f ɔ ɹ æ k
dwarfing	d w ɔ ɹ f i n
dwarves	d w ɔ ɹ f s
dwarves	d w ɔ ɹ v s
dyncorp	d ɪ n k ɔ ɹ p
dysentery	d ɪ z ə n t ɹ i
each	ɪ tʃ
each	ɪ t s
eagleswood	i ɡ ə l z w ʊ d
ealing	ɪ l ɪ ŋ
earhart	ɛ ɹ h ɑ ɹ t
early	ɹ l i
early's	ɝ l i s
earmarks	ɪ ɹ m ɑ ɹ k s
earnhardt	ɝ n h ɑ ɹ t
earnings	ɝ n ɪ n z
earnings	ɹ n ɪ ŋ z
earwig	ɪ ɹ w ɪ ɡ
ease	ɪ z
easley	i s l i
east	ɪ s t
eastern	ɪ s t ɝ n
eastern	ɪ s t ə n
eastern	i s t ɝ m
easternmost	ɪ s t ɝ n m oʊ s t
easy	ɪ s i
eat	ɪ t
eatery	i d ɝ i
eating	ɪ t ɪ ŋ
eating	i d ɪ ŋ
eaton	i d ə n
eaves	i v s
ebbe	ɛ p
ebenezer	ɛ b ə n i z ɝ
ebinger	æ b ɪ ŋ ɝ
ebook	i b ʊ k
echelon	æ ʃ ə l ɑ n
eckersley	ɛ k ɝ z l i
econometrics	ɪ k ɑ n ə m ɛ t ɹ ɪ k s
economic	ɪ k ə n ɑ m ɪ k
economics	æ k ə n ɑ m ɪ k s
economists	i k ɑ n ə m ɪ s t s
ecuador	ɛ k w ə t ɔ
ecuadorian	ɛ k w ə d ɔ ɹ i ə n
ed	æ d
ed	ɛ t
ed's	æ t s
edda	æ d ə
eddie	æ d i
eddy	ɛ t i
eden	i t ə n
edge	æ dʒ
edible	ɛ t ə b ə l
edinburgh	ɛ d ə m b ɝ ɡ
edit	æ d ɪ d
edited	ɛ d ɪ d ɪ d
edited	æ d ɪ t ɪ d
edition	ə d i ʃ ə n
editors	æ d ɪ t ɝ z
edits	æ d ɪ t s
edmond	æ d m ə n t
edmonton	ɛ d m ə n d ə n
edmonton	æ t m ə n t ə n
edmonton	æ d m ə n t ə n
edmonton	ɛ t m ə n t ə n
edmund	æ d m ə n d
edo	i t oʊ
edson	ɛ d s ə m
education	æ dʒ ə k eɪ ʃ ə n
edward	ɛ d w ɝ t
edward	æ d w ɝ t
edwardian	ɛ d w ɔ ɹ d i ə n
edwin	æ t w ɪ n
edwina	æ d w i n ə
eels	ɪ l z
efficiencies	ɪ f ɪ ʃ ə n s i s
efficiency	i f ɪ ʃ ə n s i
egan	i k ə n
egbert	æ ɡ b ɝ t
egestion	ɪ dʒ ɛ s tʃ ə n
egg	æ ɡ
eh	æ
ehlert	ɛ l ɝ d
ehret	ɛ ɹ ɪ t
eight	eɪ d
eighties	eɪ d i z
eighty	eɪ d i
einstein	aɪ n ʃ t aɪ n
eisenhower	aɪ s ə n h aʊ ɝ
eisner	aɪ z n ɝ
elaborately	ɪ l æ b ɝ ə t l i
elaine	i l eɪ n
elamites	æ l ə m aɪ t s
elasticity	ɪ l æ s t ɪ s ə t i
elated	ɪ l eɪ d ɪ d
elath	i l æ θ
elba	æ l b ə
elbert	æ l b ɝ t
elbow	æ l b oʊ
elbowing	æ l b oʊ ɪ ŋ
elbows	æ l b oʊ z
elbrus	ɛ l b ɹ ə s
elburne	æ l b ɝ n
elderslie	ɛ l d ɝ z l i
eldorado	ɛ l d ɝ ɑ t oʊ
eldridge	æ l d ɝ ɪ dʒ
eleanor	ɛ l ə n ɔ ɹ
electorate	ɪ l ɛ k t ɝ ɪ t
electorate	ɪ l ɛ k t ɹ ɪ t
electrons	ɪ l ɛ k t ɹ ɑ n z
elemental	æ l ə m ɛ n t ə l
elementary	ɛ l ə m ɛ n t ɹ i
elementary	ɛ l ə m ɛ n t ɝ i
elementary	ɛ l ə m ɛ n t ɝ ɹ i
elementary	æ l ə m ɛ n t ɝ i
elements	æ l ə m ə n t s
elena	ɛ l i n ə
elevation	ɛ l ə f eɪ ʃ ə n
eleven	i l ɛ f ə n
elie	æ l i
elim's	i l ɪ m z
elise	ɪ l i s
elite	æ l i t
elite	ə l i d
elixirs	ɪ l ɪ k s ɝ z
eliza	ɪ l i z ə
elizabeth	ɪ l ɪ s ə b ɛ θ
elkins	æ l k ɪ n z
elko	æ l k oʊ
elle	æ l
ellen	æ l ə n
ellicott	æ l ɪ k ɑ t
elliott	æ l i ə t
ellis	ɛ l i s
ellison	æ l ɪ s ə n
ellison's	æ l ɪ s ə n z
elma	æ l m ə
elmira	æ l m aɪ ɹ ə
elongation	ɪ l ɔ ŋ ɡ eɪ ʃ ə n
eloping	ɪ l oʊ p ɪ n
else	æ l s
else	ɛ l z
elton	ɛ l d ə n
elvina	æ l f i n ə
elyria	ɪ l ɪ ɹ i ə
elysium	ɪ l ɪ s i ə m
elysium	ɪ l i s i ə m
elzey	ɛ l s i
emad	ɪ m æ d
emanations	æ m ə n eɪ ʃ ə n z
embankments	æ m b æ ŋ k m ə n t s
embedded	ɪ m b ɛ t ɪ d
embrasures	ɛ m b ɹ eɪ ʃ ɝ z
embry	ɛ m b ɹ i
embry	æ m b ɹ i
emendations	æ m ə n d eɪ ʃ ə n z
emerald	ɛ m ɝ ə l d
emerald	ɛ m ɹ ə l d
emeralds	ɛ m ɝ ə l d z
emeritus	ɪ m ɛ ɹ ɪ d ə s
emic	ɪ m ɪ k
emigrated	ɛ m ə k ɹ eɪ t ɪ d
emmy	æ m i
emotionally	ɪ m oʊ ʃ n ə l i
empathetic	æ m p ə θ ɛ t ɪ k
empathy	æ m p ə θ i
emperor	ɛ m p ɝ ə
emphasis	ɛ m f ə z ə s
emphysema	æ m f ə z i m ə
emporia	æ m p ɔ ɹ i ə
empresa	ɛ m p ɹ ɛ s ə
empress	ɛ n p ɹ ɛ s
empress	ɛ m p ɝ ə s
emptiness	æ m t i n ə s
empty	æ m t i
empty	æ n t i
ems	ɛ n z
emsworth	ɛ n z w ɝ θ
emu	ɪ m j u
emulsion	ɪ m ʌ l ʒ ə n
en	æ n
encarta	ɛ n k ɑ ɹ d ə
enclave	æ n k l eɪ v
enclitic	æ n k l ɪ t ɪ k
encores	ɑ n k ɔ ɹ s
encores	ɑ n k ɔ ɹ z
encrypted	ɪ n k ɹ ɪ p t ɪ d
encyclical	æ n s ɪ k l ɪ k ə l
end	æ n d
endearing	ɛ n d ɪ ɹ ɪ ŋ
endearing	æ n d ɪ ɹ ɪ ŋ
ended	æ n d ə t
ended	ɛ n t ɪ d
endemic	æ n d ɛ m ɪ k
endemic	ɛ m d ɛ m ɪ k
enderby	æ n d ɝ b i
enders	æ n d ɝ z
ending	ɛ n d i ŋ
endorsed	æ n d ɔ ɹ s t
endorser	ɪ n d ɔ ɹ s ɝ
endowment	æ n d aʊ m ə n t
enduring	ɪ n d ʊ ɹ ɪ ŋ
enduring	ɪ n d j ʊ ɹ ɪ ŋ
enduser	ɛ n t j u z ɝ
enemies	æ n ə m i z
enemy	æ n ə m i
energy	æ n ɝ dʒ i
enfield	æ n f ɪ l d
eng	æ ŋ
engel	æ ŋ ɡ ə l
engel's	æ ŋ ɡ ə l z
engels	æ ŋ ɡ ə l z
engineer's	ɛ n dʒ ə n ɪ ɹ z
england	ɪ n l ə n d
engle	æ ŋ ɡ ə l
englewood	æ ŋ ɡ ə l w ʊ d
engstrom	æ ŋ s t ɹ ə m
engstrom	ɛ ŋ s t ɹ ə m
enormity	ɪ n ɔ ɹ m ə t i
enough	ɪ n ɑ f
enrique	æ n ɹ i k
enron	ɛ n ɹ ɑ n
enron	æ n ɹ ɑ n
ensign	æ n s ə n
ensley	ɛ n z l i
ensured	ɪ n ʃ ʊ ɹ d
ensures	ɪ n ʃ ʊ ɹ z
enter	æ n t ɝ
enter	ɛ n d ɝ
enteric	æ n t ɛ ɹ ɪ k
entering	ɛ n t ɹ ɪ ŋ
enthusiasm	ɪ n θ u ʒ i æ z ə m
entire	ɪ n t aɪ ɹ
entirely	ɪ n t aɪ ɚ l i
entirety	ɪ n t aɪ ɹ t i
entitled	æ n t aɪ t ə l d
entomologist	æ n t ə m ɑ l ə dʒ ɪ s t
entomology	æ n t ə m ɑ l ə dʒ i
entrada	ɛ n t ɹ ɑ t ə
entropy	æ n t ɹ ə p i
entry	æ n t ɹ i
entry	ɛ n t ɹ ɪ
envelope	æ n v ə l oʊ p
envisioned	ɛ m v ɪ ʒ ə n d
envoy	æ n v ɔɪ
enzyme	ɛ n s aɪ m
enzyme	ɛ m z aɪ n
enzyme	æ n s aɪ m
enzyme	ɛ m z aɪ m
enzyme	ɛ n z aɪ n
enzyme	ɛ m s aɪ m
ephemeral	i f ɛ m ɝ ə l
ephron	ɛ f ɹ ə n
epic	ɛ p ɪ ɡ
episode	æ p ə s oʊ d
episodic	æ p ə s ɑ t ɪ k
episodic	ɛ p ə s ɑ t ɪ k
epistemic	ɛ p ə s t ɛ m ɪ k
epithelium	ɛ p ɪ θ i l i ə m
eponymous	i p ɑ n ə m ə s
epps	æ p s
epsilon	æ p s ɪ l ə n
epsilon	æ p s ə l ɑ n
epstein	æ b s t i n
equality	i k w ɑ l ə t i
equals	i k w ə l s
equals	ɪ k w ə l z
equanimity	ɪ k w ə n ɪ m ɪ t i
equation	i k w eɪ ʒ ə n
equations	i k w eɪ ʒ ə n z
equator	i k w eɪ t ɝ
equatorial	ɛ k w ə d ɔ ɹ i ə l
equestrian	ɪ k w ɛ s t ɹ i ə m
equilibria	i k w ə l ɪ b ɹ i ə
equilibrium	ɛ k w ɪ l ɪ b ɹ i ə m
equine	ɪ k w aɪ n
equipped	i k w ɪ p t
equivalent	i k w ɪ v ə l ə n t
era	ɪ ɹ ə
era's	ɪ ɹ ə z
eradication	ɪ ɹ æ t ə k eɪ ʃ ə n
erased	ɪ ɹ eɪ s t
eraser	ɪ ɹ eɪ s ɝ
erasmus	ɪ ɹ æ s m ə s
erect	i ɹ ɛ k t
ergo	ɹ ɡ oʊ
erhard	ɛ ɹ h ɑ ɹ d
erman	ɹ m ə n
erotic	ɪ ɹ ɑ d ɪ k
erp	ɝ b
err	ɹ
errata	ɹ ɑ d ə
erratic	ɪ ɹ æ d ɪ k
erred	ɛ ɹ d
erred	ɹ d
error	ɛ ɹ
ertel	ɹ t ə l
erupted	ɪ ɹ ʌ p t ɪ d
eruptions	ɪ ɹ ʌ p ʃ ə n z
ervin	ɝ v i n
esbern	æ s b ɝ n
escalators	ɛ s k ə l eɪ d ɝ z
escher	æ ʃ ɝ
esdras	ɛ s t ɹ ə s
esher	æ ʃ ɝ
esperance	ɛ s p ɝ ə n s
esprit	ɛ s p ɹ ɪ
esquire	ɛ s k w aɪ ɝ
essence	æ s ə n s
essential	ɪ s ɛ n tʃ ə l
essentially	ɪ s ɛ n s ə l i
esters	æ s t ɝ z
esther	ɛ s θ ɝ
esther	æ s t ɝ
esther	æ s θ ɝ
esthetics	æ s θ ɛ t ɪ k s
eston	æ s t ə n
estrada	ɛ s t ɹ ɑ t ə
estrella	æ ʃ t ɹ ɛ l ə
estrus	ɛ s t ɹ ə s
et	æ t
etc	æ t s ɛ t ɝ ə
ethel	æ θ ə l
ethnic	ɛ θ m ɪ k
ethnicity	ɛ θ m ɪ s ɪ t i
ethnological	ɛ θ m ə l ɑ dʒ ɪ k ə l
ethyl	æ θ ə l
etiquette	ɛ d ə k ə t
etna	ɛ d n ə
ettinger	ɛ d ɪ ŋ ɝ
etymologically	ɛ d ə m ə l ɑ dʒ ɪ k l i
eucharist	j u k ɝ ɪ s t
euphoric	j u f ɔ ɹ ɪ k
eure	ɹ
euro	j ʊ ɹ oʊ
eustis	j u s t ɪ z
evade	ɪ v eɪ d
evaded	ɪ v eɪ d ɪ d
evading	ɪ v eɪ d ɪ ŋ
evaluation	i v æ l j u eɪ ʃ ə n
evaluations	i v æ l j u eɪ ʃ ə n z
evangelism	ɪ v æ n dʒ ə l ɪ z ə m
evangelists	ɪ v æ n dʒ ə l ɪ s t s
evans's	ɛ v ə n s ɪ z
evanston	ɛ v ə n z d ə n
evaporate	i v æ p ɝ eɪ t
evaporated	i v æ p ɝ eɪ t ɪ d
evaporated	i v æ p ɚ eɪ t ɪ d
evaporates	i v æ p ɝ eɪ t s
evaporating	i v æ p ɝ eɪ t ɪ ŋ
evaporation	i v æ p ɝ eɪ ʃ ə n
evasive	ɪ v eɪ s ɪ v
even	ɪ v ə n
event	ɪ f ɛ n t
event	i f ɛ n t
events	ɪ f ɛ n t s
events	i f ɛ n t s
eventual	ɪ v ɛ n tʃ u ə l
eventually	i v ɛ n tʃ u l i
ever	æ v ɝ
everingham	ɛ v ɹ ɪ ŋ h æ m
everitt	ɛ v ɹ ɪ t
evers	ɛ v ɝ s
evers	æ v ɝ z
every	ɛ f ɹ i
evesham	ɪ v s ə m
evesham	i v s ə m
eviction	ɪ f ɪ k ʃ ə n
evoked	ɪ v oʊ k t
evokes	ɪ v oʊ k s
excavated	ɛ k s k ə f eɪ t ɪ d
excelled	ɪ ɡ z ɛ l d
excess	æ k s ɛ s
exchequer	ɛ k s tʃ ɛ k ɝ
excision	ɪ k s ɪ ʃ ə n
exclusionary	ɪ k s k l u ʒ ə n ɛ ɹ i
excretory	ɛ k s k ɹ ə t ɔ ɹ i
executed	ɛ ɡ z ə k j u t ɪ d
executed	ɛ ɡ s ə k j u t ɪ d
executes	ɛ k z ə k j u t s
executioner	ɛ ɡ z ə k j u ʃ ə n ɝ
executive	ɪ k z ɛ k j ə t ɪ v
executive	ɪ ɡ z ɛ ɡ j ə t ɪ v
executive	ɪ ɡ z ɛ k j u t ɪ v
executives	ɪ k z ɛ k j ə t ɪ v z
exegetical	ɛ ɡ s ə dʒ ɛ t ɪ k ə l
exemplar	ɪ ɡ z ɛ m p l ɝ
exemplar	ɪ ɡ z æ m p l ɝ
exemption	ɪ k s ɛ m p ʃ ə n
exhibit	ɪ k s ɪ b ɪ t
exhibitors	ɪ k s ɪ b ə t ɝ z
exile	ɛ k z aɪ l
exile	ɛ k s aɪ l
existed	ɪ ɡ s ɪ s t ɪ d
existential	ɛ k s ɪ s t ɛ n tʃ ə l
existing	ɪ ɡ s ɪ s t ɪ ŋ
exists	ɪ k s ɪ s t s
exit	ɛ k z ɪ t
exits	ɛ k s ɪ t s
exodus	ɛ k s ə t ə s
exodus	ɛ k s ə t ə z
exogamous	ɪ k s ɑ ɡ ə m ə s
exogamy	ɪ k s ɑ ɡ ə m i
exotic	ɪ k s ɑ t ɪ k
expanded	ɪ k s p ɛ n d ɪ d
expansions	ɪ k s p æ n ʃ ə n s
expended	ɪ k s p æ n d ɪ d
expenditures	ɪ k s p ɛ n d ɪ tʃ ɝ z
expensive	ɪ k s p æ n s ɪ v
expertise	ɛ k s p ɝ t i s
expire	ɪ k s p aɪ ɝ
expiring	ɪ k s p aɪ ɝ ɪ ŋ
exports	ɛ k s p ɔ ɹ t s
exposed	ɪ k s p oʊ ʒ d
exposing	ɪ k s p oʊ ʒ ɪ ŋ
expressionism	ɪ k s p ɹ ɛ ʃ ə n ɪ z ə m
expressionistic	ɪ k s p ɹ ɛ ʃ ə n ɪ s t ɪ k
expulsion	ɪ k s p ʌ l ʒ ə n
expulsions	ɪ k s p ʌ l ʒ ə n z
extends	ɪ k s t æ n d z
extension	ɪ k s t æ n ʃ ə n
extensions	ɪ k s t æ n ʃ ə n z
exterior	ɛ k s t ɪ ɹ i ɝ
exterior	ɪ k s t ɪ ɝ i ɝ
extract	ɪ k s t ɹ æ k t
extracurricular	ɛ k s t ɹ ə k ɝ ɪ k j ə l ɝ
extras	ɛ k s t ɹ ə s
extravasation	ɛ k s t ɹ æ v ə z eɪ ʃ ə n
extrude	ɪ k s t ɹ u d
extrusion	ɪ k s t ɹ u ʒ ə n
exuberant	ɪ k z u b ɝ ə n t
exuding	ɪ ɡ s u d ɪ ŋ
eyes	aɪ s
ezra	ɛ s ɹ ə
f	v
face	f eɪ z
faced	f eɪ z t
faced	f eɪ z d
faces	f eɪ z ɪ z
facie	f eɪ ʃ i
facilities	f ə s ɪ l ə t i s
fact	f ɛ k t
factor	f ɛ k t ɝ
factors	f ɛ k t ɝ z
factors	f ɛ k t ə z
factory	f æ k t ɚ i
facts	f ɛ k t s
fad	f æ t
fader	f eɪ t ɝ
fades	f eɪ t s
failed	v eɪ l d
failure	f eɪ l j ɚ
fair	f æ
fake	f eɪ ɡ
fallon	v æ l ə n
falls	f ɔ l s
fame	f eɪ n
fan	f æ m
fanaticism	f ə n ɛ t ɪ s ɪ z ə m
fanciful	f æ n s i f ə l
fang	f æ n
fans	f æ n s
fans	v æ n z
fans	f ɛ n s
fantasy	f æ n t ə z i
faraday	f ɛ ɹ ə d eɪ
faraday's	f ɛ ɹ ə d eɪ z
farb	f ɑ ɹ b
faries	f ɛ ɹ i z
farina's	v ɝ i n ə z
faringdon	f ɛ ɹ ɪ ŋ d ə n
farkas	f ɑ ɹ k ə s
farm	f ʌ m
farming	f ɑ ɹ m i n
farming	f ɑ ɹ m ɪ n
farnborough	f ɑ ɹ m b ɝ oʊ
farner	f ɑ ɹ n ɝ
farnese	f ɑ ɹ n i s
farnsworth	f ɑ ɹ n z w ɝ θ
faroe	f ɛ ɹ oʊ
farrens	f ɛ ɹ ə n z
farris	f ɛ ɹ i z
fars	f ɑ ɹ s
farthings	f ɑ ɹ θ ɪ ŋ z
farwest	f ɑ ɹ w ɛ s t
fascicles	f æ s ɪ k ə l z
fascism	f æ s ɪ z ə m
fascism	f æ ʃ ɪ z ə n
fashion	f ɛ ʃ ə n
fat	f ɛ t
fat	f æ d
fatigue	f ə t i k
fatty	f æ d i
fault	v ɔ l t
faulting	v ɔ l t ɪ ŋ
faults	v ɔ l t s
faun	f ɔ m
faversham	f æ v ɝ ʃ ə m
favored	f eɪ v ɝ t
favorite	f eɪ v ɝ ə t
favourably	f eɪ v ɹ ə b l i
fe	v
features	f i tʃ ɝ s
fecal	f i ɡ ə l
fed	f ɛ t
fed	f æ t
federalists	f ɛ d ɹ ə l ɪ s
federally	f ɛ d ɹ ə l i
federation	f ɛ d ɹ eɪ ʃ ə n
federico	f ɛ t ɝ i k oʊ
fedex	f ɛ t ɛ k s
feed	f i t
feeder	f i t ɝ
feeder's	f i t ɝ z
feeding	f ɪ t ɪ ŋ
feeds	f i d s
fehring	f ɛ ɹ ɪ ŋ
feigned	f eɪ m d
felipe	f ə l i b
felled	f ɛ l t
fells	f ɛ l s
felt	f ɛ l d
femmes	f æ n z
fence	f ɛ n z
feng	f æ ŋ
fens	f ɛ n s
fens	f æ n z
fern	f ɝ m
ferraris	f ɝ ɑ ɹ i z
ferrick	f ɛ ɹ ɪ k
ferry	v ɛ ɹ i
fertile	v ɝ t ə l
fescue	f ɛ z k j u
fessenden	f ɛ z ə n t ə n
fest	f æ s t
festival	f ɛ s t ɪ f ə l
festive	f æ s t ɪ v
fetal	f i d ə l
fetch	f æ tʃ
fete	f æ t
fetish	f æ t ɪ ʃ
fett	f æ t
fetty	f ɛ d i
fetus	f i d ə s
fetuses	f i d ə s ɪ z
feuded	f j u t ɪ d
feuding	f j u t ɪ ŋ
feverishly	f i v ɝ ɪ ʃ l i
fewer	f j u ɹ
fiat	f i ɛ t
fibre	f aɪ b ɹ
fibrous	f aɪ b ɝ ə s
ficino	f ɪ tʃ i n oʊ
fidalgo	f ɪ d ɑ l ɡ oʊ
fiefdom	f i f t ə m
field	f ɪ l d
fielded	f i l d ɪ t
fielder	f ɪ l d ɝ
fields	f ɪ l d z
fife	f aɪ v
figaro	v ɪ ɡ ɝ oʊ
fight	f aɪ d
fighter	f aɪ d ɝ
fighters	f aɪ t ɝ s
fights	f aɪ d z
figs	f ɪ ɡ s
figurines	f ɪ ɡ j ɝ ɪ n z
fiji	f ɪ dʒ i
filibustering	f ɪ l ə b ʌ s t ɹ ɪ ŋ
fill	f i l
fillings	f i l ɪ ŋ z
fina	f ɪ n ə
final	f aɪ m ə l
finale	f ə n ɛ l i
finals	f aɪ n ə l s
finances	f ɪ n æ n s ɪ s
financial	f ɪ n æ n s ə l
fingal	f ɪ n ɡ ə l
finished	f ɪ n ɪ s t
finlayson	f ɪ n l ɪ s ə n
finns	f ɪ n s
finsbury	f ɪ n z b ɛ ɹ i
fire	f aɪ ɹ
fireball	f aɪ ɝ b ɔ l
firebox	f aɪ ɝ b ɑ k s
fireman	f aɪ ɝ m ə n
fireman's	f aɪ ɝ m ə n z
firemen	f aɪ ɝ m ə n
firestone	f aɪ ɝ s t oʊ n
firewood	f aɪ ɝ w ʊ d
firework	f aɪ ɝ w ɝ k
fireworks	f aɪ ɝ w ɝ k s
firing	f aɪ ɝ ɪ ŋ
firings	f aɪ ɝ ɪ ŋ z
fishes	f ɪ ʃ ɪ s
fission	v ɪ ʒ ə n
fissured	f ɪ ʒ ɝ d
fitted	f i t ɪ d
five	f aɪ f
fixing	f ɪ k s ɪ n
flag	f l æ k
flagg	f l æ k
flagged	f l æ k t
flags	f l æ k s
flagship	f l æ k ʃ ɪ p
flakes	f l eɪ ɡ z
flamenco	f l ə m ɛ n k oʊ
flanders	f l æ n d ɝ s
flanged	f l æ ŋ dʒ t
flanged	f l æ n dʒ t
flash	f l ɛ ʃ
flawed	f l ɔ t
fled	f l ɛ t
fleeing	f l ɪ ɪ ŋ
flesh	f l æ ʃ
fleshes	f l æ ʃ ɪ z
fletcher	f l æ tʃ ɝ
flights	f l aɪ d z
floater	f l oʊ d ɝ
flock	f l ʌ k
flocks	f l ʌ k s
flooded	f l ʌ t ɪ d
flooding	f l ʌ d ɪ n
flook	f l u k
flores	f l ɔ ɹ ɛ z
florida	f l ɔ ɹ d ə
florida	f l ɔ ɹ i d ə
florida's	f l ɔ ɹ ɪ d ə z
flotilla	f l oʊ t i l ə
floyd	f l ɔɪ t
fluoresce	f l ɔ ɹ ɛ s
fluorescent	f l ɔ ɹ ɛ s ə n t
fluxes	f l ʌ k s ə s
flyin	f l aɪ ɪ ŋ
flying	f l aɪ ɪ n
flyting	f l aɪ d ɪ ŋ
fodder	f ɑ t ɝ
foetal	f i d ə l
foetus	f i d ə s
folded	f oʊ l d ə t
following	f ɑ l oʊ ɪ n
follows	f ɑ l oʊ s
food	f u t
food	f ʊ t
fool	f ʊ l
fools	f ʊ l z
foot	f u t
footage	f ʊ d ɪ dʒ
football	f ʊ t p ɔ l
football	f ʊ d b ɔ l
for	f ɹ
for	f ɚ ɹ
for	v ɝ
for	v ə
forage	f ɔ ɹ ɪ dʒ
forbear	f ɔ ɹ b ɛ ɹ
forbes	f ɔ ɹ b s
forbidden	f ɝ ɹ b ɪ d ə n
force	f ɔ ʃ
forces	f ɔ s ɪ s
forces	f ɔ ɹ s ɪ s
ford	f ɔ ɹ t
fordable	f ɔ ɹ t ə b ə l
fordham	f ɔ ɹ t h ə m
forecasts	f ɔ ɹ k æ s
foreign	f ɔ ɹ ə ŋ
foreign	f ɔ ɹ ə m
foreigner	f ɔ ɹ ə n ɝ
foreigners	f ɔ ɹ ə n ɝ z
forensic	f ɝ ɛ n z ɪ k
forensic	f ɹ ɛ n z ɪ k
forensics	f ɝ ɛ n z ɪ k s
forestier	f ɔ ɹ ə s t ɪ ɹ
forfeited	f ɔ ɹ f ɪ t ɪ t
forfeiture	f ɔ ɹ f ɪ tʃ ɝ
forgot	f ɝ ɡ ɑ t
forks	f ɔ ɹ ɡ s
formaldehyde	f ɔ ɹ m ɛ l d ə h aɪ d
formality	f ɔ ɹ m æ l ə d i
formatted	f ɔ ɹ m æ d ɪ d
formed	f ɔ ɹ n d
forrest	f ɔ ɹ ə s t
fort	f ɔ ɹ d
fortas	f ɔ ɹ t ə z
forte	f ɔ ɹ t
fortenberry	f ɔ ɹ t ə n b ɛ ɹ i
fortier	f ɔ ɹ d i ɝ
fortman	f ɔ ɹ t m ə n
fortnum	f ɔ ɹ d n ə m
forum	f ɔ ɹ ə n
forward	f ɔ ɹ ɝ d
forward	f ɔ d
forward	f ɔ ɹ w ɝ t
foster	f ɔ s t ɝ
fothergill	f ɑ ð ɝ ɡ ɪ l
foundry	f aʊ n d ɝ i
fountain	f aʊ n d ə n
four's	f ɔ ɹ s
fourman	f ɔ ɹ m ə n
fourteen	f ɔ ɹ t i m
fracking	f ɹ æ k ɪ n
fracture	f ɹ æ k s ɝ
frady	f ɹ eɪ t i
fragging	f ɹ æ ɡ ɪ n
frame	f ɹ eɪ n
france	f ɹ æ n z
france	f ɹ ɛ n z
france	f ɹ ɛ n s
frances	f ɹ æ n s ɪ s
francis	f ɹ æ n s ɪ z
francisville	f ɹ æ n s ɪ z v ɪ l
frankel	f ɹ æ ŋ k ə l
frankenstein's	f ɹ æ ŋ k ə n ʃ t aɪ n z
frankford	f ɹ æ ŋ k f ɝ t
frankfurt's	f ɹ æ ŋ k f ɝ d z
frankie	f ɹ ɛ n k i
franklin	f ɹ æ n k l ɪ n
franklinville	f ɹ æ ŋ k l ɪ n v ɪ l
frankton	f ɹ æ ŋ k d ə n
frannie	f ɹ æ n i
franny	f ɹ ɛ n i
franson	f ɹ æ n s ə n
franz	f ɹ æ n s
franzen	f ɹ æ n z ə n
fraser	f ɹ eɪ ʒ ɝ
fraser	f ɹ eɪ ʃ ɝ
frazer	f ɹ eɪ ʒ ɝ
fred	f ɹ æ d
fred	f ɹ æ t
fred	f ɹ ɛ t
frederic	f ɹ ɛ d ɝ ɪ k
frederica	f ɹ ɛ d ɹ i k ə
frederickson	f ɹ ɛ d ɹ ɪ k s ə n
frederik	f ɹ ɛ d ɹ ɪ k
fredrickson	f ɹ ɛ d ɹ ɪ k s ə n
freed's	f ɹ i d z
freefall	f ɹ i f ɔ l
freestanding	f ɹ i s t æ n d ɪ ŋ
freeware	f ɹ i w ɛ ɹ
fremantle	f ɹ i m æ n t ə l
fremont	f ɹ i m ɑ n t
french	f ɹ æ ŋ tʃ
french	f ɹ ɛ n z
frenkel	f ɹ æ ŋ k ə l
frenzel	f ɹ ɛ n z ə l
freon	f ɹ i ɑ n
frequenting	f ɹ i k w ə n t ɪ ŋ
frescoes	f ɹ ɛ s k oʊ s
frese	f ɹ ɪ s
fresh	f ɹ ɛ s
fresnel	f ɹ ɛ s n ə l
fresno	f ɹ ɛ s n oʊ
freston	f ɹ ɛ s t ə n
freund	f ɹ ʊ n d
friant	f ɹ i ə n t
fricke	f ɹ ɪ k
friday's	f ɹ aɪ d ɪ z
fridley	f ɹ ɪ d l i
fridman	f ɹ ɪ d m ə n
fried	f ɹ aɪ t
friedan	f ɹ i d ə n
friedman's	f ɹ i d m ə n z
friend's	f ɹ ɛ n d z
friendlier	f ɹ ɛ n d l i ɝ
friendliest	f ɹ ɛ n d l i ə s t
friendly	f ɹ ɛ m l i
friesen	f ɹ i z ə n
friesland	f ɹ ɪ z l ə n d
friesland	f ɹ i s l ə n d
frigid	f ɹ ɪ dʒ ɪ t
friis	f ɹ ɪ s
frisa	f ɹ i s ə
frisbee	f ɹ ɪ s p i
frisby	f ɹ ɪ z b i
frisco	f ɹ ɪ s k oʊ
frisia	f ɹ ɪ s i ə
frisia	f ɹ i z i ə
frisian	f ɹ ɪ ʃ ə n
frits	f ɹ ɪ t s
frittata	f ɹ ɪ t ɑ t ə
frizell	f ɹ ɪ z ə l
from	f ɹ ʌ n
from	f ɹ ɑ m
frome	f ɹ u m
fromm	f ɹ ʌ m
frond	f ɹ ʌ n t
front	f ɹ ɑ n t
frontage	f ɹ ɑ n t ɪ dʒ
fronted	f ɹ ʌ n t ɪ t
frontiersman	f ɹ ə n t ɪ ɹ z m ə n
frontino	f ɹ ɑ n t i n oʊ
fronto	f ɹ ɑ n t oʊ
fruit	f ɹ u d
fruity	f ɹ u d i
frutti	f ɹ u d i
fulda	f u l d ə
fulham	f ʊ l ə n
fuller	f u l ɝ
fully	f u l i
fund	f ʌ n t
fund	f ɑ n d
fundamental	f ʌ n t ə m ɛ n ə l
fungal	f ɑ ŋ ɡ ə l
fungus	f ʌ ŋ ɡ ə z
funky	f ɑ ŋ k i
funnels	f ɑ n ə l z
furey	f j ʊ ɹ i
furfur	f ɝ f ɝ
furini	f u ɹ i n i
furse	f ɝ z
furthest	f ɝ ð ə s t
fuselage	f j u s ə l ɑ ʒ
fusiform	f j u s ə f ɔ ɹ m
fussell	f ɑ s ə l
futile	f j u d ə l
futtock	f ʌ d ə k
fuzz	f ɑ s
gaddafi	k ə d ɑ f i
gadsden	ɡ æ d s t ə n
gain	ɡ eɪ m
gain	k eɪ n
gain	ɡ eɪ ŋ
gaines	ɡ eɪ m z
galactic	k ə l æ k t ɪ k
galactic	k ə l ɛ k t ɪ k
galapagos	k ə l ɑ p ə ɡ oʊ s
galicia	ɡ ə l i ʃ ə
galician	ɡ ə l i ʃ ə n
galician	k ə l i ʃ ə n
galleons	ɡ æ l i ə n s
gallery	ɡ æ l ɚ i
game	ɡ eɪ n
game	k eɪ m
game	k eɪ n
game's	ɡ eɪ n z
games	ɡ eɪ n z
games	k eɪ m z
ganapati	ɡ æ n ə p ɑ d i
gandhi	ɡ ɑ n t i
gangs	ɡ æ ŋ s
gannon	k æ n ə n
gar	k ɑ ɹ
gar	k ɑ
garage	k ɝ ɑ ʒ
garcia	k ɑ ɹ s i ə
gardens	k ɑ ɹ d ə n z
gardner	ɡ ɑ ɹ t n ɝ
garibaldi	ɡ ɛ ɹ ə b ɔ l d i
garrett's	ɡ ɛ ɹ ɪ t s
garrick	ɡ ɛ ɹ ɪ k
garrison	ɡ ɛ ɹ ɪ s ə n
garrisons	ɡ ɛ ɹ ɪ s ə n z
garten	ɡ ɑ ɹ d ə n
gartner	ɡ ɑ ɹ d n ɝ
gary	ɡ æ ɹ i
gary's	ɡ ɛ ɹ i z
garza	ɡ ɑ ɹ s ə
garza	k ɑ ɹ z ə
gas	ɡ ɛ s
gases	k æ s ɪ z
gasoline	ɡ æ z ə l i n
gatehouse	ɡ eɪ t h aʊ z
gateshead	ɡ eɪ t s h ɛ d
gathering	ɡ æ ð ɝ ɪ n
gatty	ɡ æ d i
gaule	k ɔ l
gautama	k oʊ t ɑ m ə
gay	k eɪ
gaya	k aɪ ə
gearing	k ɪ ɹ ɪ n
gecko	k ɛ k oʊ
geese	ɡ i z
geezer	ɡ i z ɝ
geis	ɡ aɪ s
geller	ɡ ɛ l ɝ
gems	dʒ ɛ n z
gemsbok	ɡ æ m z b ɑ k
gender	dʒ æ n d ɝ
gendered	dʒ æ n d ɝ d
gene	dʒ ɪ n
genera	dʒ ɛ n ɹ ə
general's	dʒ ɛ n ɝ ə l z
generalization	dʒ ɛ n ɝ ə l ɪ z eɪ ʃ ə n
generalizations	dʒ ɛ n ɝ ə l ɪ z eɪ ʃ ə n z
generally	dʒ ɛ n ɝ l i
generals	dʒ ɛ n ɹ ə l z
genetic	dʒ ə n æ t ɪ k
genie	dʒ i m i
genocide	dʒ ɛ n ə s aɪ t
genre	ʃ ɑ n ɹ ə
genres	z ɑ n ɹ ə z
geoff	dʒ æ f
georgian	dʒ ɔ dʒ ə n
gerber	ɡ ɝ p ɝ
get	k ɪ t
get	ɡ æ t
getting	ɡ ɛ d ɪ ŋ
getty	ɡ ɛ d i
getty's	ɡ ɛ d i z
geyser	k i z ə
ghost	k oʊ s t
gibson	ɡ ɪ b z ə n
gigas	ɡ i ɡ ə s
gigs	k ɪ ɡ z
gil	ɡ i l
gillard	k ɪ l ɝ d
gillingham	k ɪ l ɪ ŋ h æ m
gimmick	k ɪ m ɪ k
gina	dʒ ɪ n ə
ginsberg	ɡ ɪ n z b ɝ ɡ
giovanni	dʒ i ə f ɑ n i
girders	ɡ ɝ t ɝ z
girls	ɡ ɝ l s
girton	ɡ ɝ d ə n
girtys	ɡ ɝ d i z
given	ɡ ɪ v ə ŋ
giving	ɡ ɪ v ɪ n
giving	ɡ ɪ f ɪ ŋ
giza	k i z ə
glabrous	ɡ l æ b ɝ ə s
glaciation	ɡ l eɪ s i eɪ ʃ ə n
glaciation	k l eɪ ʃ i eɪ ʃ ə n
glacier	ɡ l eɪ s ɝ
glamis	ɡ l æ m i s
glands	k l æ n d z
glaser	ɡ l eɪ s ɝ
glasgow	ɡ l æ s ɡ oʊ
glasgow	ɡ l æ z ɡ oʊ
glasgow	ɡ l æ z k oʊ
glass	k l æ s
gleason	k l i s ə n
gleason	ɡ l i z ə n
glee	k l i
gleeson	ɡ l i s ə n
gleeson	k l i s ə n
glen	k l ɛ n
glendon	ɡ l æ n d ə n
global	k l oʊ b ə l
glossy	k l ɔ s i
glossy	ɡ l ɔ s ɪ
gloucester	ɡ l ʌ s t ɝ
gluck	k l ʌ k
glucose	ɡ l u k oʊ z
glue	k l u
goals	k oʊ l z
goat	ɡ oʊ d
god	ɡ ɑ t
god's	ɡ ɑ d s
godzilla	ɡ ɑ d s ɪ l ə
godzilla	ɡ ɑ d s i l ə
goes	ɡ oʊ s
goiter	ɡ ɔɪ d ɝ
gold	k oʊ l d
golf	ɡ ʌ l f
goliad	ɡ oʊ l i ə t
gone	ɡ ɔ ŋ
gonzales	ɡ ʌ n z ɑ l ə s
gonzales	ɡ ɑ n s ɑ l ə z
gonzales	k ɑ n z ɑ l ə z
gonzalez	ɡ ʌ n z ɑ l ə s
good	ɡ u d
goodies	ɡ u d i z
goods	ɡ ʊ d s
google	ɡ u k ə l
gooseneck	ɡ u s n æ k
gopi	ɡ oʊ b i
gordita	ɡ ɔ ɹ d i d ə
gore	k ɔ
gore	k ɔ ɹ
gorgeous	ɡ ɔ ɹ dʒ ə z
gorilla	ɡ ɹ ɪ l ə
gorse	ɡ ɔ ɹ z
gorse	k ɔ ɹ s
gorst	k ɔ ɹ s t
gorton	ɡ ɔ ɹ d ə n
gosford	k ɑ s f ɝ t
goswami	ɡ ɑ z w ɑ m i
goswell	k ɑ z w ɛ l
got	k ʌ t
got	ɡ ɑ d
got	k ɑ t
gotham	ɡ ɑ θ ə n
gottlieb	ɡ ɑ d l i b
gout	k aʊ t
government	ɡ ʌ v ɝ n m ə n t
governments	ɡ ʌ v ɝ n m ə n t s
governor	ɡ ʌ v ɚ n ɝ
gowanus	ɡ ə w ɑ n ə z
grace's	k ɹ eɪ s ɪ z
grade	ɡ ɹ eɪ t
grade	k ɹ eɪ d
graded	ɡ ɹ eɪ t ɪ d
graders	k ɹ eɪ t ɝ z
grades	ɡ ɹ eɪ d s
grades	k ɹ eɪ t s
grado	ɡ ɹ ɑ t oʊ
graffiti	ɡ ɹ ə f i d i
graffiti	k ɹ ə f i t i
grafted	k ɹ æ f t ɪ d
graham	ɡ ɹ æ ə m
grainger	ɡ ɹ eɪ n dʒ ɝ
gran	ɡ ɹ ɛ n
granada	ɡ ɹ ə n ɑ t ə
grandville	ɡ ɹ æ n t v ɪ l
granger	k ɹ eɪ n dʒ ɝ
granny	ɡ ɹ æ n ɪ
grant	ɡ ɹ æ n d
grant	k ɹ æ n t
granville	ɡ ɹ ɛ n v i l
graph	k ɹ æ f
graphic	k ɹ æ f ɪ k
grassley	k ɹ æ s l i
grated	ɡ ɹ eɪ d ɪ d
graters	ɡ ɹ eɪ d ɝ z
grates	ɡ ɹ eɪ d z
grating	ɡ ɹ eɪ d ɪ ŋ
gravelly	ɡ ɹ ɛ v ə l i
gravesend	ɡ ɹ eɪ v s æ n d
gravesend	ɡ ɹ eɪ v z ɛ n d
graveyard	ɡ ɹ eɪ f j ɑ ɹ d
gravid	ɡ ɹ æ v ɪ t
graving	k ɹ eɪ v ɪ ŋ
gray	k ɹ eɪ
graziers	ɡ ɹ eɪ z ɪ ɹ z
grazing	k ɹ eɪ z ɪ ŋ
great	ɡ ɹ eɪ d
great	k ɹ eɪ t
greatly	ɡ ɹ eɪ d l i
greaves	k ɹ i v z
grebes	k ɹ i b z
greed	ɡ ɹ i t
greek	k ɹ i k
greeks	ɡ ɹ ɪ ɡ z
greeks	k ɹ i k s
green	ɡ ɹ ɪ n
green	ɡ ɹ i m
green	k ɹ i n
green's	ɡ ɹ ɪ n z
greene	k ɹ i n
greenfield	ɡ ɹ i n f ɪ l d
greensborough	ɡ ɹ i n s b ɝ oʊ
greenville	k ɹ i n v ɪ l
greenwich	k ɹ ɪ m w ɪ tʃ
greenwood	ɡ ɹ ɪ n w ʊ d
greeting	ɡ ɹ i d ɪ ŋ
greeting	k ɹ i d ɪ ŋ
greg	ɡ ɹ æ ɡ
greg	k ɹ ɛ ɡ
gregg	k ɹ ɛ ɡ
gregory	ɡ ɹ ɛ ɡ ɹ i
grenier	ɡ ɹ ɪ n ɪ ɹ
gress	ɡ ɹ æ s
grew	k ɹ u
grid	ɡ ɹ ɪ t
grieg's	k ɹ i ɡ z
gries	ɡ ɹ aɪ s
grimaldi	ɡ ɹ ɪ m ɑ l d i
grimsby	ɡ ɹ ɪ m s b i
grip	ɡ ɹ i p
grips	ɡ ɹ ɪ b s
grips	ɡ ɹ i p s
griqua	ɡ ɹ i k w ə
gris	ɡ ɹ i z
griswold	ɡ ɹ ɪ z w ɔ l d
gritty	ɡ ɹ ɪ d i
gritty	ɡ ɹ i d i
gritz	ɡ ɹ ɪ d s
grizzlies	ɡ ɹ i z l i z
grocer	ɡ ɹ oʊ ʃ ɝ
groceries	ɡ ɹ oʊ s ɝ i z
groceries	ɡ ɹ oʊ ʃ ɝ i z
grocery	ɡ ɹ oʊ ʃ ɝ i
grocery	ɡ ɹ oʊ s ɹ i
grooming	ɡ ɹ u m i n
grooming	k ɹ u m ɪ ŋ
grose	ɡ ɹ oʊ s
grotius	ɡ ɹ oʊ d i ə s
grounds	ɡ ɹ aʊ n d s
grounds	k ɹ aʊ n d z
group	k ɹ u p
group	ɡ ɹ u b
group's	ɡ ɹ u p z
groupings	ɡ ɹ u p ɪ n z
grouting	ɡ ɹ aʊ d ɪ ŋ
grove	ɡ ɹ oʊ f
growers	ɡ ɹ oʊ ɝ s
growing	ɡ ɹ oʊ ɪ n
grows	ɡ ɹ oʊ s
gruber	ɡ ɹ u p ɝ
gruenwald	ɡ ɹ u n w ɔ l d
gryce's	k ɹ aɪ s ɪ z
guadalupe	ɡ w ɑ d ə l u b
guam	k w ɑ m
guantanamo	k w ɑ n t ɑ n ə m oʊ
guard	k ɑ ɹ d
guatemala	ɡ w ɑ d ə m ɑ l ə
guenon	k w ɛ n ə n
guerrilla	ɡ ɹ ɪ l ə
guess	ɡ æ s
guest	ɡ æ s t
guiana	k i ɑ n ə
guides	ɡ aɪ t s
guild	k ɪ l d
guinea	ɡ i n i
guinea	k ɪ n i
guinness	k ɪ n ɪ s
guitar	k ə t ɑ ɹ
guitar	k ɪ t ɑ ɹ
guitar	ɡ ə d ɑ ɹ
guitar	ɡ ɪ d ɑ ɹ
guitars	k ɪ t ɑ ɹ z
guitars	k i t ɑ ɹ z
gules	k u l z
gulf	ɡ ɑ l f
gulliver	ɡ ɑ l ɪ v ɝ
gulliver's	ɡ ɑ l ɪ v ɝ z
gumming	k ʌ m ɪ ŋ
gun	ɡ ɑ n
gunboats	k ʌ n b oʊ t s
gunboats	ɡ ʌ m b oʊ d z
gundry	ɡ ʌ n d ɹ i
gunfire	ɡ ʌ n f aɪ ɝ
gunn	ɡ ɑ n
gunnison	k ʌ n ɪ s ə n
guns	ɡ ɑ n z
gunther	ɡ ʌ m θ ɝ
gushing	ɡ ʌ ʃ ɪ n
gustaf	ɡ u s t ɑ v
gustav	ɡ u s t ɑ v
gustav	ɡ u s t ɑ f
gustavo	k u s t ɑ v oʊ
gut	k ʌ t
guthrie	ɡ ʌ θ ɝ i
gutman	ɡ ɑ d m ə n
gutted	ɡ ʌ d ɪ d
guys	ɡ aɪ s
gym	dʒ ɪ n
gymnasium	dʒ ɪ m n eɪ z i ə n
habitat	h æ p ə t æ t
habitats	h æ p ə t æ t s
habsburg	h æ b s b ɝ ɡ
habsburgs	h æ b s b ɝ ɡ z
hacking	h æ k i n
had	h æ t
had	h ɛ t
had	h ɛ d
hadad	h ɛ d ə d
hades	h eɪ t s
hadow	h æ t oʊ
hahn	h ɑ m
hails	h eɪ l s
hair	h æ
hair	h æ ɹ
haiti	h eɪ d i
hake	h eɪ ɡ
halberd	h æ l b ɝ t
halcyon	h ɛ l s i ə m
hallo	h ɛ l oʊ
hallstrom	h æ l s t ɹ ə m
hallucinogenic	h ə l u s ə n ə dʒ ɛ n ɪ k
halprin	h æ l p ɹ ɪ n
halt	h ʌ l t
halt	h ɔ l d
halved	h æ f t
ham	h ɛ m
ham	h æ n
hamden	h æ m t ə n
hamersley	h æ m ɝ z l i
hamish	h ɛ m ɪ ʃ
hammersley	h æ m ɝ z l i
hammock	h ɛ m ə k
hampden	h æ m p t ə n
hampshire	h ɛ m p ʃ ɝ
hampster	h æ m p s t ɝ
hamster	h ɛ m s t ɝ
han	h æ ŋ
hancock	h æ ŋ k ɑ k
hand	h æ n t
handcrafted	h æ n d k ɹ æ f t ɪ d
handicapped	h æ n d ɪ k æ p t
handkerchief	h æ ŋ k ɝ tʃ i f
handkerchief	h æ n k ɝ tʃ ɪ f
handling	h æ n d l ɪ n
handmade	h ɛ n m eɪ d
hands	h æ m z
hands	h æ n s
hankins	h æ n k ɪ n z
hannay	h ɛ n eɪ
hannelore	h æ n ə l ɔ ɹ
hannibal	h æ n i b ə l
hansberry	h æ n z b ɛ ɹ i
hansel	h æ m s ə l
hansen	h æ m s ə n
hanson's	h æ n s ə m z
happy	h ɛ b i
haran	h ɛ ɹ ə n
harbor	h ɑ ɹ p ɝ
harbour	h ɑ ɹ p ɝ
hard	h ɑ t
hard	h ɑ ɹ t
hardball	h ɑ ɹ d b ɔ l
hardcore	h ɑ ɹ t k ɔ ɹ
hardener	h ɑ ɹ d ə n ɝ
hardening	h ɑ ɹ d ə n ɪ ŋ
hardin	h ɑ ɹ d i n
hardy	h ɑ ɹ t i
hardys	h ɑ ɹ t i z
harem	h ɛ ɹ ə n
haren	h ɛ ɹ ə n
harlem	h ɑ ɹ l ə n
harleysville	h ɑ ɹ l i z v ɪ l
harmonium	h ɑ ɹ m oʊ n i ə n
harmony	h ɑ ɹ m ə m i
harpel	h ɑ ɹ p ɛ l
harper	h ɑ ɹ b ɝ
harpsichord	h ɑ ɹ b s ə k ɔ ɹ d
harrah	h ɛ ɹ ə
harrah's	h ɛ ɹ ə z
harran	h ɛ ɹ ə n
harrell	h æ ɹ ə l
harrell	h ɛ ɹ ə l
harrigan's	h ɛ ɹ ɪ ɡ ə n z
harringay	h ɛ ɹ i n eɪ
harris	h ɛ ɹ ɪ ʃ
harrisburg	h æ ɹ ɪ s b ɝ ɡ
harrold	h ɛ ɹ ə l d
harrow	h ɛ ɹ oʊ
harrowing	h ɛ ɹ oʊ ɪ ŋ
harry's	h ɛ ɹ i z
harshman	h ɑ ɹ ʃ m ə n
harter	h ɑ ɹ d ɝ
hartford	h ɑ ɹ t f ɝ t
hartigan	h ɑ ɹ d ɪ ɡ ə n
hartnell	h ɑ ɹ t m ə l
hartsfield	h ɑ ɹ t s f i l d
hartvig	h ɑ ɹ d f ɪ ɡ
hartwig	h ɑ ɹ t w ɪ ɡ
harty	h ɑ ɹ d i
harum	h æ ɹ ə m
harvard	h ɑ ɹ v ɝ t
harvest	h ɑ ɹ f ə s t
harvested	h ɑ ɹ v ə s t ɪ d
has	h æ s
has	h ɛ z
hasler	h æ z l ɝ
hasta	h ɑ s t ə
haswell	h æ z w ɛ l
hat	h æ d
hatchery	h æ tʃ ɹ i
hatfield	h æ t f ɪ l t
hats	h ɛ d z
hattery	h æ t ɹ i
hattie	h æ d i
haug	h ɔ k
haunted	h ʌ n t ɪ d
hauser	h aʊ z ɝ
have	h ɛ v
havens	h eɪ v ə n s
haverty	h æ v ɝ d i
hawker	h ɑ k ɝ
hawking	h ɔ k ɪ n
hawley	h ɔ l ɪ
hazael	h ɛ z eɪ l
hazard	h æ s ɝ t
he	ɪ
he	h ɪ
he's	h ɪ z
he's	h ɪ s
head	h æ d
head	h æ t
head	h ɛ t
headdress	h ɛ d ɹ ɛ s
header	h ɛ t ɝ
header	h æ t ɝ
headers	h ɛ t ɝ z
heading	h ɛ d ɪ n
heading	h ɛ t ɪ ŋ
headley	h æ d l i
headquartered	h ɛ d k w ɔ ɹ t ɝ d
headquarters	h ɛ d k w ɔ ɹ t ɝ s
headrick	h ɛ d ɹ ɪ k
heads	h æ d z
heads	h æ t z
heads	h ɛ d s
heads	h ɛ t s
headset	h æ d s ɛ t
healthcare	h ɛ l θ k ɛ ɹ
hear	h ɪ ɹ
heard	h ɝ t
hearing	h i ɹ ɪ n
hearings	h ɪ ɹ ɪ ŋ z
hearsay	h ɪ ɹ s eɪ
heart	h ɑ ɹ d
hearties	h ɑ ɹ d i z
heartland	h ɑ ɹ t l æ n d
hearty	h ɑ ɹ d i
heat	h ɪ t
heating	h ɪ t ɪ ŋ
heats	h ɪ d z
heavier	h ɛ f i ɝ
heavily	h ɛ f ə l i
heaviness	h ɛ v i n ə s
heavy	h ɛ f i
heavy	h æ v i
hebe	h ɪ p i
hebe	h ɪ p
hebrides	h ɛ p ɹ ə d i z
hecate	h æ k eɪ t
heckling	h æ k l ɪ ŋ
hectare	h ɛ k t ɛ
hedgerows	h ɛ dʒ ɹ oʊ z
hedges	h æ dʒ ɪ z
hedi	h ɛ t i
hedonism	h ɛ t ə n ɪ z ə m
hedvig	h ɛ d v ɪ k
hedwig	h ɛ d w ɪ k
heeded	h i t ɪ d
heel	h ɪ l
heels	h ɪ l z
heenan	h i m ə n
heeney	h i m i
hefner	h æ f n ɝ
heggie	h æ ɡ i
heights	h aɪ d z
held	h ɛ l t
helen	h ɛ l ə m
helena	h ɛ l i n ə
helens	h ɛ l ə n s
helfer	h æ l f ɝ
hell	h æ l
hellfire	h ɛ l f aɪ ɝ
hello	h æ l oʊ
hellstrom	h ɛ l s t ɹ ə m
help	h æ l p
helping	h ɛ l p ɪ n
helsing	h ɛ l z ɪ ŋ
helsinki	h ɛ l s ɪ n k i
helsinki	h æ l s ɪ ŋ k i
helvetica	h æ l v ɛ t ɪ k ə
hemby	h æ m b i
hemel	h æ m ə l
hemingway	h æ m ɪ ŋ w eɪ
hemingway	h æ m ɪ n w eɪ
hemlock	h æ m l ɑ k
hemorrhage	h ɛ m ɹ ɪ dʒ
hempstead	h æ m p s t ɛ d
hen	h æ n
hendel	h æ n d ə l
henderson	h æ n d ɝ s ə n
hendon	h æ n d ə n
hendra	h ɛ n d ɹ ə
hendrickson	h ɛ n d ɹ ɪ k s ə n
hendry	h ɛ n t ɹ i
hendry	h æ n d ɹ i
hennessy	h æ n ɪ s i
henri	ɑ n ɹ i
henry	h ɛ n ɹ ɪ
henryk	h ɛ n ɹ ɪ k
hens	h æ n z
hensley	h ɛ n s l i
henson	h æ n s ə n
henson	h æ n s ə m
henson's	h æ n s ə n z
her	h ɚ
herbarium	ɝ b ɛ ɹ i ə m
herbarium	ɹ b ɛ ɹ i ə n
herder	h ɝ t ɝ
herding	h ɝ t ɪ ŋ
herds	h ɝ t s
here	h i
here	h i ɹ
hereford	h ɝ f ɝ d
heretic	h ɛ ɹ ə t ɪ k
herington	h ɛ ɹ ɪ ŋ t ə n
heriot	h ɛ ɹ i ə t
hero	h ɪ ɹ oʊ
hero's	h i ɹ oʊ z
heroism	h i ɹ oʊ ɪ z ə m
heros	h i ɹ oʊ z
herrera	h ɝ ɛ ɹ ə
hers	ɝ z
herself	ɝ s ɛ l f
herself	ɹ s ɛ l f
heseltine	h æ s ə l d aɪ n
heseltine	h ɛ s ə l t aɪ m
heseltine	h ɛ z ə l t i n
hesiod	h æ z i ə t
hess	h æ s
hesse	h æ s
heterodox	h ɛ t ɹ ə d ɑ k s
hetland	h ɛ d l ə n d
hetman	h ɛ d m ə n
hetty	h ɛ d i
hex	h æ k s
hexagonal	h ɛ ɡ z æ ɡ ə n ə l
hexham	h æ k s ə m
hexham	h ɛ k s ə n
hiatus	h aɪ eɪ d ə s
hibbert	h ɪ p ɝ d
hid	h ɪ t
hierarchies	h aɪ ɝ ɑ ɹ k i z
hierarchy	h aɪ ɝ ɑ ɹ k i
hieratic	h aɪ ɝ ɛ t ɪ k
highlanders	h aɪ l ə n d ɝ s
hilary	h ɪ l ɹ i
hilderic	h ɪ l d ɝ ɪ ɡ
hills	h i l z
hills	h ɪ l s
hilton	h ɪ l d ə n
him	ɪ n
himself	h ɪ m s ɛ l v
hinckley	h ɪ n k l i
hinckley's	h ɪ ŋ ɡ l i z
hindenburg	h ɪ n d ə m b ɝ ɡ
hins	h ɪ n s
hinsdale	h ɪ n z d eɪ l
hippies	h i p i s
hire	h aɪ ɝ
hiring	h aɪ ɝ ɪ ŋ
hiroshima	h i ɹ oʊ ʃ i m ə
hirsch	h ɝ s
his	h i z
his	h i s
histamine	h ɪ s d ə m i n
historically	h ɪ s t ɔ ɹ ɪ k ə l i
hit	h ɪ d
hit	h i t
hitch	h ɪ t s
hitler's	h ɪ d l ɝ z
hits	h ɪ d s
hits	h ɪ d z
hitting	h ɪ d ɪ ŋ
hittite	h ɪ d aɪ t
hobbs	h ɑ p s
hobhouse	h ɑ p h aʊ s
hockin	h ʌ k ɪ n
hogan	h oʊ k ə n
hogg	h ʌ ɡ
hoggins	h ɑ ɡ ɪ ŋ z
hokus	h oʊ k ə z
hold	h oʊ l t
holly	h ɑ l ɪ
hollywood	h ɑ l i w ʊ t
holsworthy	h oʊ l z w ɝ ð i
home	h oʊ n
hood	h u d
hooft	h ʊ f t
hook	h u k
hooray	h u ɹ eɪ
hooters	h u d ɝ z
horine	h ɔ ɹ ɪ n
horizontally	h ɔ ɹ ɪ z ɑ n t ə l i
hormuz	h ɔ ɹ m u s
hornsey	h ɔ ɹ n z i
horror	h ɔ ɹ
hors	ɔ ɹ
horsemen	h ɔ ɹ s m ə n
horticulture	h ɔ ɹ t i k ʌ l tʃ ɝ
hose	h oʊ s
hosen	h oʊ s ə n
hoskins	h ʌ s k ɪ n z
hot	h ɑ d
hotspur	h ɑ t s b ɝ
hough	h ɑ f
hounslow	h aʊ n z l oʊ
hour's	aʊ ɹ z
hourly	aʊ ɝ l i
hours	aʊ ɝ z
house	h aʊ z
housed	h aʊ z d
housed	h aʊ z t
houseman	h aʊ z m ə n
housemate	h aʊ s m eɪ d
housemates	h aʊ s m eɪ d z
housemates	h aʊ s m eɪ d s
houser	h aʊ z ɝ
houses	h aʊ z ɪ z
housing	h aʊ s ɪ ŋ
housing	h aʊ z ɪ n
howse	h aʊ s
hoyt	h ɔɪ d
hub	h ɑ b
hubert	h j u b ɝ d
hucknall	h ɑ k n ə l
huddersfield	h ʌ t ɝ z f i l d
huffington	h ʌ v ɪ ŋ t ə n
huffman	h ɑ f m ə n
hughes	j u s
hughes	h j u s
huguenots	h j u k ə n ɑ t s
hui	h u i
hulbert	h ɑ l b ɝ t
hull's	h ʌ l s
hulse	h ʌ l z
humanitarian	h j u m æ n ɪ t ɛ ɹ i ə n
humanitarian	j u m æ n ə t ɛ ɹ i ə n
humor	j u m ɝ
humour	j u m ɝ
humphries	h ʌ m f ɹ i z
hun	h ʌ ŋ
hundred	h ʌ n t ɹ ɪ d
hungary	h ʌ ŋ ɡ ɹ i
huns	h ɑ n z
hunted	h ʌ n d ɪ d
hunter	h ʌ n t ɹ
hunter	h ɑ n t ɝ
hunters	h ɑ n t ɝ z
huntingdon	h ʌ n t ɪ ŋ t ə n
huntingdonshire	h ʌ n t ɪ ŋ t ə n ʃ ɝ
hunza	h ɑ n z ə
hupp	h ɑ p
hurdle	h ɝ t ə l
hurdles	h ɝ t ə l z
hurt	h ɝ d
hurtado	h ɝ t ɑ t oʊ
hurwitz	h ɝ w ɪ d s
husband	h ʌ s b ə n d
husband	h ɑ z b ə n d
hustler	h ɑ s l ɝ
hutchinson	h ɑ tʃ ɪ n s ə n
hutson	h ʌ d s ə n
hygiene	h aɪ dʒ ɪ ŋ
hymns	h ɪ n z
hysterically	h ɪ s t ɛ ɹ ɪ k l i
hythe	h aɪ θ
i	i
ibrahim	i b ɹ ɑ h i m
ice	aɪ z
id	i t
ideas	aɪ d i ə s
idiosyncrasies	ɪ d i ə s ɪ ŋ k ɹ ə s i z
idiosyncratic	ɪ d i oʊ s ɪ ŋ k ɹ æ t ɪ k
idris	i d ɹ ə z
idyllic	aɪ d i l ɪ k
iglesias	ɪ ɡ l eɪ s i ə z
ignition	ɪ ɡ m ɪ ʃ ə n
ignition	ɪ k n ɪ ʃ ə n
ignominiously	ɪ ɡ n ə n ɪ m i ə s l i
iguanas	i ɡ w ɑ n ə s
ill	i l
illegal	ɪ l ɪ ɡ ə l
illinois	ɪ l ə n ɔɪ s
illusory	ɪ l u z ɝ i
imager	ɪ m ɪ dʒ ɝ
imaging	ɪ m ɪ dʒ ɪ n
imbalance	ɪ n b æ l ə n s
imbecile	ɪ n b ə s ə l
imitated	ɪ m ə d eɪ t ɪ d
immersion	ɪ m ɝ ʃ ə n
immortality	ɪ m ɔ ɹ t æ l ɪ t i
imogen	ɪ m ə dʒ i n
impact	ɪ n p æ k t
impacted	ɪ m p ɛ k t ɪ d
impairment	ɪ n p ɛ ɹ m ə n t
impede	ɪ n b i d
impenetrable	ɪ n p ɛ n ə t ɹ ə b ə l
impermeable	ɪ n p ɝ m i ə b ə l
impersonated	ɪ n p ɝ s ə n eɪ t ɪ d
implausible	ɪ n p l ɔ z ə b ə l
implies	ɪ n p l aɪ z
important	ɪ n p ɔ ɹ t ə n t
impostor	ɪ m p ɑ s t ɝ
impoverished	ɪ m p ɑ v ɝ ɪ ʃ t
impresses	ɪ n b ɹ ɛ s ɪ z
imprint	ɪ n p ɹ ɪ n t
imprisoned	ɪ n p ɹ ɪ z ə n d
imprisonment	ɪ n p ɹ ɪ z ə n m ə n t
imprisons	ɪ n p ɹ ɪ z ə n z
improprieties	ɪ n p ɹ ə p ɹ aɪ ə t i z
in	ɪ ŋ
in	ɪ m
in	ə m
in	i n
inaugural	ɪ n ɔ ɡ ɝ ə l
inbred	ɪ n b ɹ ɛ d
inc	ɪ n k
inca	ɪ n k ə
incident	ɪ n s ə t ə n t
inciting	ɪ n s aɪ d ɪ ŋ
inclement	ɪ ŋ k l ə m ə n t
inclusive	ɪ n k l u z ɪ v
inclusive	ɪ n k l u s ɪ f
incommensurable	ɪ n k ə m ɛ n s ɹ ə b ə l
incomparable	ɪ n k ɑ m p ɹ ə b ə l
inconsequential	ɪ n k ɑ n s ə k w ɛ n tʃ ə l
inconstant	ɪ n k ɑ n s t ə n t
incorporated	ɪ n k ɔ ɹ b ɝ eɪ t ɪ d
incorrectly	ɪ n k ɹ ɛ k t l i
increments	ɪ ŋ k ɹ ə m ə n t s
increments	ɪ n k ɹ ə m ɛ n t s
incubate	ɪ ŋ k j ə b eɪ t
incubated	ɪ ŋ k j ə b eɪ t ɪ d
incubates	ɪ ŋ k j ə b eɪ t s
incubating	ɪ ŋ k j ə b eɪ t ɪ ŋ
incubator	ɪ ŋ k j ə b eɪ t ɝ
incubators	ɪ ŋ k j ə b eɪ t ɝ z
incubus	ɪ n k j ə p ə s
inculcation	ɪ n k ə l k eɪ ʃ ə n
incumbent	ɪ n k ɑ m b ə n t
indemnity	ɪ n d ɛ m n i t i
indentation	ɪ n t ɛ n t eɪ ʃ ə n
indian	ɪ n d i ə m
indiana	ɪ n d i ɛ n ə
indicates	ɪ n t ə k eɪ t s
indices	ɪ n d ə s i z
indicted	ɪ n d aɪ d ɪ d
indies	ɪ n d i s
indigo	ɪ n t ə ɡ oʊ
indira	ɪ n d ɪ ɹ ə
indissoluble	ɪ n d ɪ s ɑ l j ə b ə l
indonesia	ɪ n d ə n ɪ s ə
indonesian	ɪ n t ə n i ʒ ə n
indonesian	ɪ n d ə n i ʃ ə n
ine	i n
infarction	ɪ m f ɑ ɹ k ʃ ə n
inference	ɪ n f ɹ ə n s
inflation	ɪ n f l eɪ ʒ ə n
infliximab	ɪ n f l ɪ k s ɪ m æ p
influential	ɪ n f l u ɛ n s ə l
influenza	ɪ n f l u ɛ n s ə
information	ɪ n f ɚ m eɪ ʃ ə n
infrared	ɪ n f ɝ ɹ ɛ d
infrared	ɪ n f ɝ ɹ æ d
infrequent	ɪ n f ɹ ɪ k w ə n t
ingolstadt	ɪ ŋ ɡ oʊ l s t æ d
ingram	ɪ n ɡ ɹ ə m
ingratiating	ɪ n ɡ ɹ eɪ ʃ i eɪ t ɪ ŋ
ingratitude	ɪ ŋ ɡ ɹ æ t ə t u d
initial	ɪ m ɪ ʃ ə l
initiate	ɪ n i ʃ i eɪ t
inker	ɪ ŋ k ɝ
inlet	ɪ n l æ t
inn	i n
inna	i n ə
innings	ɪ n ɪ n z
inns	ɪ n s
inputs	ɪ m p ʊ t s
inquirer	ɪ n k w aɪ ɝ ɝ
inquiries	ɪ n k w aɪ ɹ i z
inquiry	ɪ n k w aɪ ɝ i
inscription	ɪ n s k ɹ ɪ p s ə n
insecticide	ɪ n s ɛ k t ə s aɪ t
insecticides	ɪ n s ɛ k t ə s aɪ t s
insectivorous	ɪ n s ɛ k t ɪ f ɝ ə s
inside	ɪ n s aɪ t
inside	ɪ m s aɪ d
insight	ɪ n s aɪ d
insignia	ɪ n s ɪ k n i ə
inspire	ɪ n s p aɪ ɹ
inspirers	ɪ n s p aɪ ɹ ɝ z
instead	ɪ n s t æ d
instrumentals	ɪ n s t ɹ ə m ɛ n ə l z
insular	ɪ n s j ə l ɝ
insurmountable	ɪ m s ɝ m aʊ n t ə b ə l
integral	ɪ n t i ɡ ɹ ə l
integration	ɪ m ə ɡ ɹ eɪ ʃ ə n
intendant	ɪ n d ɛ n d ə n t
intensity	ɪ n d ɛ n s ə t i
intents	ɪ n t ɛ n d z
interactions	ɪ n t ɹ æ k ʃ ə n z
interamerican	ɪ n t ɝ ə m ɛ ɹ ə k ə n
interbred	ɪ n t ɝ b ɹ ɛ d
intercity	ɪ n ɝ s ɪ d i
intercourse	ɪ n ɝ k ɔ ɹ s
interest	ɪ n t ɝ ɛ s t
interest	ɪ n t ɝ ə s t
interesting	ɪ n t ɝ ə s t ɪ ŋ
interfered	ɪ n t ɝ f ɪ ɹ d
interference	ɪ n t ɝ f ɪ ɹ ə n s
interfering	ɪ n t ɝ f ɪ ɹ ɪ ŋ
interim	ɪ n t ɝ ə n
interim	ɪ n t ɹ ə m
intermediary	ɪ n t ɝ m i d i ɛ ɹ i
international	ɪ n t ɝ n æ ʃ ə n ə l
internationally	ɪ n ɚ n æ ʃ n ə l i
internecine	ɪ n t ɝ n ɛ s i n
internet	ɪ n t ɝ n æ t
intersex	ɪ n t ɝ s ɛ k s
interspecific	ɪ n t ɝ s p ə s ɪ f ɪ k
interval	ɪ n t ɝ f ə l
intestines	ɪ n t ɛ s t ə n s
into	ɪ n d u
intrigued	ɪ n t ɹ ɪ ɡ d
intrinsically	ɪ n t ɹ ɪ n z ɪ k l i
intro	ɪ n d ɹ oʊ
introductory	ɪ n t ɹ ə d ʌ k t ɹ i
inuit	ɪ n u ɪ t
inuit	ɪ n u ɪ d
invalid	ɪ n v ɛ l ə d
invariance	ɪ n f ɛ ɹ i ə n s
invariant	ɪ n v ɛ ɹ i ə n t
invasion	ɪ n v eɪ z ə n
inventories	ɪ m v ə n t ɔ ɹ i z
inverse	ɪ n f ɝ s
invested	ɪ m v ɛ s t ɪ d
investor	ɪ n f ɛ s t ɝ
invocation	ɪ n f ə k eɪ ʃ ə n
invoices	ɪ n f ɔɪ s ɪ z
involved	ɪ m v ɑ l v d
involved	ɪ n v ɑ l f t
involved	ɪ n f ɑ l v d
involving	ɪ n v ɑ l v ɪ n
ipswich	ɪ b s w ɪ tʃ
iran	i ɹ ɑ n
iraq	i ɹ ɑ k
ire	aɪ ɝ
ireland	aɪ ɝ l ə n d
ireland	ɑ ɹ l ə n d
irina	i ɹ i n ə
iron	aɪ ɹ n
ironton	aɪ ɝ n t ə n
irtysh	ɹ d ɪ ʃ
irving	ɝ f ɪ ŋ
irwell	ɹ w ɛ l
is	ɪ s
is	i z
is	ɪ ʃ
is	i s
isaac	aɪ s ə k
isaac's	aɪ s ɪ k s
isabella	ɪ s ə b ɛ l ə
isabelle	ɪ s ə b ɛ l
isaias	aɪ z eɪ ə s
isha	i ʃ ə
ishi's	ɪ ʃ ɪ z
isidro	ɪ z i d ɹ oʊ
iskra	ɪ s k ɹ ə
islam	ɪ s l ə m
islamic	ɪ s l æ m ɪ k
islamists	ɪ z l ə m ɪ s t s
islington	ɪ s l ɪ ŋ t ə n
ismail	i s m eɪ l
isotopes	aɪ s ə t oʊ b s
isotopes	aɪ z ə t oʊ p s
israel	ɪ s ɹ i ə l
israeli	ɪ s ɹ eɪ l i
issuing	ɪ ʃ u ɪ n
istanbul	i s t æ n b ʊ l
istanbul	ɪ s t æ n b u l
it	ɪ d
it	i t
it's	ɪ t z
italia	ɪ t æ l i ə
itchen	i tʃ ə n
item	aɪ d ə m
items	aɪ d ə n z
iterations	ɪ d ɝ eɪ ʃ ə n z
ito	i d oʊ
ivan	i v ə n
ivan's	i v ə n s
ivana	i v ɑ n ə
ivanhoe	aɪ f ə n h oʊ
ivories	aɪ v ɝ i z
ivory	aɪ v ɹ i
jabberwocky	dʒ æ b ɝ w ɑ k i
jack	dʒ æ ɡ
jack	dʒ ɛ k
jackman	dʒ æ ɡ m ə n
jacobs	dʒ eɪ k ə b s
jagger	dʒ æ k ɝ
jakarta	dʒ ə k ɑ ɹ d ə
jam	dʒ ɛ m
jam	dʒ ɛ n
james	dʒ eɪ n z
jamesville	dʒ eɪ n z v ɪ l
jamie	dʒ eɪ n i
jamieson	dʒ eɪ m i s ə n
jamming	dʒ ɛ m ɪ ŋ
jan	dʒ ɛ n
jang	dʒ æ n
janitor	dʒ æ n ɪ t ɝ
january	dʒ ɛ n j u ɛ ɹ i
japan	dʒ ə b æ n
jared	dʒ ɛ ɹ i d
jarrett	dʒ ɛ ɹ ɪ t
jason	dʒ eɪ z ə n
jastrow	dʒ æ ʃ t ɹ oʊ
java	dʒ ɑ f ə
jazz	dʒ æ s
jazz	dʒ ɛ s
jazz	dʒ ɛ z
jazzed	dʒ æ s t
jean	dʒ ɪ n
jeans	dʒ ɪ n z
jeans	dʒ i n s
jeans	dʒ i m z
jed	dʒ æ d
jeddah	dʒ ɛ t ə
jedson	dʒ ɛ t s ə n
jeep	dʒ ɪ p
jeeps	dʒ i b z
jeering	dʒ ɪ ɹ ɪ ŋ
jeeves	dʒ i f s
jeff	dʒ ɛ v
jeffery	dʒ ɛ f ɹ i
jenkins	dʒ ɛ n k ɪ n z
jenkinson	dʒ ɛ n k ɪ n s ə n
jennie	dʒ æ n i
jennifer	dʒ ɛ n ɪ f ɝ
jennifer	dʒ æ n ɪ f ɝ
jennifer	dʒ æ n ə f ɝ
jennings	dʒ ɛ n ɪ n z
jenny	dʒ ɛ n ɪ
jensen	dʒ æ n s ə n
jersey	dʒ ɝ s i
jessop	dʒ æ s ə p
jesuits	dʒ ɛ z u ɪ t s
jesus	dʒ i z ə z
jet	dʒ æ t
jettisoned	dʒ ɛ d ɪ s ə n d
jetty	dʒ ɛ d i
jewellery	dʒ u ə l ɝ i
jewelry	dʒ u l ɹ i
jewish	dʒ u ɪ s
jezebel	dʒ ɛ s ə b ɛ l
jiggers	dʒ i ɡ ɝ z
jihad	dʒ i h ɑ d
jilin	dʒ ɪ l ɪ n
jin	dʒ i n
jin	dʒ ɪ m
jit	dʒ i t
jitter	dʒ ɪ t ɝ
joaquin	w ɑ k ɪ n
job	dʒ ɑ p
jockey	dʒ ʌ k i
jogger	dʒ ɑ ɡ ɝ
jogging	dʒ ʌ ɡ ɪ ŋ
joined	dʒ ɔɪ n t
joins	dʒ ɔɪ n s
joint	dʒ ɔɪ n d
jokingly	dʒ oʊ k ɪ n l i
jones	dʒ oʊ n s
jose	dʒ oʊ s
joseph's	dʒ oʊ s ə f s
josie	dʒ oʊ s i
juanita	w ɑ n i d ə
juba	dʒ u p ə
judge	dʒ ɑ dʒ
juggernaut	dʒ ʌ ɡ ɝ n ɑ t
jugs	dʒ ʌ ɡ s
jugular	dʒ ʌ ɡ j ə l ɝ
juicer	dʒ u s ɝ
jung's	j u ŋ z
junior	dʒ u n i ə
jury	dʒ ʊ ɝ i
justice	dʒ ʌ s t i z
juvenile	dʒ u f ə n ə l
kabila	k ə b i l ə
kaddish	k ɑ t ɪ ʃ
kader	ɡ eɪ d ɝ
kader	k eɪ t ɝ
kamchatka	k ʌ m tʃ ɑ t k ə
kane	k eɪ m
kanishka	k ɑ n ɪ ʃ k ə
kankakee	k æ n k ə k i
kansas	k æ n s ə s
kansas	k æ n s ə z
kapiti	k ə p ɪ t i
kara	k ɛ ɹ ə
karate	k ɝ ɑ d i
kardon	k ɑ ɹ t ə n
kareem	k ɹ i m
karen's	k æ ɹ ə n z
karlen	k ɑ ɹ l ə n
karlin	k ɑ ɹ l ɪ n
karlsson	k ɑ ɹ l s ə n
karney	k ɑ ɹ n i
karrick	k ɛ ɹ ɪ k
karsh	k ɑ ɹ ʃ
kashmir	k æ ʃ m ɪ ɹ
kashmir	k æ ʒ m ɪ ɹ
kashmiri	k æ ʃ m ɪ ɹ i
kashubian	k ə ʃ u b i ə n
kassem	k æ s ə n
katharine	k æ θ ɝ ɪ n
katherine	k æ θ ɹ i n
katie	k eɪ d i
katoomba	k ə t u n b ə
katowice	k ɑ d ə v i t s ə
katy	k eɪ d i
kea	ɡ i
kearsarge	k ɪ ɹ s ɑ ɹ dʒ
keating	ɡ ɪ t ɪ ŋ
keck	k æ k
keenan	k ɪ n ə n
keene	k ɪ n
keep	k ɪ p
keiser	k aɪ z ɝ
kel	k æ l
kellaway	k æ l ə w eɪ
kelley	k æ l i
kelly	k æ l i
kelly	k ɛ l ɪ
kelvin	k æ l v ə n
kelvin	k æ l v ɪ n
kem	k æ m
kembel	k æ m b ə l
kember	k æ m b ɝ
kemp	k æ m p
kempe	k æ m p
kemper	k æ m p ɝ
kemps	k æ m p s
kempton	k æ m p t ə n
ken	k æ n
ken	ɡ ɛ n
kendall	k æ n d ə l
kenefick	k æ n i f ɪ k
keng	k æ ŋ
kennan	k æ n ə n
kennebec	k æ n ə b ɛ k
kennedy	k æ n ə d i
kennedys	k æ n ə d i z
kennel	k ɛ m ə l
kennelly	k æ n ə l i
kenner	ɡ æ n ɝ
kenneth	k æ n ɪ θ
kennon	k æ n ə n
kenny	k æ n i
kenora	k ə n ɔ ɹ ə
kensal	k ɛ n z ə l
kensal	k æ n s ə l
kent	k ɛ m t
kent	k æ n t
kenton	k æ m t ə n
kentucky	k æ n t ʌ k i
kenya	k æ n j ə
kenya	k ɪ n j ə
kenya	ɡ æ n j ə
kenyan	k æ n j ə n
kenyon	k æ n j ə n
kerosene	k ɛ ɹ ə ʃ i n
kestrel	k æ s t ɹ ə l
keswick	k ɛ z w ɪ k
ket	k æ t
ketley	k æ t l i
kettering	k æ t ɝ ɪ ŋ
kettle	k æ t ə l
kevin	k æ v ə n
kevin	k æ v ɪ n
keyboard	k i b ɔ ɹ t
keyboards	k i b ɔ ɹ d s
keyes	ɡ i z
keynes	k ɪ n z
keys	k i s
khalid	k ɑ l i d
khan	k ʌ n
kharkiv	k ɑ ɹ k ɪ f
khartoum	k ɑ ɹ t u n
khas	k ɑ z
kheer	k ɪ ɹ
khyber	k aɪ p ɝ
kick	k ɪ ɡ
kicking	k ɪ k ɪ n
kid	k ɪ t
kidde	k ɪ t
kidder	k ɪ t ɝ
kidderminster	k ɪ t ɝ m ɪ n s t ɝ
kiddie	k ɪ t i
kidnappers	k ɪ d n æ p ɝ s
kids	k ɪ t s
kids	k ɪ d s
kikuyu	k ɪ k u j u
kilbride	k ɪ l b ɹ aɪ t
killing	k ɪ l ɪ n
kills	k ɪ l s
kilmaine	ɡ ɪ l m eɪ n
kiln	k ɪ l m
kilns	k ɪ l m z
kim	k ɪ n
kindergarten	k ɪ n d ɝ ɡ ɑ ɹ d ə n
kinematics	k ɪ n ə m ɛ t ɪ k s
king	k ɪ n
king	k i n
kingdom	k ɪ ŋ d ə n
kingdom	k ɪ n d ə m
kings	k ɪ ŋ s
kingsford	k ɪ ŋ z f ɝ d
kingsmill	k ɪ ŋ z m ɪ l
kingsport	k ɪ ŋ z p ɔ ɹ t
kingston	k ɪ n s t ə n
kingstown	k ɪ ŋ s t aʊ n
kinkaid	k ɪ n k eɪ d
kinshasa	k ɪ n s ɑ ʃ ə
kinston	k ɪ ŋ s t ə n
kintail	k ɪ n d eɪ l
kinvara	k ɪ n f ɑ ɹ ə
kirby	k ɝ p i
kiribati	k ɪ ɹ i b ɑ t i
kiribati	k ɪ ɹ ə b ɑ d i
kirk	k ɝ ɡ
kirkpatrick	k ɝ k p æ t ɹ ɪ k
kirov	k ɪ ɹ ɑ v
kiryat	k ɪ ɹ j ə t
kisa	k i s ə
kisan	k ɪ s ə n
kisan	k i s ə n
kish	k i ʃ
kishimoto	k ɪ ʃ i m oʊ d oʊ
kissing	k i s ɪ ŋ
kissinger	k ɪ s ə n dʒ ɝ
kit	k ɪ d
kith	k i θ
kits	k ɪ d z
klopstock	k l ɑ b s t ɑ k
klugh	k l ɑ
kneading	n ɪ t ɪ ŋ
knee	m i
knew	m u
knights	n aɪ t z
knit	n i t
knoxville	n ʌ k s v ɪ l
knutson	n u d s ə n
koda	k oʊ t ə
kodak	k oʊ d ɛ k
konig	k ɑ n ɪ k
konkan	k ɑ n k ə n
koos	k u s
kopp	k ɑ b
korean	k ɝ i ə n
korean	k ɔ ɹ i ə n
koreans	k ɝ i ə n z
korey	k ɔ ɹ i
korman	k ɔ ɹ m ə n
korn	k ɔ ɹ n
kos	k oʊ s
kote	k oʊ d
krack	k ɹ æ k
krasny	k ɹ æ s n i
krause's	k ɹ aʊ z ɪ z
kravitz	k ɹ æ v ɪ t s
krebs	k ɹ æ p s
kremer	k ɹ ɪ m ɝ
kremlin	k ɹ æ m l ə n
kremlin	k ɹ æ m l ɪ ŋ
kriging	k ɹ ɪ ɡ ɪ ŋ
krikalev	k ɹ ɪ k ə l ɛ v
krim	k ɹ i m
krishna	k ɹ ɪ s n ə
krista	k ɹ ɪ s t ə
kristen	k ɹ ɪ s t ə n
kristensen	k ɹ ɪ s t ə n s ə n
kristina	k ɹ ɪ s t i n ə
kristine	k ɹ ɪ s t i n
kristopher	k ɹ ɪ s t ə f ɝ
kroc's	k ɹ ɑ k s
kron	k ɹ ʌ n
kropp	k ɹ ɑ p
kruger	k ɹ u k ɝ
krum	k ɹ ɑ m
krum	k ɹ ʌ m
krupp	k ɹ ʌ b
kruse	k ɹ u s
krypton	k ɹ ɪ p t ɔ n
krystal	k ɹ ɪ s t ə l
kugler	k u k l ɝ
kunstler	k ɑ n s l ɝ
kurdish	k ɝ t ɪ ʃ
kushan	k u ʃ ɑ n
kyiv	k ɪ f
kyushu	k j u s u
l	æ l
lab	l æ p
labels	l eɪ p ə l z
labor	l eɪ p ɝ
laboratory's	l æ b ɹ ə t ɔ ɹ i z
labrador	l æ b ɹ ə t ɔ ɹ
labs	l æ p s
labs	l æ b s
lack	l ɛ k
lacking	l æ k ɪ n
lad	l æ t
ladder	l æ t ɝ
ladder	l ɛ t ə
lafayette	l ɑ f i æ t
lafferty	l æ f ɝ d i
lafitte	l ə f i t
lager	l ɑ ɡ ɝ
lagging	l ɛ ɡ ɪ ŋ
lahore	l ə h ɔ ɹ
lairmore	l ɛ ɹ m ɔ ɹ
lake	l eɪ ɡ
lakeview	l eɪ k f j u
lakeville	l eɪ k f i l
lakshmi	l ɑ k s m i
lamb's	l æ m s
lambert	l æ m b ɝ d
lambton	l æ m t ə m
lamesa	l ə m i z ə
lampert	l æ m b ɝ t
lancashire	l æ ŋ k ə ʃ aɪ ɝ
lancaster	l æ ŋ k ɛ s t ɝ
lancastrian	l æ n k æ s t ɹ i ə n
lance	l ɛ n s
land	l æ n t
landfill	l æ n d f i l
landing	l ɛ n d ɪ ŋ
landrieu	l æ n d ɹ u
landseer	l æ n s i ɝ
landtag	l æ n d æ k
lanes	l eɪ n s
lang	l æ n
lange	l æ n
lansdowne	l æ n z d aʊ n
lansing	l ɛ n z ɪ ŋ
lansing	l æ n z ɪ ŋ
lansing	l ɛ n s ɪ ŋ
laos	l aʊ z
laparoscopic	l æ p ɹ ə s k ɑ p ɪ k
laplace	l ə p l ɑ z
laptop	l æ p t ʌ p
laptop	l æ p t ʌ b
laramie	l ɛ ɹ ə m i
laramie's	l ɛ ɹ ə m i z
lari	l ɑ ɝ i
larimer	l ɛ ɹ ɪ m ɝ
laroque	l ɹ oʊ ɡ
larrabee	l ɛ ɹ ə b i
larvae	l ɑ ɹ f i
lary	l ɛ ɹ i
lassen	l ɛ s ə n
last	l ɛ s t
later	l eɪ d ɝ
later	l eɪ t ɚ
latex	l eɪ t æ k s
lathom	l æ θ ə m
latimer	l æ d ə m ɝ
latter	l ɛ t ɝ
latter	l æ d ɝ
latter	l æ ɾ ɝ
lattice	l æ d ə s
lattice	l ɛ t ə s
lattices	l æ t ə s i z
latvia	l ɑ t f i ə
latvia	l æ t f i ə
lauderdale	l ɔ t ɝ d eɪ l
launcher	l ʌ n tʃ ɝ
laundry	l ɔ n d ɝ i
laurens	l ɔ ɹ ə n s
laurie's	l ɔ ɹ i z
lauter	l aʊ d ɝ
lawn	l ɔ ŋ
lawrencium	l ɔ ɹ ɛ n s i ə m
laws	l ɔ s
lawther	l ɔ θ ɝ
layton	l eɪ d ə n
lead	l i t
lead	l ɪ t
lead	l ɛ t
leader	l i t ɝ
leadership	l i d ɝ s ɪ p
leading	l ɪ d ɪ ŋ
leading	l i d ɪ n
leaf	l i v
leafs	l i f z
leafs	l i v z
league	l i k
league	l ɪ k
leaguers	l i k ɝ z
leak	l i ɡ
leamington	l ɪ m ɪ ŋ t ə n
lear's	l ɪ ɹ z
lear's	l i ɝ z
learned	l ɝ n t
leasing	l i z ɪ ŋ
least	l ɪ s t
leave	l i f
leaves	l i f z
leaving	l ɪ v ɪ ŋ
lebanese	l æ b ə n i z
led	l ɛ t
leeches	l i tʃ ɪ s
leeds	l ɪ d z
leer	l i ɝ
left	l æ f t
left	l ɛ v d
leg	l æ ɡ
leg	l ɛ k
legacy	l ɛ k ə s i
legal	l i k ə l
legend	l ɛ dʒ ə n t
legendary	l ɛ dʒ ə n t ɛ ɹ i
legs	l ɛ ɡ s
legs	l ɛ k s
lehtinen	l æ t ɪ n ə n
leiden	l aɪ t ə n
leighton's	l eɪ d ə n z
leipzig	l aɪ p s ɪ k
leisurely	l i ʒ ɝ l i
lek	l æ k
lemhi	l æ m h i
lemm	l æ m
len	l æ n
lena	l ɪ n ə
lending	l æ n d ɪ ŋ
leng	l æ ŋ
length	l ɛ n θ
lengthy	l æ ŋ θ i
leningrad	l ɛ n ɪ ŋ ɡ ɝ æ d
lennon	l æ n ə n
leno	l ɪ n oʊ
lenoir	l æ n w ɑ ɹ
lens	l æ n z
lens	l ɛ n s
lenses	l ɛ n s ɪ z
lenton	l æ n t ə n
leonidas	l i ə n i d ə s
leppert	l ɛ p ɝ d
les	l æ s
lesbian	l ɛ s b i ə n
lesbos	l ɛ z b oʊ s
less	l æ s
lethality	l ɪ θ æ l ə t i
lets	l ɛ d z
letter	l æ t ɝ
letter	l ɛ t ə
letterman	l ɛ d ɝ m ə n
letters	l ɛ t ɝ s
letters	l ɛ t ə s
letters	l ɛ d ɝ z
leukemia	l u k ɪ m i ə
leung	l u n
levant	l ɛ v ə n d
level	l ɛ f ə l
leveling	l ɛ f ə l ɪ ŋ
leverage	l ɛ v ɝ ɪ dʒ
lewis	l u ɪ z
lexmark	l ɛ k s m ɑ ɹ k
liaisons	l i eɪ z ɑ n z
liam	l i ə n
liber	l i b ɝ
liberal	l i b ɝ ə l
liberal's	l ɪ b ɝ ə l z
liberati	l ɪ b ɝ ɑ t i
liberman	l i b ɝ m ə n
libertarianism	l ɪ b ə t ɛ ɹ i ə n ɪ z ə m
liberty	l i b ɝ t i
lida	l ɪ d ə
liddell	l ɪ t ə l
liechtenstein	l ɪ k t ə n ʃ t aɪ n
lies	l aɪ s
life	l aɪ v
ligament	l ɪ k ə m ə n t
lightbody	l aɪ d b ɑ d i
likud	l ɪ k u d
lilies	l ɪ l ɪ ʃ
lillias	l ɪ l i ə s
lime	l aɪ n
limerick	l ɪ m ɹ ɪ k
limericks	l ɪ m ɹ ɪ k s
limes	l aɪ n z
linden	l ɪ n d ə m
lindisfarne	l ɪ n d ɪ ʃ f ɑ n
lindsay	l ɪ n s i
line	l aɪ m
linear	l i n i ɝ
lines	l aɪ n s
lining	l aɪ n ɪ n
linlithgow	l ɪ n l ɪ θ k aʊ
lintels	l ɪ m t ə l z
linux	l i n ə k s
lions	l aɪ ə n s
lipari	l ɪ p ɑ ɹ i
lippi	l i p i
liquids	l i k w ɪ d z
liquor	l i k ɝ
lira	l i ɹ ə
lisa	l ɪ s ə
lismore	l ɪ z m ɔ ɹ
lita	l i d ə
liter	l i d ɝ
literature	l ɪ t ɝ tʃ ɝ
liters	l i d ɝ z
lithgow	l ɪ θ k aʊ
lithium	l i θ i ə m
litters	l i d ɝ z
little	l i t ə l
live	l aɪ f
live	l i v
lived	l i f t
lived	l aɪ f t
lived	l ɪ v t
lived	l ɪ f d
liver	l ɪ f ɝ
liveries	l ɪ v ɝ i z
lives	l i v z
lives	l ɪ v s
lives	l aɪ f s
livestock	l aɪ f s t ɑ k
living	l i v ɪ ŋ
living	l ɪ f ɪ ŋ
living	l ɪ v ɪ n
liz	l ɪ s
liza	l ɪ z ə
lizards	l i s ɝ d z
lizards	l ɪ z ɝ d s
lizards	l i z ɝ d z
lloyd	l ɔɪ t
load	l oʊ t
loads	l oʊ t s
loamy	l oʊ n i
loath	l oʊ ð
lobe	l oʊ p
lobos	l oʊ b oʊ s
lobster	l ɑ p s t ɝ
location	l oʊ k eɪ ʒ ə n
locker	l ʌ k ɝ
locomotive's	l oʊ k ə m oʊ t i v z
locomotives	l oʊ k ə m oʊ t ɪ v s
locos	l oʊ k oʊ s
lodged	l ɑ dʒ t
logarithmic	l ɑ ɡ ɝ ɪ θ m ɪ k
logo	l oʊ k oʊ
logos	l oʊ ɡ oʊ s
logstown	l ɑ ɡ z t aʊ n
loki	l oʊ ɡ i
loki	l oʊ k ɪ
lomas	l oʊ m ə s
lombards	l ɑ m b ɑ ɹ t s
lonely	l oʊ ŋ l i
long	l ɔ n
longer	l ɔ ŋ ɚ
longer	l ɔ ŋ ɡ ɝ
longevity	l ɔ ŋ dʒ ɛ v ə t i
lonsdale	l ɑ n z d eɪ l
look	l u k
looking	l ʊ k ɪ n
loose	l u z
loosely	l u z l i
looted	l u d ɪ d
looting	l u d ɪ ŋ
looting	l u d ɪ n
lopez	l oʊ p æ z
lopsided	l ɑ p s aɪ t ɪ d
loren's	l ɔ ɹ ə n s
lorette	l ɔ ɹ ɛ t
lorie	l ɔ ɹ i
lorient	l ɔ ɹ i ɛ n d
lorimar	l ɔ ɹ ə m ɑ ɹ
lortie	l ɔ ɹ t i
los	l oʊ z
lose	l u s
loss	l ɔ z
lot	l ɑ d
lotus	l oʊ d ə s
louis	l u ɪ
louis	l u i z
louis	l u i s
louis	l u ɪ z
louisa	l u i s ə
louisan	l u i z ə n
louise	l u i s
louise	l u ɪ s
louisiana	l u i ʃ i æ n ə
love	l ʌ f
lovitt	l ʌ v ɪ t
lower	l oʊ ɚ
lower	l oʊ ɹ
lowther	l oʊ θ ɝ
lp	æ l p i
lubricants	l u b ɹ ɪ k ə n z
luc	l u ɡ
lucas	l u ɡ ə s
lucasville	l u k ə z v ɪ l
lucia	l u ʃ i ə
lucille	l u s ɪ l
lucinda's	l u s ɪ n d ə s
lucius	l u s i ə s
luck	l ɑ k
ludlow	l ɑ d l oʊ
ludlum	l ʌ d l ə n
luis	l u i z
luis	l u ɪ s
luis	l u ɪ ʃ
luisa	l u i s ə
lukas	l u k ə s
lumber	l ʌ m p ɝ
lumpur	l ə m p ʊ ɹ
lung	l ʌ n
lupo	l u b oʊ
lusitanians	l u s ə d eɪ n i ə n z
lute	l u d
lutherans	l u θ ɹ ə n z
luthier	l u θ i ɝ
luthier	l u d i ɝ
lux	l ɑ ɡ s
luxembourg	l ʌ k s ə n b ɝ ɡ
luxury	l ʌ ɡ ʃ ɝ i
luxury	l ʌ k ʒ ɝ i
lyndon	l ɪ n d ə m
lynette	l i n æ t
lyre	l aɪ ɝ
lytle	l aɪ d ə l
m	æ m
m	ɛ n
m	æ n
ma'am	m ɛ n
mac	m ɛ k
macarthur	m ə ɡ ɑ ɹ θ ɝ
macbeth	m ə k b æ θ
macgregor	m ə k ɹ ɛ k ɝ
machine	m ə s i n
mackerel	n æ k ɝ ə l
macon	m eɪ k ə m
macpherson	m ə k f ɪ ɹ s ə n
macpherson's	m ə k f ɪ ɹ s ə n z
mad	m æ t
madagascar	m æ t ə ɡ æ s k ɑ ɹ
madagascar	m æ t ə ɡ æ s k ɝ
madcap	m ɛ d k æ p
madder	m æ t ɝ
maddison	m æ t ɪ s ə n
maddock	m ɛ d ə k
maddy	m æ t i
made	m eɪ t
madigan	m æ t ɪ ɡ ə n
madison	m ɛ d ɪ s ə n
madison	m æ t ɪ s ə n
madison	m ɛ d ə s ə n
madison's	m æ t ɪ s ə n z
madras	m æ t ɹ ə s
magat	m ɛ ɡ ə t
magazine	m æ ɡ ə s i n
magdeburg	m æ k t ə b ɝ ɡ
maggie	m æ k i
magnetic	m æ ɡ n æ t ɪ k
magni	m æ k n i
magnon	m ɛ k n ə m
magnus	m æ k n ə s
magog	m ə ɡ ɑ k
magruder	m ə ɡ ɹ u t ɝ
maguire	m ə ɡ w aɪ ɝ
mahim	m ɑ h ɪ m
maine	n eɪ m
mainz	m eɪ m z
mainz	m eɪ n s
making	m eɪ k ɪ n
malagasy	m æ l ə ɡ æ z i
malaysia	m ə l eɪ ʃ ə
malaysian	m ə l eɪ ʃ ə n
malfeasance	m æ l f i z ə n z
malin	m ɛ l i n
malmstrom	m æ l m s t ɹ ə m
malt	m ɔ l d
maltese	m ɑ l t i s
malvern	m æ l f ɝ n
malvern	m ɛ l v ɝ n
mambas	m ʌ m b ə z
mambo	m ʌ m b oʊ
mammary	m ɛ m ɝ i
mammoth	m æ n ə θ
mammy	n æ m i
man	m æ m
man's	m ə n s
managed	m ɛ n ɪ dʒ t
manas	m æ n ə s
mandarin	m æ n d ɹ ə n
mandate	m ɛ n d eɪ t
mandibular	m æ n d ɪ b j ə l ɝ
mandibular	m ɛ n d ɪ b j ə l ɝ
mane	n eɪ m
manga	m ʌ ŋ ɡ ə
manga	m æ n ɡ ə
manga	m æ n k ə
mangrove	m æ ŋ ɡ ɹ oʊ v
mangroves	m æ ŋ ɡ ɹ oʊ v z
manifolds	m æ n ə f oʊ l d s
manitoba	m æ n i t oʊ b ə
manitoba	m ɛ n i t oʊ b ə
manitoba	m ɛ n ɪ t oʊ b ə
manmade	m æ n m eɪ t
mannerist	m æ n ɝ ɪ ʃ t
manoeuvre	m ə n u v ɝ
mansfield	m æ n s f i l d
mansfield	m ɛ n s f i l d
mansfield	m æ n z f ɪ l d
manufacture	m æ n ə f æ k tʃ ɝ
many	m æ n i
many	m ɛ n ɪ
manzanita	m ɛ n s ə n i t ə
maori	m aʊ ɝ i
mapping	n æ p ɪ ŋ
mapplethorpe	m æ p ə l θ ɔ ɹ p
maps	n æ p s
marable	n ɛ ɹ ə b ə l
marathon	m ɛ ɹ ə θ ə n
marathon	m ɛ ɹ ə θ ə m
marathons	m ɛ ɹ ə θ ɑ n z
marble	m ɑ ɹ p ə l
marbling	m ɑ ɹ b ə l i n
marche	m ɑ ɹ ʃ
marching	m ɑ ɹ tʃ ɪ n
marci	m ɑ ɹ s i
marcia	m ɑ ɹ s ə
marcin	m ɑ ɹ s ɪ n
marcinkus	m ɑ ɹ s ɪ ŋ k ə s
marcon	m ɑ ɹ k ə n
marcos	m ɑ ɹ k oʊ z
marden	m ɑ ɹ t ə n
marder	m ɑ ɹ t ɝ
mares	m ɛ ɹ z
margaret's	m ɑ ɹ ɡ ɝ ɪ t s
margareta	m ɑ ɹ ɡ ɝ i t ə
margarete	m ɑ ɹ ɡ ɝ ɪ t
mariachi	m ɛ ɹ i ɑ tʃ i
marianas	m ɑ ɹ i æ n ə s
marijuana	m ɛ ɹ ə w ɑ n ə
marilyn	m ɛ ɹ ə l ɪ n
marilyn	m ɛ ɹ ə l ɪ m
marinas	m ɝ ɪ n ə z
marino	m ɑ ɹ ɪ n oʊ
mariposa	m ɛ ɹ ɪ p oʊ s ə
marital	m ɛ ɹ ɪ t ə l
marius	m ɛ ɹ i ə z
marjorie	m ɑ ɹ dʒ ɝ i
marked	m ɑ ɹ k d
marketed	m ɑ ɹ k ə t ə d
marketer	m ɑ ɹ k ə t ɝ
marketing	m ɑ ɹ k ə t ɪ n
markets	m ɑ ɹ k ə t s
markings	m ɑ ɹ k ɪ n z
marla	m ɑ ɹ l ə
marlene	m ɑ ɹ l i n
marlon	m ɑ ɹ l ə n
marmalade	m ɑ ɹ m ə l eɪ t
marmont	m ɑ ɹ m ə n d
marmosets	m ɑ ɹ m ə s ɛ t s
marnie	m ɑ ɹ n i
maros	m ɑ ɹ oʊ z
marple	m ɑ ɹ b ə l
marquardt	m ɑ ɹ k w ɑ ɹ t
marquis	m ɑ ɹ k w ɪ
marquise	m ɑ ɹ k i s
marrable	m ɛ ɹ ə b ə l
marrakech	m ɑ ɹ ə k æ ʃ
marrow	m æ ɹ oʊ
marschall	m ɑ ɹ ʃ ə l
marsfield	m ɑ ɹ ʃ f i l d
marshal	m ɑ ɹ s ə l
marshes	m ɑ ɹ ʃ ɪ z
marshes	m ɑ ɹ ʃ ɪ ʃ
marsilio	m ɑ ɹ s ɪ l i oʊ
martel	m ɑ ɹ t ɛ l
marthe	m ɑ ɹ θ
martin	m ɑ ɹ t ə n
martin	m ɑ ɹ d ɪ ŋ
martin's	m ɑ ɹ t ə n z
martine	m ɑ ɹ t ɪ n
martinec	m ɑ ɹ t ɪ n æ k
marty	m ɑ ɹ d i
mary's	m ɛ ɹ ɪ s
maryland	m ɛ ɹ i l ə n d
marysville	m ɛ ɹ ɪ z v ɪ l
maryville	m ɛ ɹ i v ɪ l
mascot	m ɛ s k ə t
mascot	m æ s ɡ ɑ t
masefield	m eɪ s f i l d
mason	m eɪ ʃ ə n
mason	m eɪ s ə m
mass	m ʌ s
mass	n æ s
masses	m æ s ə s
massie	m ɛ s i
massif	m æ s ɪ v
master	m æ s t ɹ
masterfully	m æ s t ɝ f l i
mastery	m æ s t ɹ i
masturbatory	m æ s t ɝ b ə t ɔ ɹ i
mat	m æ d
matador	m æ d ə d ɔ ɹ
match	m æ t s
matches	m æ tʃ ɪ s
matching	m æ tʃ ɪ n
mated	m eɪ d ɪ d
mather	m æ θ ɝ
mather's	m æ θ ɝ z
mathilde	m ə t i l d
mathis	n æ θ ɪ s
mating	m eɪ d ɪ ŋ
mating	m eɪ d ɪ n
matlin	m æ d l ɪ n
matt	m æ d
matters	m ɛ t ɝ z
mattie	m æ d i
matty	m æ d i
matzek	m æ t s ɪ k
maurice	m ɔ ɹ ɪ s
max	n æ k s
max	m ɛ k s
maxi	m æ k s ɪ
may	n eɪ
mayer	m eɪ ɹ
mayfield	m eɪ f i l t
mayor	m eɪ ɹ
mayor	m ɛ ɹ
mayor	m eɪ ɚ
maysville	m eɪ s f ɪ l
mazda	m æ s d ə
mazda	m ɑ s t ə
maze	m eɪ s
mcadoo	m ɛ k ə d u
mcbroom	m ə k b ɹ u n
mccaffrey	m ə k æ f ɹ i
mccarey	m ə k ɛ ɹ i
mccarthy's	m ə k ɑ ɹ θ i z
mccarthyism	m ə k ɑ ɹ θ i ɪ z ə m
mccartin	m ə k ɑ ɹ t ə n
mccartney	m ə k ɑ ɹ t n i
mccartney's	m ə k ɑ ɹ t n i z
mccarty	m ə k ɑ ɹ t i
mccarty	m ə k ɑ ɹ d i
mcclory	m ə k l ɔ ɹ i
mcclure	m ə k l ʊ ɹ
mcclurg	m ə k l ɝ k
mcclusky	m ə k l ɑ s k i
mccord	m ə k ɔ ɹ t
mccormack	m ə k ɔ ɹ m ə k
mccormick	m ə k ɔ ɹ m ɪ k
mccort	m ə k ɔ ɹ t
mccourt	m ə k ɔ ɹ t
mccracken	m ə k ɹ æ k ə n
mccrimmon	m ə k ɹ ɪ m ə n
mccrory	m ə k ɹ ɔ ɹ i
mccullough	m ə k ɑ l ə
mccullum	m ə k ʌ l ə n
mcelderry	m æ k ə l d ɪ ɹ i
mcfarland	m ə k f ɑ ɹ l ə n d
mcfarlane	m ə k f ɑ ɹ l ə n
mckeesport	m ə k i s p ɔ ɹ t
mckendree	m ə k ɛ n d ɹ i
mckenna	m ə k æ n ə
mclaren	m ə k l ɛ ɹ ə n
mclaren	m ə ɡ l ɛ ɹ ə n
mclean	m ə ɡ l i n
mcmorran	m ə k m ɔ ɹ ə n
mcnair	m ə k n ɛ ɹ
mcnairy	m ə k n ɛ ɹ i
mcnamara	m æ k n ə m ɛ ɹ ə
mcnary	m ə k n ɛ ɹ i
mcpartlin	m ə k p ɑ ɹ t l ə n
mcpherson	m ə k f ɝ z ə n
me	n
means	m i n s
means	m ɪ n s
meant	m æ n d
mease	m i s
measure	m ɛ ʃ ɝ
measured	m ɛ ʃ ɝ d
measurement	m ɛ z ɝ m ə n t
measures	m ɛ ʃ ɝ z
measuring	m ɛ ʒ ɝ ɪ n
mecca	n æ k ə
mechanisms	m æ k ə n ɪ z ə m z
med	n ɛ d
medal	m ɛ t ə l
medal	m æ d ə l
medals	m ɛ t ə l z
medford	m ɛ d f ɝ t
median	m i d i ə m
medicare	m ɛ d ə k ɛ ɹ
medicine	m æ d ə s ə n
medieval	m ɪ d i i v ə l
meer	m ɪ ɹ
meese	n i s
meet	m i d
meets	n i d z
meg	m æ ɡ
meg	m æ k
megabyzus	m ɛ k ə b aɪ s ə s
megalosaurus	m æ ɡ ə l ə s ɔ ɹ ə s
megan	m æ ɡ ə n
meggs	m æ ɡ s
mehrtens	m ɛ ɹ t ə n z
meinzer	m aɪ n s ɝ
meisner	m aɪ z n ɝ
mel	n ɛ l
melanippe	m ɛ l ə n i p
melas	m ɛ l ə s
melbourne	n ɛ l b ə n
melbourne	m æ l b ɝ n
meld	m ɛ l t
melded	m ɛ l t ɪ d
melding	m ɛ l t ɪ ŋ
melford	m ɛ l f ɝ t
mell	m æ l
melodeon	m ə l oʊ d i ə m
melodic	m ə l ɑ t ɪ k
melt	n ɛ l t
melusine	m ɛ l ə s i n
melville	m ɛ l f ɪ l
melvin	m æ l v ɪ n
melzer	m ɛ l s ɝ
mem	m æ m
members	m ɛ m b ɝ s
members	n ɛ m b ɝ z
memes	m i n z
memo	m æ m oʊ
memorabilia	m ɛ m ɹ ə b ɪ l j ə
memorabilia	m ɛ m ɝ ə b ɪ l j ə
memory	m ɛ m ɝ ɪ
memphis	m ɛ n f ə s
memphis	m ɛ n f ɪ s
men	m æ n
men	n æ n
men's	m ɛ n s
men's	m æ n z
mencken	m ɛ n k ə n
mendelsohn	m æ n d ə l s ə n
mendoza	m ɛ n d oʊ s ə
mendoza	m æ n d oʊ z ə
mendoza's	m ɛ n d oʊ s ə s
mennonites	m æ n ə n aɪ t s
mental	m æ n t ə l
mention	m æ n ʃ ə n
mentor	m æ n t ɝ
mentoring	m æ n t ɝ ɪ ŋ
mentors	m ɛ n t ɔ ɹ z
menus	m æ n j u z
menzies	m ɛ n s i z
menzies	m æ n z i z
merchandise	m ɝ tʃ ə n d aɪ s
mercredi	m ɝ k ɹ ɛ t i
meriden	m ɛ ɹ i d ə n
merrett	m ɛ ɹ ɪ t
merrill	n ɛ ɹ ə l
merrimack	m ɛ ɹ i m æ k
merriman	m ɛ ɹ i m ə n
merriman's	m ɛ ɹ i m ə n z
merryfield	m ɛ ɹ i f i l d
mersey	m ɝ z i
mesh	m æ ʃ
meshed	m æ ʃ t
mesodermal	m ɛ s ə d ɝ m ə l
mesolithic	m ɛ s ə l ɪ θ ɪ k
mesozoic	m ɛ z ə z oʊ ɪ k
mess	m æ s
messiah's	m ə s aɪ ə s
messy	m æ s i
mestre	m ɛ s t ɹ
met	m æ t
meta	m æ t ə
metal	m ɛ d ə l
metal	m æ t ə l
metals	m ɛ d ə l z
metamora	m æ d ə m ɔ ɹ ə
metaphor	m ɛ t ə f ɝ
metaphor	m ɛ d ə f ɔ
metaphor	m ɛ d ə f ɔ ɹ
metastatic	m ɛ d ə s t æ t ɪ k
meteor	m i d i ɝ
meteor	m i d i ɔ
meteorites	m i d i ɝ aɪ t s
meteorologist	m i d i ɝ ɑ l ə dʒ ɪ s t
meteorologists	m i d i ɝ ɑ l ə dʒ ɪ s t s
meteorology	m i d i ɝ ɑ l ə dʒ i
method	m æ θ ə d
methods	m ɛ θ ə t z
metics	m æ t ɪ k s
metra	m ɛ t ɹ ə
metric	m æ t ɹ ɪ k
mets	m æ t s
mettle	m ɛ d ə l
metz	m æ t s
metzger	m ɛ t s k ɝ
metzger	m æ t s k ɝ
mezzanine	m ɛ z ə n ɪ n
mezzanine	m ɛ s ə n i n
miami	m aɪ æ n i
mick	n ɪ k
mickey	m i k i
midcourse	m ɪ d k ɔ ɹ s
middens	m i d ə n z
middens	m ɪ t ə n z
middle	m i d ə l
middle	m ɪ t ə l
middlemiss	m ɪ d ə l n ɪ s
midler	m ɪ t l ɝ
midway	m ɪ t w eɪ
midwives	m ɪ d w aɪ f s
mifflin	m ɪ f l i n
might	m aɪ d
miguel	m ɪ ɡ ɛ l
mila	m i l ə
milam	m ɪ l ə n
mildred	m ɪ l d ɹ ɪ d
milesians	m ɪ l i ʒ ə n z
milford	m ɪ l f ɝ t
militaries	m ɪ l ə t ɛ ɹ i z
mill	m i l
millennium	m ɪ l ɛ n i ə m
miller	m i l ɝ
mills	m ɪ l s
milne	m ɪ l m
milnthorpe	m ɪ l m θ ɔ ɹ p
milpitas	m ɪ l p i d ə s
mima	n i m ə
mimas	m aɪ m ə s
mime	m aɪ n
mimi	m ɪ m i
minami	m ɪ n ɑ m i
minho	m ɪ ŋ h oʊ
mini	m i n i
mining	m aɪ n ɪ n
minister	m ɪ n ə s t ɹ
ministerial	m ɪ n ɪ s t ɪ ɹ i ə l
ministry	m ɪ n ɪ s t ɹ ɪ
mink	m ɪ n k
minors	m aɪ n ɚ s
mints	m ɪ n d s
mir's	m ɪ ɹ z
mirabelle	m ɪ ɹ ə b ɛ l
miramichi	m ɪ ɹ ə m ɪ tʃ i
mire	m aɪ ɝ
miro	m i ɹ oʊ
mirra	m ɪ ɹ ə
mirror	n ɪ ɹ ɝ
mirror	n ɪ ɹ
mirror	m ɪ ɝ
mises	m aɪ s i z
misha	m i ʃ ə
missile	n ɪ s ə l
missouri	m ɪ s ɝ i
missouri	m ɪ s ʊ ɹ i
mistletoe	m i s ə l t oʊ
mistress	m ɪ s t ɹ ə s
mitanni	m ɪ t ɑ n i
mitcham	m ɪ tʃ ə n
mite	m aɪ d
mitra	m i t ɹ ə
mitsubishi	m ɪ t s u p i ʃ i
mixing	m ɪ k s ɪ n
mixing	m ɪ k s i n
mizrahi	m ɪ z ɹ ɑ h i
moated	m oʊ d ɪ d
mob	m ɑ p
mobility	n oʊ b ɪ l ɪ t i
mock	m ʌ k
mod	n ɔ d
modal	m oʊ t ə l
mode	m oʊ t
model	m ɑ t ə l
model	m ʌ d ə l
models	m ʌ d ə l z
models	m ɑ t ə l z
modem	m oʊ t ə m
modernized	m ɑ t ɝ n aɪ z d
moenkopi	m oʊ n k oʊ p i
molasses	m ə l æ s ə s
monaghan	m ɑ n ə h ə n
monarchists	m ɑ n ɑ ɹ k ɪ s t s
monckton	m ɑ ŋ k t ə n
monckton	m ɑ n k t ə n
money	m ɑ n i
monge	m ʌ n dʒ
mongol	m ʌ ŋ ɡ ə l
mongol	m ɑ ŋ k ə l
mongoose	m ɑ ŋ ɡ u z
monkees	m ʌ ŋ k i z
monopolies	m ə n ɑ p ə l ɪ z
monoxide	n ə n ɑ k s aɪ d
monsey	m ɑ n s i
montage	m ɑ n t ɑ ʃ
montezuma	m ɑ n t i z u m ə
montgomery	m ɑ n t ɡ ʌ m ɝ i
month	m ʌ m θ
monza	m ɑ n s ə
moonstruck	m u n s t ɹ ɑ k
moore	m ɔ ɹ
moore's	m ɔ ɹ z
moorefield	m ʊ ɹ f i l d
mooring	m ʊ ɹ ɪ ŋ
moose	m u z
moosic	m u z ɪ k
moot	m u d
mooting	m u d ɪ ŋ
mordecai	m ɔ ɹ t ə k aɪ
mordechai	m ɔ ɹ t ə k aɪ
morial	m ɔ ɹ i ə l
moriarty	m ɔ ɹ i ɑ ɹ d i
morita	m ɔ ɹ i t ə
morkin	m ɔ ɹ k ɪ n
morphed	m ɔ ɹ f t
morphing	m ɔ ɹ f ɪ ŋ
morrell	m ɔ ɹ ɛ l
morris	m ɔ ɹ ə s
morrish	m ɔ ɹ ɪ ʃ
morriss	m ɔ ɹ ɪ s
mortar	m ɔ ɹ d ɝ
mortensen	m ɔ ɹ t ɪ n s ə n
mortier	m ɔ ɹ d i ɝ
mortification	m ɔ ɹ d ə f ə k eɪ ʃ ə n
mortifications	m ɔ ɹ d ə f ə k eɪ ʃ ə n z
mortimer	m ɔ ɹ t ə m ɝ
morty	m ɔ ɹ d i
moscow	m ʌ s k oʊ
moscow's	m ʌ s k oʊ z
moseley	m oʊ s l i
moses	m oʊ z ɪ s
mosiah	m oʊ z aɪ ə
mosman	m ɑ z m ə n
mosquitos	m ə s k i t oʊ z
moss	m ʌ s
mothers	m ʌ ð ə s
moths	m ʌ θ s
motif	m oʊ t ɪ f
motif	m oʊ t ɪ v
motifs	m oʊ t ɪ v s
motifs	m oʊ t i v z
motifs	m oʊ t ɪ v z
motifs	m oʊ t i v s
motifs	m oʊ t ɪ f s
motion	m oʊ s ə m
mottled	m ɑ d ə l d
mould	m oʊ l t
mound	m aʊ n t
mounds	m aʊ n t s
mount	m aʊ n d
mountain	m aʊ n d ə n
mouser	m aʊ s ɝ
mousse	m u z
mouths	m aʊ θ s
movie	m u v ɪ
movie	m u f i
movies	n u v i z
mowed	m oʊ t
mozart	m oʊ s ɑ ɹ t
mu	n u
mud	m ɑ d
mudra	m ʌ d ɹ ə
mueller	m ɑ l ɝ
mugging	m ʌ ɡ i n
muhammad	m u h ɑ m ə d
muhammed	m u h ɑ m ɛ d
muir	m ɪ ɹ
mulatto	m ə l ɑ d oʊ
muldoon	m ɑ l d u n
mullah	m u l ə
multipart	m ʌ l t i p ɑ ɹ t
multiparty	m ʌ l t i p ɑ ɹ t i
multistory	m ʌ l t i s t ɔ ɹ i
mum	m ɑ m
mundella	m ɑ n d ɛ l ə
mundt	m ɑ n t
municipal	m j u n ɪ s ə b ə l
municipium	m j u n ɪ s ɪ p i ə m
munsee	m ɑ n s i
murder	m ɝ t ɝ
murdoch	n ɝ d ɑ k
murray	m ɑ ɹ i
muses	m j u z ɪ s
mushers	m ɑ ʃ ɝ z
musicals	m j u z ɪ k ə l s
musicians	m j u z ɪ s ə n z
musik	m j u z ɪ k
musil	m u s ə l
muskeg	m ʌ s k æ ɡ
muslim	m ʌ s l ə m
muslim	m ɑ s l ə m
muslim	m ʌ z l ə n
muslim	m ɑ z l ə m
muslims	m ʌ s l ə m z
muslims	m ʌ s l ɪ m z
muslin	m ʌ z l ə m
musselman	m ɑ s ə l m ə n
mussolini	m u s ə l i n i
mutineers	m j u t ə n i ɹ z
mutt	m ʌ d
mutt	m ɑ t
mysteries	m ɪ s t ɹ i z
mysteriously	m ɪ s t ɪ ɹ i ə s l i
n	æ n
nada	n ɑ t ə
nadir	n eɪ t ɝ
nairobi	n aɪ ɹ oʊ p i
naked	m eɪ k ə d
name	n eɪ n
names	n eɪ m s
nana's	n æ m ə s
napalm	n eɪ p ɑ n
napier's	n eɪ p ɪ ɝ z
napoleon	n ə b oʊ l i ə n
narcissistic	n ɑ ɹ s ɪ s ɪ s t ɪ k
narcotics	n ɑ ɹ k ɑ d ɪ k s
nares	n ɛ ɹ ɪ s
nares	n ɛ ɹ z
nares	n ɛ ɹ i z
narron	n ɛ ɹ ə n
narses	n ɑ ɹ s ɪ s
narses	n ɑ ɹ s i z
narva	n ɑ ɹ f ə
nasal	n eɪ s ə l
nasby	n æ z b i
nash	n æ s
nasturtium	n ɛ s t ɝ ʃ ə m
natal	n eɪ d ə l
natalie	n æ d ə l i
nathalie	n æ d ə l i
natty's	n ɛ t i z
naturalism	n æ tʃ ɝ ə l ɪ z ə m
naturalistic	n æ tʃ ɝ ə l ɪ s t ɪ k
naturalists	n æ tʃ ɝ ə l ɪ s t s
naturalization	n æ tʃ ɝ ə l ɪ z eɪ ʃ ə n
naturalized	n æ tʃ ɝ ə l aɪ z d
nature	n eɪ tʃ ɚ
nauset	n ɔ s ɪ t
naval	m eɪ v ə l
nave	n eɪ f
navy	n eɪ f i
naxos	n æ k s oʊ s
naylor	m eɪ l ɝ
nazianzen	n æ z i æ n z ə n
nazis	n ɑ t s ɪ s
near	n ɪ ɝ
near	m ɪ ɹ
near	m ɪ
near	n i
nearly	m ɪ ɹ l i
neary	m ɪ ɹ i
neck	m æ k
nederland	m ɪ d ɝ l ə n d
need	n i t
need	m i d
needed	n i t ɪ d
needs	m i d z
needs	n i d s
neely	m i l i
negligence	m ɛ ɡ l ɪ dʒ ə n s
nehru	n ɛ ɹ u
neighboring	n eɪ b ɝ ɪ n
neighbouring	n eɪ b ɝ ɪ n
neil	m i l
neilan	m i l ə n
neill	m i l
nels	n ɛ l s
neon	m i ɑ n
nerissa	n ɝ i s ə
nero's	n i ɹ oʊ z
nesbitt	n ɛ s p ɪ t
nesbitt	n ɛ s b ɪ t
net	m ɛ t
net	n ɛ d
netta	n æ d ə
nette	n ɛ d
nettie	n ɛ d i
nettles	n ɛ d ə l z
netzer	n ɛ t s ɝ
neufeld	n u f ɛ l t
neuse	n u z
neutrons	n u t ɹ ɑ n s
never	n ɛ f ɝ
nevertheless	n ɛ v ɝ θ ə l ɛ s
nevertire	n ɛ v ɝ t aɪ ɝ
new	m u
newark	n u ɹ k
newark	n ʊ ɹ k
newberry	n u b ɛ ɹ ɪ
newer	n u ɹ
newhart	n u h ɑ ɹ t
newington	n u ɪ n t ə n
newmarket	n u m ɑ ɹ k ə t
newspaper	n u s p eɪ p ɝ
newt	n u d
newton	m u t ə n
newton's	m u t ə n z
newydd	n u ɪ d
nibbler	n ɪ p l ɝ
nicaragua	m ɪ k ɝ ɑ ɡ w ə
nice	n aɪ z
niche	n i s
niches	n i ʃ ɪ z
nick	m i k
nick	m ɪ k
nickell	m ɪ k ə l
nicky	m ɪ k i
niece	n i z
niepce	n ɪ p s
nigeria	m aɪ dʒ ɪ ɹ i ə
nightingale	n aɪ t ɪ n ɡ eɪ l
nightmares	n aɪ t m ɛ ɝ z
nikita's	m ɪ k i t ə z
nikita's	n ɪ k i d ə z
nile	m aɪ l
nils	n i l z
nilsen	n i l s ə n
nilsson	n i l s ə n
nimitz	n ɪ m ɪ d s
nina	n ɪ n ə
nineties	n aɪ n d i z
nipawin	n i p ə w ɪ n
nisbett	n ɪ z b ɪ t
nishida	m ɪ ʃ i d ə
nixon	m ɪ k s ə n
nizhny	n ɪ z n i
nodal	n oʊ t ə l
nodder	n ɑ t ɝ
node	n oʊ t
nodes	n oʊ t s
nodes	n oʊ t z
nogo	n oʊ k oʊ
nomadic	n oʊ m æ t ɪ k
nonconformists	n ɑ n k ə n f ɔ ɹ m ə s t s
none	n ɑ n
none	n ʌ m
nonessential	n ɑ n i s ɛ n tʃ ə l
nonetheless	n ʌ n θ ə l ɛ s
nonlinear	n ɑ n l ɪ n i ɹ
nonna	m ɑ n ə
nonprofit	n ɑ n p ɹ ɑ f ə t
nordic	n ɔ ɹ t ɪ k
nordica	n ɔ ɹ t ɪ k ə
nordstrom	n ɔ ɹ d s t ɹ ə m
normality	n ɔ ɹ m æ l ə d i
normanton	n ɔ ɹ m ə ŋ t ə n
norquist	n ɔ ɹ k w ɪ s t
norse	m ɔ ɹ z
north	n ɔ ɹ ð
north	m ɔ ɹ θ
northern	n ɔ ɹ θ ɝ n
northern's	n ɔ ɹ ð ɝ n z
northview	n ɔ ɹ θ v j u
nos	n oʊ s
not	n ɑ d
note	n oʊ d
noted	n oʊ d ə d
notepad	n oʊ t b æ d
notes	n oʊ d z
nothin	n ʌ θ ɪ ŋ
nothing	n ʌ θ ɪ n
notified	n oʊ t ə f aɪ t
notoriously	n ə t ɔ ɹ i ə s l i
notre	n oʊ d ɝ
notre	n oʊ t ɹ
nougat	n ʊ ɡ ə t
novel's	n ɑ v ə l s
novels	n ɑ v ə l s
novels	n ɑ f ə l z
novgorod	n ɑ f ɡ ɝ ɑ d
now	m aʊ
nude	n u t
nudity	n u d ɪ d i
nuer	n u ɝ
number	n ʌ m p ɝ
number	n ʌ m ɝ
numbers	n ʌ m b ɝ s
numeric	n u m ɛ ɹ ɪ k
numerically	n u m ɛ ɹ ɪ k l i
numerous	n u m ɝ ə z
numismatics	n u m ə s m æ t ɪ k s
nun	n ɑ n
nusku	n ɑ s k u
nut	n ɑ d
nutmeg	n ʌ t m æ ɡ
nutt	n ɑ t
nutting	n ʌ d ɪ ŋ
nutty	n ʌ d i
nymph	n ɪ n f
nyssa	n i s ə
o'dowd	oʊ d aʊ t
o'hara	oʊ h æ ɹ ə
oases	oʊ eɪ s ɪ s
oasis	oʊ eɪ s i s
oates	oʊ d z
oba	oʊ p ə
obadiah	oʊ p ə d aɪ ə
obelisk	ɑ p ə l ɪ s k
obesity	ə b ɪ s ə t i
obligated	ɑ p l ə k eɪ t ɪ d
oblique	ə b l ɪ k
obs	ɑ p s
obscenity	ə b s æ n ɪ t i
observations	ɑ b s ɝ v eɪ ʃ ə n z
obsessed	ə p s ɛ s t
obstacle	ɑ p s t ə k ə l
obstetricians	ɑ b s t ə t ɹ ɪ ʃ ə n z
obstetrics	ɑ p s t ɛ t ɹ ɪ k s
obstetrics	ʌ p s t ɛ t ɹ ɪ k s
obverse	ɑ b v ɝ z
occasional	ə k eɪ ʃ ə n ə l
occasions	ə k eɪ ʃ ə n s
oceana	oʊ s i æ n ə
odd	ɑ t
odds	ɑ t s
odeon	oʊ d i ə m
oder	oʊ t ɝ
odyssey	ɑ t ə s i
oedipal	ɛ d ə b ə l
of	ʌ f
of	ɔ f
of	ə f
of	ɑ v
off	ʌ v
off	ʌ f
off	ɔ v
offences	ə f ɛ n s ə s
offered	ɔ f ɝ t
offering	ɔ f ɹ ɪ ŋ
offers	ɔ f ɝ s
office	ɔ f ə z
offices	ɔ f ə s ə s
official	ə v ɪ ʃ ə l
ogg	ɑ k
ogilvy	oʊ ɡ ə l f i
oglesby	oʊ ɡ ə l z b i
oh's	oʊ s
oldham	oʊ l t ə m
olinda	oʊ l ɪ n d ə
on	ʌ n
on	ʌ m
on	ɑ m
on	ɔ m
once	w ʌ n z
one	w ɑ n
onscreen	ɑ n s k ɹ i n
onslow's	ɑ n z l oʊ z
opera	ɑ b ɝ ə
opera	ʌ p ɝ ə
opera's	ɑ p ɝ ə z
operable	ɑ p ɹ ə b ə l
operas	ɑ p ɝ ə z
operate	ʌ p ɝ eɪ t
operate	ɑ p ɹ eɪ t
operate	ʌ p ɹ eɪ t
operated	ʌ p ɝ eɪ t ɪ d
operated	ʌ p ɹ eɪ d ɪ d
operated	ʌ p ɹ eɪ t ɪ d
operates	ɑ p ɹ eɪ t s
operatic	ɑ p ɝ ɛ t ɪ k
operating	ɑ p ɹ eɪ t ɪ ŋ
operating	ɑ p ɝ eɪ t ɪ n
operating	ʌ p ɝ eɪ t ɪ ŋ
operation	ʌ p ɝ eɪ ʃ ə n
operator	ɑ p ɹ eɪ t ɝ
operetta	ɑ p ɝ ɛ d ə
ophthalmic	ɑ p θ ɛ l m ɪ k
opiate	oʊ b i ə t
opry	ɑ p ɝ i
or	ɹ
orbiting	ɔ ɹ b ə t i ŋ
order	ɔ ɹ ɾ ɝ
orders	ɔ d ə s
oregon	ɔ ɹ ɪ ɡ ə m
org	ɔ ɹ k
organelle	ɔ ɹ ɡ ə n æ l
orient	ɔ ɹ i æ n t
orient	ɔ ɹ i ɛ n d
oriented	ɔ ɹ i ɛ n t ə d
original	ɚ ɪ dʒ ə n ə l
orin	ɔ ɹ i n
orix	ɔ ɹ ɪ k s
orthodontic	ɔ ɹ θ ə d ɑ n t ɪ k
orthogonal	ɔ ɹ θ ɑ k ə n ə l
ortiz	ɔ ɹ t ɪ z
orwell's	ɔ ɹ w ɛ l z
os	ɑ z
oscar	ɑ s k ɝ
osgood	ɑ z ɡ ʊ d
osgoode	ɑ z ɡ ʊ d
osler's	ɑ z l ɝ z
oslo	ɑ s l oʊ
osman	ɑ z m ə n
osment	ɑ z m ə n d
osmond	ɑ z m ə n d
osmotic	ɑ s m ɑ d ɪ k
osric	ɑ s ɹ ɪ k
oswego	ɑ z w i ɡ oʊ
oswin	ɑ z w ɪ n
ota	oʊ d ə
other	ɑ ð ɝ
other	ɑ θ ɝ
others	ɑ ð ɝ z
otter	ɑ d ɝ
otters	ɑ d ɝ z
ottershaw	ɑ d ɝ ʃ ɔ
otto	ɑ d oʊ
ottoman	ɑ d ə m ə n
our	aʊ ɝ
ourself	ɑ ɹ s ɛ l v
outbid	aʊ t b ɪ t
outfield	aʊ t f ɪ l d
output	aʊ t p ʊ d
outside	aʊ t s aɪ t
over	oʊ v ɚ
over	oʊ f ɝ
overhead	oʊ f ɝ h ɛ d
overridden	oʊ v ɝ ɹ ɪ t ə n
overrides	oʊ v ɝ ɹ aɪ t s
overseer	oʊ v ɝ s i ɹ
overtime	oʊ v ɝ t aɪ n
ovid	oʊ v i d
ovid	oʊ v ɪ t
ownership	oʊ n ɝ s ɪ p
oz	ɑ s
ozark	oʊ s ɑ ɹ k
ozone	oʊ s oʊ n
p	b i
pablo	p ɑ p l oʊ
pabst	p æ p s t
pace	b eɪ s
pacifist	p æ s ɪ v ɪ s t
pack	b æ k
packaging	p æ k ɪ dʒ ɪ n
packer	p ɛ k ɝ
packet	b æ k ɪ t
packets	p æ k ɪ t z
packs	b æ k s
packs	p ɛ k s
pad	p æ t
pad	b æ d
padda	b æ d ə
padding	p æ t ɪ ŋ
paddington	p æ t ɪ ŋ t ə n
paddle	p æ t ə l
paddy	p æ t i
paddy	p ɛ d i
paddy	b ɛ t i
paddy's	p æ t i z
pads	p ɛ d s
paducah	p ə t u k ə
pages	b eɪ dʒ ɪ s
pages	p eɪ dʒ i z
paglia	p ɛ ɡ l i ə
pagodas	b ə ɡ oʊ d ə z
paid	b eɪ d
pains	p eɪ n s
painters	p eɪ n t ɝ s
paisley	p eɪ s l i
palace	p æ l i s
palace	p ɛ l ə s
palatal	p æ l ə d ə l
palazzo	p ə l ɑ s oʊ
palsy	p ɔ l s i
pam	p æ n
pampanga	p æ m p æ n ɡ ə
pamphleteer	p æ m f l ə t i ɹ
pan	p ɛ n
panay	p ɛ n eɪ
pancreatic	p æ ŋ k ɹ i æ t ɪ k
pandora	p ɛ n d ɔ ɹ ə
panel	p ɛ n ə l
panel	b æ n ə l
panels	b æ n ə l z
panhandle	p æ n h æ n t ə l
panna	p ɛ n ə
panned	p ɛ n d
panora	p ə n ɔ ɹ ə
pans	p æ n s
pantograph	p æ n t ə k ɹ æ f
panzer	p æ n s ɝ
papas	p ɑ p ə s
papayas	p ə p aɪ ə s
papineau	p æ p i n oʊ
paprika	p æ b ɹ i k ə
paracelsus	p ɛ ɹ ə s ɛ l s ə s
parachuted	p ɛ ɹ ə ʃ u t ɪ d
parachuting	p ɛ ɹ ə ʃ u t ɪ ŋ
parade	p ɹ eɪ d
paradigm	p ɛ ɹ ə d aɪ n
paralinguistic	p ɛ ɹ ə l ɪ ŋ ɡ w ɪ s t ɪ k
paralympic	p ɛ ɹ ə l ɪ m p ɪ k
paramedic	p ɛ ɹ ə m ɛ t ɪ k
paramedic	p ɛ ɹ ə m æ t ɪ k
paramedics	p ɛ ɹ ə m ɛ t ɪ k s
parametric	p ɛ ɹ ə m ɛ t ɹ ɪ k
paramilitaries	p ɛ ɹ ə m ɪ l ə t ɛ ɹ i z
paranormal	p ɛ ɹ ə n ɔ ɹ m ə l
parapet	p ɛ ɹ ə p ɪ t
paratrooper	p ɛ ɹ ə t ɹ u p ɝ
paratroopers	p ɛ ɹ ə t ɹ u p ɝ z
paratus	b ɹ æ d ə s
parc	p ɑ ɹ ɡ
parenthesis	p ɝ ɛ n θ ə s i z
parenthetically	p ɛ ɹ ə n θ ɛ t ɪ k l i
parenting	p ɛ ɹ ə n t ɪ ŋ
parents	b ɛ ɹ ə n t s
paris	p ɛ ɹ ə s
paris	p ɛ ɹ ɪ ʃ
parishes	p ɛ ɹ ɪ ʃ ɪ z
parishes	b ɛ ɹ ɪ s ɪ z
parisian	p ɝ i ʒ ə n
parity	p ɛ ɹ ə d i
park	b ɑ ɹ k
parker	b ɑ ɹ k ɝ
parking	p ɑ ɹ k ɪ n
parking	b ɑ ɹ k ɪ ŋ
parkland	p ɑ ɹ k l æ n d
parliamentary	p ɑ ɹ l ə m ɛ n t ɝ i
parliamentary	p ɑ ɹ l ə m ɛ n t ɹ i
parlier	p ɑ ɹ l i ɝ
parma	b ɑ ɹ m ə
parody	p ɛ ɹ ə t i
parramatta	p ɛ ɹ ə m ɑ t ə
parrish	p æ ɹ ɪ ʃ
parry	b ɛ ɹ i
parser	p ɑ ɹ s ɝ
parshall	p ɑ ɹ ʃ ə l
parsing	p ɑ ɹ s ɪ n
part	b ɑ ɹ t
part	b ʌ t
part	b ɑ ɹ d
parted	p ɑ ɹ t ɪ t
partial	b ɑ ʃ ə l
partial	p ɑ ɹ s ə l
partially	p ɑ ɹ ʃ l i
participatory	p ɑ ɹ t ɪ s ə p ə t ɔ ɹ i
particulates	p ɑ ɹ t ɪ k j ə l ə t s
parties	b ɑ t i z
parties	b ɑ ɹ t i z
parties	p ɑ ɹ d i z
parties	b ɑ d i z
partisan	p ɑ ɹ t ə s ə n
partnering	p ɑ ɹ t n ɝ ɪ ŋ
partnership	b ɑ ɹ t n ɝ ʃ ɪ p
parts	b ɑ t s
parts	b ɑ ɹ t s
party	b ɑ ɹ t i
party	p ɑ ɹ d i
party	p ɑ ɹ t ɪ
party	b ʌ d i
party	b ɑ d i
party's	p ɑ ɹ t ɪ s
partying	p ɑ ɹ t i ɪ ŋ
pasadena	p ɛ s ə d i n ə
pascagoula	p æ ʃ k ə ɡ u l ə
pascal	p æ s k ɛ l
pasig	p æ s ɪ k
pass	b æ s
pass	b ʌ s
passage	b æ s ɪ dʒ
passed	b æ s t
passed	p ɑ z t
passerine	p æ s ɝ ɪ ŋ
passes	p æ s ɪ s
passing	b ʌ s ɪ ŋ
passing	b æ s ɪ ŋ
passing	p æ s ɪ n
passive	p æ s ɪ f
passwords	p æ s w ɝ t z
past	b ɑ s t
past	b æ s t
past	b ɛ s t
pasta	b ɑ s t ə
pasta	b æ s t ə
pastoral	p ɛ s t ɔ ɹ ə l
pasture	b æ s tʃ ɝ
pasture	p æ s t ɝ
pat	b ɛ t
patas	p æ t ə s
patch	b æ tʃ
patched	p ɛ tʃ t
patent	b æ t ə n t
patent	b ɛ t ə n t
paterson	b ɛ t ɝ s ə n
paterson	b æ t ɝ s ə n
path	b æ θ
paths	p æ θ z
patio	p æ d i oʊ
patrice	p ə t ɹ ɪ s
patricks	p æ t ɹ ɪ k s
pattern	b æ t ɝ n
patterning	p æ t ɝ n ɪ n
patti	p æ d i
patti	b æ t i
patties	p æ d i z
patton	b ɛ d ə n
patty	p æ d i
patty's	p æ d i z
paul	b ɔ l
pave	p eɪ f
pay	b eɪ
paying	b eɪ ɪ ŋ
payload	p eɪ l oʊ t
payson	p eɪ s ə n
peabody	p i b ə t i
peace	b i s
peach	b i tʃ
peach	p ɪ tʃ
peak	b i k
peak	p ɪ ɡ
peaks	p ɪ k s
peaks	b i k s
pean	p ɪ n
pearce	p ɪ ɹ s
pearl	b ɝ l
pearson	b ɪ ɹ s ə n
peary	p ɪ ɹ i
peas	p i s
pebble	b ɛ b ə l
pedagogical	p ɛ t ə ɡ ɑ dʒ ɪ k ə l
pedagogics	p ɛ t ə ɡ ɑ dʒ ɪ k s
pedagogy	p ɛ t ə ɡ oʊ dʒ i
pedagogy	p ɛ t ə ɡ ɑ dʒ i
pedal	p ɛ t ə l
pedal	p æ d ə l
pedal	p æ t ə l
pedal	b æ d ə l
peddie	p æ d i
peddie	p ɛ t i
pedersen	p ɛ t ɝ s ə n
pedersen	p æ t ɝ s ə n
pederson	p ɛ t ɝ s ə n
pediatric	p i d i æ t ɹ ɪ k
pediatricians	p i d i ə t ɹ ɪ ʃ ə n z
pediatrics	p ɪ d i æ t ɹ ɪ k s
pedophilia	p ɛ t ə f ɪ l i ə
peebles	p i p ə l z
peek	p i ɡ
peer	p i ɹ
peering	p ɪ ɹ ɪ ŋ
peers	b ɪ ɹ z
peery	p ɪ ɹ i
peg	p æ ɡ
pegasus	p ɛ k ə s ə s
pegs	p æ ɡ z
pellet	p æ l ə t
pelvis	p æ l v ə s
pen	p æ n
penang	p ɛ n æ n
peng	p æ ŋ
pengilly	p ɛ n ɡ ə l i
penicillin	p ɛ n ə s ɪ l ə m
penk	p ɛ n k
penn	p æ n
penned	p æ n d
penny	b ɛ n i
penny	p æ n i
penology	p ɪ n ɑ l ə dʒ i
pens	b ɛ n s
pentagon	p æ n t ə ɡ ɑ n
penthesilea	p æ n θ ə s ɪ l i ə
penza	b ɛ n s ə
penzance	p ɛ n z æ n z
penzance	p ɛ n s ə n s
peppercorn	p ɛ p ɝ k ɔ ɹ n
per	p ɚ
perahu	p ɝ ɑ h u
peralta	b ɝ ɑ l t ə
percussive	p ɝ k ʌ s ɪ v
percy's	p ɝ s ɪ z
perdiccas	p ɝ d i k ə s
perelman	p ɛ ɹ ə l m ə n
perera	p ɝ ɛ ɹ ə
performa	p ɝ f ɔ ɹ m ə
performances	p ɚ f ɔ ɹ m ə n s ɪ z
performers	p ɝ f ɔ ɹ m ɝ s
performing	p ɝ f ɔ ɹ m ɪ n
peril	b ɛ ɹ ə l
periodontal	p ɛ ɹ i ə d ɑ n t ə l
periods	p ɪ ɹ i ə d z
peripherals	p ɹ i f ɹ ə l s
pernice	p ɝ n i s
perrin	b ɛ ɹ ɪ ŋ
perry	b ɛ ɹ ɪ
persephone	p ɝ s ɛ f ə n i
persian	p ɝ ʃ ə n
persians	p ɝ ʃ ə n z
persic	p ɝ ʒ ɪ k
personnel	p ɝ s ə n æ l
pesce	p æ ʃ
peshawar	p æ ʃ ə w ɑ ɹ
pesky	p æ s k i
pest	p æ s t
pet	p æ t
pet	p æ d
pet	b ɛ t
petal	p ɛ d ə l
petals	p ɛ d ə l z
petals	p æ t ə l z
petals	b ɛ t ə l z
peter	b i t ə
peter	b i d ɝ
peter	b ɪ d ə
petey	p i d i
petit	b ə t i
petit	b ə t i t
petit	p ɛ d ɪ
petr	p ɛ t ɹ
petre	p ɛ t ɹ
petrels	p ɛ t ɹ ə l s
petrie	p ɛ t ɹ i
petro	b ɛ t ɹ oʊ
petroleum	p ə t ɹ oʊ l i ə n
petry	p æ t ɹ i
pets	p æ t s
pets	b ɛ t s
pettibone	p ɛ t i b oʊ n
petz	p æ t s
peyton	b eɪ t ə n
phair	f ɛ ɹ
phantom	f æ n ə n
pharmaceuticals	f ɑ ɹ m ə s u t ɪ k ə l z
pharnaces	f ɑ ɹ n ə s i z
phase	f eɪ s
phased	f eɪ s d
phased	f eɪ s t
phases	f eɪ s ɪ z
phill	f i l
phillies	f ɪ l i s
phillippe	f ɪ l i p
philomena	v ɪ l ə m i n ə
phinis	f ɪ n ɪ s
phlegmatic	f l æ ɡ m æ t ɪ k
phocas	f oʊ k ə s
phone	f oʊ m
phonemic	f ə n ɪ m ɪ k
phonetically	f ə n æ t ɪ k l i
phosphor	f ɑ s f ɝ
phosphors	f ɑ s f ɔ ɹ z
phosphorus	f ɑ s f ɹ ə s
photius	f oʊ d i ə s
photo	f oʊ d oʊ
physicians	f ə z ɪ ʒ ə n z
physics	f ɪ ʃ ɪ k s
physiology	f ɪ s i ɑ l ə dʒ i
pianist	b i ə n ɪ s t
piastre	p i ɛ s t ɹ
piazza	p i ɑ s ə
picard	p i k ɑ ɹ d
picardie	b ɪ k ɑ ɹ d i
picardy	p ɪ k ɑ ɹ t i
piccola	p ɪ k oʊ l ə
pick	b ɪ k
pick	p ɪ ɡ
pickerel	p ɪ k ɹ ə l
picking	p i k ɪ n
pickpockets	p ɪ k b ʌ k ə t s
pico's	p ɪ k oʊ z
picture	p ɪ tʃ ɝ
piece	p i z
pieces	p ɪ s ɪ z
piedmont	p i t m ɑ n t
pierce	p ɪ ɹ z
pierre	b ɪ ɹ
piers	p ɪ ɹ s
piersall	p ɪ ɹ s ə l
pietre	p i t ɹ
pig	p ɪ k
piggery	p ɪ k ɝ i
piggott	b ɪ ɡ ə t
piglet	p ɪ ɡ l ɪ d
pigot's	p ɪ k ə t s
pilsen	b ɪ l s ə n
pimlico	p ɪ m l ɪ k oʊ
pinchas	p ɪ n tʃ ə s
ping	p ɪ n
pinkham	p ɪ ŋ k ə n
pinned	p ɪ n t
pintado	p ɪ n t ɑ d oʊ
pinto	b ɪ n t oʊ
piotr	p i oʊ t ɝ
pipes	p aɪ b s
piquet	p ɪ k eɪ
piquet	b ɪ k ɛ t
pisa	p i z ə
pisco	p i s k oʊ
pisgah	p ɪ s k ə
pisiform	p ɪ s ə f ɔ ɹ m
pita	p i d ə
pitch	p i tʃ
pitch	b ɪ tʃ
pitches	b ɪ tʃ ɪ z
pits	b ɪ t s
pitter	p i t ɝ
pittsburgh	p i t s b ɝ ɡ
pituitary	p ə t u ə t ɛ ɹ i
pixar	p ɪ k s ɑ ɹ
placating	p l eɪ k eɪ d ɪ ŋ
place	p l eɪ z
place	b l eɪ s
placid	p l æ s ɪ t
plague	p l æ ɡ
plagued	p l eɪ ɡ t
plaid	p l ɛ d
plains	p l eɪ n s
plains	p l eɪ m z
plaintiffs	p l eɪ n ɪ v s
plan	b l æ n
plan	b l æ m
planetarium	p l æ n ɪ t ɛ ɹ i ə m
plank	b l æ ŋ k
planning	p l æ n ɪ n
plans	p l æ n s
plant	p l æ n d
plante	p l ɛ n t
plante	p l ɛ n t i
planted	p l ɛ n t ɪ d
planting	p l æ n t i n
plants	p l æ n t z
plaque	b l æ k
plaque	p l ʌ k
plasma	p l æ s m ə
plasmon	p l æ s m ə n
plaster	b l æ s t ɝ
plasterwork	b l æ s t ɝ w ɝ k
plating	p l eɪ t ɪ n
platinum	p l æ t ə n ə n
play	b l eɪ
played	p l eɪ t
player	p l eɪ ɹ
players	p l eɪ ɚ z
players	b l eɪ ɹ z
playing	p l eɪ ɪ n
plays	p l eɪ s
plaza	p l ɑ s ə
plea	p l ɪ
plead	p l i t
pleasure	p l ɛ ʃ ɝ
pleated	p l i d ɪ d
plebiscite	p l æ b ə s aɪ t
plectrum	p l æ k t ɹ ə m
pleistocene	p l ɪ s t ə s i n
plena	p l æ n ə
plenipotentiary	p l ɛ n i p ə t ɛ n tʃ ɝ i
plenum	p l æ n ə m
plop	p l ʌ p
plot	b l ɑ t
plots	b l ɑ t s
plots	p l ɑ t z
plug	b l ɑ k
plugged	p l ʌ ɡ t
plugin	p l ʌ ɡ ɪ ŋ
plush	p l ʌ s
plywood	b l aɪ w ʊ d
pod	p ɑ t
poetical	p oʊ æ t ɪ k ə l
polar	p oʊ l ɹ
polarity	p ə l ɛ ɹ ɪ t i
polarized	b oʊ l ɝ aɪ z d
pole	b oʊ l
police	p ə l i z
polished	p ɑ l ɪ s t
polity	p ɑ l ə d i
pollack	b ɑ l ə k
polling	p oʊ l ɪ n
polling	p oʊ l i n
pollinia	p oʊ l ɪ n i ə
polls	p oʊ l s
polyethylene	p ɑ l i æ θ ə l i n
polyhedron	p ɑ l i h i d ɹ ə n
polymer	p ɑ l ɪ m ɝ
polymer	p ɑ l i m ɝ
polymers	p ɑ l i m ɝ z
polymorph	p ɑ l i m ɔ ɹ f
polyphonic	p ɑ l i f ɑ n ɪ k
pomfret	p ɑ m f ɹ ɪ t
ponce	b ʌ n s
ponchatoula	p ʌ n tʃ ə t u l ə
pond	b ʌ n t
pond	p ɑ n t
ponkapoag	p ɑ ŋ k ə p oʊ k
pons	p ɑ n s
ponsonby	p ɑ n s ə m b i
pont	b ɑ n t
poodle	p u t ə l
pool	p ʊ l
pooled	p ʊ l d
poor	p ɔ
pop	p ʌ p
porcelain	p ɔ ɹ s ə l i n
porches	b ɔ ɹ tʃ ɪ z
port	b ɔ ɹ t
port	p ɔ ɹ d
port	b ɔ ɹ d
portage	b ɔ ɹ t ɪ dʒ
portalegre	p ɔ ɹ t ə l ɛ ɡ ɹ
ported	p ɔ ɹ d ɪ d
portico	p ɔ ɹ t ɪ k oʊ
ports	b ɔ d z
portugal	p ɔ ɹ tʃ ə k ə l
portuguese	p ɔ ɹ tʃ ə k i z
pose	p oʊ s
pose	b oʊ z
posey	p oʊ s i
posidonius	p oʊ s ɪ d oʊ n i ə s
positioning	p ə s ɪ ʃ ə n ɪ ŋ
positive	p ɑ z ə t i v
poss	p ɔ z
possessives	p ə s ɛ s ɪ f s
postcards	p oʊ s t k ɑ ɹ t z
posterior	p ɑ s t ɪ ɹ i ɝ
postern	p ɑ s t ɝ n
posture	b ʌ s tʃ ɝ
pot	b ʌ t
pot	b ɑ t
potable	p oʊ t ə p ə l
potassium	p ə t æ ʃ i ə m
pots	b ɑ t s
potter	p ɑ d ɝ
potteries	p ɑ t ɹ i z
potters	p ɑ d ɝ z
pottery	p ɑ d ɝ i
pottery	p ɑ t ɹ i
potty	p ɑ d i
pounce	p aʊ n z
power	p aʊ ɹ
powered	b aʊ ɝ d
powers	b aʊ ɝ z
powhatan	b aʊ h æ t ə n
pox	b ɑ k s
practice	b ɹ ɛ k t ə s
practice	p ɹ æ k t ə z
practice	p ɹ æ k t i s
practiced	p ɹ æ k t ə z d
practiced	p ɹ æ k t ə z t
practiced	p ɹ æ k t ə s d
practices	p ɹ æ k t ɪ s ɪ s
practices	p ɹ æ k t ə z ə z
practicing	p ɹ æ k t ə z ɪ ŋ
practising	p ɹ æ k t ə s ɪ ŋ
prada	p ɹ ɑ t ə
pradesh	p ɹ ə d ɛ ʃ
prado	p ɹ ɑ t oʊ
pragmatic	p ɹ ɛ ɡ m æ t ɪ k
prairie	p ɝ ɛ ɹ i
prancing	b ɹ æ n s ɪ ŋ
prat	b ɹ æ d
prater	p ɹ eɪ d ɝ
pratt	p ɹ ɛ t
pratte	p ɹ æ t
prattville	b ɹ æ d v ɪ l
pravda	p ɹ ɑ f t ə
prawn	b ɹ ɔ n
prayer	b ɹ eɪ ɝ
preakness	p ɹ i k n ə s
precambrian	p ɹ i k æ m b ɹ i ə n
precarious	p ɹ i k ɛ ɹ i ə s
preceded	p ɹ i s i d ə d
preceded	p ɹ ɪ s i d ə d
precedent	p ɹ ɛ z ə d ə n t
precedent	p ɹ ɛ z ɪ d ə n t
precedes	p ɹ i s i d z
preceptor	p ɹ ɪ s ɛ p t ɝ
precinct	p ɹ i s ɪ ŋ k
precincts	p ɹ i s ɪ ŋ k t s
precise	p ɹ i s aɪ z
precluded	p ɹ i k l u d ɪ d
precocious	p ɹ ɪ k oʊ ʃ ə s
precondition	p ɹ i k ə n d ɪ ʃ ə n
predecessor	p ɹ i d ə s ɛ s ɝ
predecessor	p ɹ ɛ t ə s ɛ s ɝ
predetermined	p ɹ i d ɪ t ɝ m ə n d
predictability	p ɹ ɪ d ɪ k t ə b ɪ l ɪ t i
predictions	p ɹ ɪ d ɪ k ʃ ə n z
predictors	p ɹ ɪ d ɪ k t ɝ z
predominance	p ɹ i d ɑ m ə n ə n s
predominant	p ɹ i d ɑ m ə n ə n t
predominantly	p ɹ i d ɑ m ə n ə n t l i
predominately	p ɹ ɪ d ɑ m ə n ə n t l i
predominates	p ɹ i d ɑ m ə n eɪ t s
preelection	p ɹ i ɪ l ɛ k ʃ ə n
preestablished	p ɹ i i s t æ b l ɪ ʃ t
prefab	b ɹ i f æ b
prefabs	p ɹ i f ɛ b z
prefecture	p ɹ ɪ f ɛ k tʃ ɝ
prefer	p ɹ i f ɝ
preferable	p ɹ ɛ f ɝ ə b ə l
preferably	p ɹ ɛ f ɝ ə b l i
preference	p ɹ ɛ v ɹ ə n s
preferences	p ɹ ɛ f ɹ ə n s ɪ z
preferred	p ɹ i f ɝ d
prefrontal	p ɹ i f ɹ ʌ n t ə l
premadasa	p ɹ i m ə d ɑ s ə
premier	p ɹ i m ɪ ɹ
premier	p ɹ i m i ɹ
premier	p ɹ ɪ m ɪ ɹ
premier	p ɹ i m i ɝ
premier	p ɹ ɪ m i ɹ
premium	p ɹ i m i ə n
premonition	p ɹ i m ə n ɪ ʃ ə n
prenzlau	b ɹ ɛ n z l aʊ
prep	p ɹ æ p
preparatory	p ɹ ɛ p ɝ ə t ɔ ɹ i
preponderance	p ɹ i p ɑ n d ɝ ə n s
preposterous	p ɹ i p ɑ s t ɝ ə s
prerecorded	p ɹ i ɹ ɪ k ɔ ɹ d ɪ d
preschool	p ɹ i s k u l
preschoolers	p ɹ i s k u l ɝ z
preschools	p ɹ i s k u l z
prescribed	p ɹ ɪ s k ɹ aɪ b d
prescriptive	p ɹ i s k ɹ ɪ p t ɪ v
preseason	p ɹ i s i z ə n
presence	p ɹ ɛ s ə n s
present	p ɹ i s ɛ n t
presented	p ɹ i z ɛ n ə d
presented	p ɹ i z ɛ n t ə d
presented	p ɹ i z ɛ n t ɪ d
presented	p ɹ i z ɛ n d ə d
presenter	p ɹ i z ɛ n t ɝ
presenter	p ɹ ɪ z ɛ n t ɝ
presenters	p ɹ i z ɛ n t ɝ z
presenters	p ɹ ɪ z ɛ n t ɝ z
presenting	p ɹ ɪ z ɛ n t ɪ ŋ
preservation	p ɹ ɛ s ɝ v eɪ ʃ ə n
preset	p ɹ i s ɛ t
preside	p ɹ i s aɪ d
preside	p ɹ ɪ z aɪ d
presided	p ɹ ɪ z aɪ d ɪ d
presided	p ɹ i s aɪ d ɪ d
presidencies	p ɹ ɛ z ɪ d ə n s i z
presidency	p ɹ ɛ s ə d ə n s i
president	p ɹ ɛ s ɪ d ə n t
presides	p ɹ ɪ z aɪ d z
presiding	p ɹ ɪ z aɪ d ɪ ŋ
presiding	p ɹ i s aɪ d ɪ ŋ
presley's	p ɹ ɛ s l i z
press's	p ɹ ɛ s ɪ z
pressler	b ɹ ɛ s l ɝ
pressure	p ɹ ɛ s ɝ
prestigious	p ɹ ɛ s d ɪ dʒ ə s
preston	p ɹ ɛ s t ə m
preston	b ɹ ɛ s t ə n
preteens	p ɹ i t i n z
pretoria	p ɹ ɪ t ɔ ɹ i ə
preuss's	p ɹ u z ɪ z
prevailed	p ɹ i f eɪ l d
prevented	p ɹ i v ɛ n ɪ d
previewed	p ɹ i v j u d
previewing	p ɹ i v j u ɪ ŋ
previews	p ɹ i v j u z
previous	p ɹ i f i ə s
prewitt	p ɹ u ɪ t
prichard	b ɹ ɪ tʃ ɝ d
priddy	p ɹ ɪ t i
pride	b ɹ aɪ d
pride	p ɹ aɪ t
prideaux	p ɹ i d oʊ
priestly	p ɹ ɪ s t l i
prim's	p ɹ ɪ m z
primitive	p ɹ ɪ m ə t ɪ v
primitive	p ɝ ɪ m ə t ɪ v
primitivistic	p ɹ ɪ m ɪ t ɪ v ɪ s t ɪ k
prince	b ɹ ɪ n s
prince	p ɹ ɪ n z
princes	p ɹ ɪ n s ɪ s
princess	p ɹ ɪ n s ɛ z
princesses	p ɹ ɪ n s ɛ s ɪ z
pringle	b ɹ ɪ ŋ ɡ ə l
prins	p ɹ ɪ n s
printers	p ɹ ɪ n ɝ z
printing	p ɹ ɪ n ɪ ŋ
prinz	p ɹ ɪ n s
prinz	p ɹ i n z
priors	b ɹ aɪ ɝ z
priory	p ɹ aɪ ɚ i
prisk	p ɹ ɪ s k
prisms	p ɹ ɪ z ə n z
prison	p ɹ i z ə n
prison	p ɹ ɪ ʒ ə n
prison	b ɹ ɪ s ə n
prison	p ɹ i z ə m
prison	p ɹ ɪ s ə n
prisoner	p ɹ ɪ s ə n ɝ
pritzker	p ɹ ɪ t s k ɝ
private	b ɹ aɪ v ə t
privateering	p ɹ aɪ f ə t ɪ ɹ ɪ ŋ
privy	p ɹ i v i
prix	p ɹ ɪ
prize	p ɹ aɪ s
prized	p ɹ aɪ s t
prizes	p ɹ aɪ s ɪ z
probability	p ɹ ɑ b ə b ɪ l ə t i
problematic	p ɹ ɑ p l ə m æ t ɪ k
proceeds	p ɹ oʊ s i d s
processes	p ɹ ɑ s ɛ s i z
processes	p ɹ ɑ s ɛ s ɪ s
processing	p ɹ ɑ s ɛ s i n
processor	p ɹ ɑ s ɛ s ɝ
processor's	p ɹ ɑ s ɛ s ɝ z
prod	p ɹ ɑ t
produce	p ɹ ə t u s
product's	p ɹ ɑ d ə k t s
production's	p ɹ ə d ʌ k ʃ ə n z
products	p ɹ ɑ d ə k s
professionals	p ɹ ə f ɛ ʃ ə n ə l s
professorships	p ɹ ə f ɛ ʃ ɝ ʃ ɪ p s
profitably	p ɹ ɑ f ə t ə b l i
programmes	b ɹ oʊ ɡ ɹ æ m z
programming	p ɹ oʊ ɡ ɹ æ m ɪ n
promised	p ɹ ɑ m ə s d
promising	p ɹ ɑ m ə s ɪ ŋ
promos	p ɹ oʊ m oʊ s
prompting	p ɹ ɑ m p t ɪ n
promptly	p ɹ ɑ m p l i
prompts	p ɹ ɑ m p t s
proof	p ɹ u v
property	p ɹ ɑ p ɝ ɾ i
propp	p ɹ ɑ p
prosecute	p ɹ ɑ s ə k j u t
prosody	p ɹ ɑ s ə t i
prospector	p ɹ ɑ s p ɛ k t ɝ
prosperity	p ɹ ɑ s p ɛ ɹ ə t i
prost	p ɹ ɑ s t
prosthetics	p ɹ ɑ s θ ɛ t ɪ k s
protection	p ɹ ə t ɛ k s ə n
protectionism	p ɹ ə t ɛ k ʃ ə n ɪ z ə m
protectionist	p ɹ ə t ɛ k ʃ ə n ɪ s t
protections	p ɹ ə t ɛ k ʃ ə n z
protests	p ɹ ə t ɛ s
proteus	p ɹ oʊ d i ə s
proud	b ɹ aʊ d
prove	p ɹ u f
provide	p ɹ ə f aɪ d
provides	p ɹ ə v aɪ d s
province	p ɹ ɑ f ə n s
province's	p ɹ ɑ v ə n s ɪ z
provincial	p ɹ ə v ɪ n s ə l
provisional	p ɹ ə f ɪ ʃ ə n ə l
prowse	b ɹ aʊ z
proximal	p ɹ ɑ k s ə m ə l
pruned	p ɹ u m d
psalms	s ɑ m s
pseudonym	s u t ə n ɪ m
psychical	s aɪ k i k ə l
pub	p ʌ p
pub	p ɑ p
pub	p ɑ b
pubescent	p j u b ɛ s ə n t
public	p ɑ b l ɪ k
publicist	p ʌ b l ɪ ʃ ɪ s t
publish	p ɑ b l ɪ ʃ
publishing	p ʌ b l ɪ ʃ ɪ n
pubs	p ɑ b z
puck	p ɑ k
pudding	p u d ɪ n
pudding	p ʊ t ɪ ŋ
puddle	p ʌ t ə l
puerto	p ɔ ɹ t ɝ
puerto	p ɔ ɹ t ə
puffer	p ɑ v ɝ
pulled	p u l d
pulling	p u l ɪ ŋ
pulls	p ʊ l s
pulse	p ʊ l z
pumas	p u m ə s
pummels	p ɑ m ə l z
pumping	p ʌ m p ɪ n
pumps	b ʌ m p s
pun	p ɑ n
punch	p ɑ n tʃ
pundit	p ɑ n d ɪ t
punitive	p j u n ə d ɪ v
punk	b ʌ ŋ k
puns	p ɑ n z
punt	p ɑ n t
punts	p ɑ n t s
puppetry	p ʌ p ə t ɹ i
pure	p j ɝ
pursue	p ɝ ʃ u
pursued	b ɝ s u d
purves	p ɝ f s
purview	p ɝ f j u
pusher	p u ʃ ɝ
putney	p ɑ d n i
puts	p u t s
putting	p u t ɪ ŋ
puzzle	p ʌ s ə l
puzzle	b ʌ z ə l
pylos	p aɪ l oʊ z
pym	p ɪ n
qatar	k ʌ t ɝ
quadrangles	k w ɑ d ɝ æ ŋ ɡ ə l z
quadratic	k w ɑ d ɹ ɛ t ɪ k
quadrilateral	k w ɑ d ɹ ə l æ t ɝ ə l
quadroon	k w ɑ d ɹ u m
quagga	k w ɑ k ə
quandaries	k w ɑ n d ɹ i z
quarterback	k w ɔ ɹ t ɝ b ɛ k
quarters	k ɔ ɹ t ɝ z
quarters	k w ɔ ɹ d ɝ z
quartz	k w ɔ ɹ d z
qubit	k j u p ɪ t
queen	k w ɪ n
queenie	k w ɪ n i
queens	k w i n s
queensland	k w ɪ n z l ə n d
questioned	k w ɛ ʃ tʃ ə n d
quire	k w aɪ ɝ
quitting	k w ɪ t ɪ n
quitting	k w ɪ t i ŋ
quixotic	k w ɪ k z ɑ t ɪ k
quorums	k w ɔ ɹ ə n z
rabbitt	ɹ æ b ɪ t
rabid	ɹ æ b ɪ t
rabies	ɹ eɪ p i z
rabuka	ɹ ə b u k ə
race	ɹ eɪ z
raced	ɹ eɪ z d
racehorses	ɹ ɛ s h ɔ ɹ s ɪ z
raceme	ɹ eɪ s i n
racer	ɹ eɪ z ɝ
races	ɹ eɪ s ɪ s
racine	ɹ ə s i n
racing	ɹ eɪ z ɪ ŋ
racing	ɹ eɪ s ɪ n
rackets	ɹ æ k ə t s
racks	ɹ æ ɡ z
racks	ɹ æ ɡ s
radicals	ɹ æ d ɪ k ə l s
radice	ɹ æ d i z
radler	ɹ æ d l ɝ
radner	ɹ æ d n ɝ
radnor	ɹ ɛ d n ɝ
radomski	ɹ ə d ɑ n s k i
radtke	ɹ æ d k i
raffi	ɹ æ f i
rahman's	ɹ ɑ m ə n z
raided	ɹ eɪ t ɪ d
raider	ɹ eɪ t ɝ
raiders	ɹ eɪ t ɝ z
raiding	ɹ eɪ t ɪ ŋ
rainier	ɹ eɪ n i ɹ
raised	ɹ eɪ s d
raised	ɹ eɪ z t
raises	ɹ eɪ s ɪ z
raising	ɹ eɪ z ɪ n
raisins	ɹ eɪ s ɪ n z
ralphie	ɹ ɛ l f i
ramadan	ɹ ɛ m ə d ə n
ramallah	ɹ ə m ɑ l ə
raman	ɹ ɑ m ə n
raman	ɹ ʌ m ə n
rampart	ɹ æ n p ɑ ɹ t
rampur	ɹ æ m p u ɹ
rams	ɹ æ n z
ramsay	ɹ æ m z i
ramsay	ɹ æ m s i
ramsay	ɹ æ n s i
ramsey	ɹ æ m s i
ramsey's	ɹ æ m s ɪ z
ramsgate	ɹ æ n z ɡ eɪ t
ramson	ɹ æ m s ə m
rand	ɝ ɛ n d
randell	ɹ ɛ n d ɛ l
randi	ɹ æ n d i
randy	ɹ æ n t i
rangers	ɹ eɪ n dʒ ɝ s
ranging	ɝ eɪ n dʒ ɪ ŋ
rangoon	ɹ æ n ɡ u n
ranjit	ɹ æ n dʒ ɪ d
ranking	ɹ æ ŋ k i ŋ
rankings	ɹ æ ŋ k ɪ ŋ z
ranted	ɹ ɛ n t ɪ d
rapaport	ɹ æ p ə p ɔ ɹ t
rapid	ɹ æ p ə d
rapid	ɹ æ b ɪ d
rapidly	ɹ æ b ə d l i
rapids	ɝ æ p ɪ d z
rapids	ɹ æ b ɪ t z
rappelling	ɹ ə p ɛ l ɪ ŋ
rappin	ɹ æ p ɪ ŋ
raptor	ɹ æ p t ɝ
raptors	ɹ æ p t ɝ z
rash	ɹ ɛ ʃ
raskin	ɹ æ s k ɪ n
raspberry	ɹ ɛ s p ɝ i
raspberry	ɹ æ s b ɛ ɹ i
rat	ɝ æ t
rates	ɹ eɪ t z
rates	ɹ eɪ d z
rather	ɹ ɑ ð ɝ
ratification	ɹ ɛ t ə f ə k eɪ ʃ ə n
rating	ɹ eɪ d ɪ ŋ
rating	ɹ eɪ d ɪ n
ratings	ɹ eɪ d ɪ ŋ z
rationale	ɹ ɛ ʃ ə n æ l
rationale	ɹ æ ʃ ə n ɛ l
rationales	ɹ æ ʃ ə n æ l z
rationally	ɹ æ ʃ ə n ə l i
rationed	ɹ ɛ ʃ ə n d
ratner	ɹ æ t n ɝ
raton	ɹ ɛ t ə n
rats	ɹ æ d z
rats	ɹ ɛ t s
ratterman	ɹ æ t ɝ m ə n
raven	ɹ eɪ f ə n
ravinia	ɹ ə v ɪ n i ə
rawls	ɹ ɔ l z
raymond	ɹ eɪ m ə n t
rays	ɹ eɪ s
re	ɝ i
reached	ɹ ɪ tʃ t
reactivity	ɹ i æ k t ɪ v ə t i
reactor's	ɹ i æ k t ɝ z
read	ɹ æ d
reade	ɹ ɛ d
readership	ɹ i t ɝ ʃ ɪ p
readies	ɹ ɛ d i z
reading	ɹ ɪ d ɪ ŋ
reading	ɹ ɛ t ɪ ŋ
reading	ɹ i d ɪ n
readings	ɹ i d ɪ ŋ z
reads	ɹ ɛ t s
realtor	ɹ ɪ l ə t ɝ
realtor	ɹ i l t ɝ
reardon	ɹ ɪ ɹ d ə n
reared	ɹ ɪ ɹ t
reared	ɹ i ɝ d
rearmament	ɹ i ɑ ɹ m ə m ə n t
reason	ɹ i ʒ ə n
reassessment	ɹ i ə s ɛ s m ə n t
reaves	ɹ i v z
rebalancing	ɹ i b æ l ə n s ɪ ŋ
rebel	ɹ ɪ b ɛ l
rebels	ɹ æ b ə l z
reber	ɹ ɛ b ɝ
rebid	ɹ i b ɪ d
reboot	ɹ i b u t
rebroadcast	ɹ i b ɹ ɔ d k æ s t
rebuild	ɹ i p ɪ l d
rebuild	ɹ i b ɪ l t
rebuilders	ɹ i b ɪ l d ɝ z
rebuilds	ɹ i b ɪ l t s
rebutted	ɹ i b ʌ t ɪ d
recalling	ɹ i k ɔ l ɪ ŋ
recalls	ɹ ɪ k ɔ l z
received	ɹ i s i v d
received	ɹ i s ɪ v t
receives	ɹ i s i v z
receiving	ɹ ɪ s i v ɪ n
recently	ɹ i s ə n l i
reception	ɹ i s ɛ p ʃ ə n
receptionists	ɹ ɪ s ɛ p ʃ ə n ɪ s t s
receptionists	ɹ ɪ s ɛ p ʃ ə n ɪ s
recession	ɹ i s ɛ ʃ ə n
recoiling	ɹ ɪ k ɔɪ l ɪ ŋ
reconditioned	ɹ i k ə n d ɪ ʃ ə n d
reconfirmed	ɹ i k ə n f ɝ m d
reconnect	ɹ i k ə n ɛ k t
record	ɹ i k ɔ ɹ d
record	ɹ ɛ k ɹ d
recorder	ɹ i k ɔ ɹ d ɝ
recording	ɹ ɪ k ɔ ɹ d ɪ n
recording	ɹ ɪ k ɔ ɹ t ɪ ŋ
records	ɹ ɛ k ɝ d z
recounted	ɹ ɪ k aʊ n t ɪ d
recounting	ɹ ɪ k aʊ n t ɪ ŋ
recounts	ɹ ɪ k aʊ n t s
recovered	ɹ i k ʌ v ɝ d
recoveries	ɹ ɪ k ʌ v ɹ i z
recovery	ɹ ɪ k ʌ v ɝ i
recovery	ɹ ɪ k ʌ f ɝ i
recruiting	ɹ i k ɹ u t ɪ ŋ
rector	ɝ ɛ k t ɝ
rector	ɹ æ k t ɝ
recuperate	ɹ i k u p ɝ eɪ t
recur	ɹ ɪ k ɝ
recurrent	ɹ i k ɝ ə n t
recurs	ɹ ɪ k ɝ z
recused	ɹ ɪ k j u z d
red	ɹ ɛ t
redacted	ɹ ɪ d æ k t ɪ d
redaction	ɹ i d æ k ʃ ə n
redbook	ɹ ɛ d b ʊ k
redeem	ɹ i d i m
redeemable	ɹ i d i m ə b ə l
redeemer	ɹ i d i m ɝ
redeeming	ɹ i d i m ɪ ŋ
redefinition	ɹ i d ɛ f ə n ɪ ʃ ə n
redemptions	ɹ ɪ d ɛ m p ʃ ə n z
redevelop	ɹ i d ɪ v ɛ l ə p
redevelopment	ɹ i d ɪ v ɛ l ə p m ə n t
redfish	ɹ ɛ d f ɪ ʃ
redford	ɹ ɛ d f ɝ t
redirecting	ɹ i d ɝ ɛ k t ɪ ŋ
redistricting	ɹ i d ɪ s t ɹ ɪ k t ɪ ŋ
redland	ɹ ɛ d l ə n d
reds	ɹ æ d z
reds	ɹ ɛ t s
redshank	ɹ ɛ d ʃ æ ŋ k
reductions	ɹ ɪ d ʌ k ʃ ə n z
redundancy	ɹ i d ʌ n d ə n s i
redundant	ɹ i d ʌ n d ə n t
reebok	ɹ i b ɑ k
reed's	ɹ ɪ d z
reefs	ɹ i v z
reenactment	ɹ i ɪ n æ k t m ə n t
reenactments	ɹ i ɪ n æ k t m ə n t s
rees	ɹ i s
reese	ɹ i z
reestablish	ɹ i i s t æ b l ɪ ʃ
reestablished	ɹ i i s t æ b l ɪ ʃ t
reestablishing	ɹ i i s t æ b l ɪ ʃ ɪ ŋ
reestablishment	ɹ i i s t æ b l ɪ ʃ m ə n t
reeve	ɹ i f
reexport	ɹ i ɛ k s p ɔ ɹ t
refectories	ɹ ɪ f ɛ k t ɝ i z
refectory	ɹ ɪ f ɛ k t ɝ i
reference	ɹ ɛ f ɝ ə n s
referenced	ɹ ɛ v ɹ ə n s t
references	ɹ ɛ f ɹ ə n s ɪ z
references	ɹ ɛ v ɹ ə n s ɪ z
referencing	ɹ ɛ f ɹ ə n s ɪ ŋ
referendum	ɹ ɛ f ɝ æ n d ə m
referendums	ɹ ɛ f ɝ ɛ n d ə m z
referrals	ɹ ɪ f ɝ ə l z
referred	ɹ ɪ f ɝ t
refined	ɹ i f aɪ n d
refinement	ɹ i f aɪ n m ə n t
refineries	ɹ i f aɪ n ɝ i z
refinery	ɹ i f aɪ n ɝ i
refinished	ɹ i f ɪ n ɪ ʃ t
refitted	ɹ i f ɪ t ɪ d
reflects	ɹ ɪ f l ɛ k s
reforestation	ɹ ɪ f ɔ ɹ ə s t eɪ ʃ ə n
reformation	ɹ i f ɔ ɹ m eɪ ʃ ə n
reformed	ɹ i f ɔ ɹ m d
reformers	ɹ i f ɔ ɹ m ɝ z
reformists	ɹ ɪ f ɔ ɹ m ɪ s t s
reforms	ɹ i f ɔ ɹ m z
refractories	ɹ ɪ f ɹ æ k t ɝ i z
refraining	ɹ i f ɹ eɪ n ɪ ŋ
refrains	ɹ i f ɹ eɪ n z
refrigeration	ɹ i f ɹ ɪ dʒ ɝ eɪ ʃ ə n
refueling	ɹ i f j u l ɪ ŋ
refueling	ɹ ɪ f j u l ɪ ŋ
refund	ɹ i f ʌ n d
refunded	ɹ i f ʌ n d ɪ d
refunds	ɹ i f ʌ n d z
refurbishment	ɹ ɪ f ɝ b ɪ ʃ m ə n t
refurbishment	ɹ i f ɝ b ɪ ʃ m ə n t
refuse	ɹ ɛ f j u z
regal	ɹ ɪ ɡ ə l
regard	ɹ i ɡ ɑ ɹ d
regard	ɹ ɪ k ɑ ɹ t
regarded	ɹ ɪ k ɑ ɹ d ɪ d
regarded	ɹ i ɡ ɑ ɹ d ɪ d
regatta	ɹ ə ɡ ɑ d ə
regatta	ɹ ɪ ɡ ɑ d ə
regensburg	ɹ i ɡ ə n s b ɝ ɡ
regia	ɹ ɪ dʒ i ə
regime	ɹ eɪ z i m
regimes	ɹ eɪ ʃ i m z
region	ɝ ɪ dʒ ə n
regional	ɹ ɪ dʒ ə n ə l
regional	ɝ ɪ dʒ ə n ə l
regionally	ɹ ɪ dʒ ə n ə l i
regions	ɹ i dʒ ə n s
regular	ɹ ɛ k j ə l ɝ
regulation	ɹ ɛ k j ə l eɪ ʃ ə n
regurgitation	ɹ i ɡ ɝ dʒ ə t eɪ ʃ ə n
rehab	ɹ i h æ p
rehearsal	ɹ ɪ h ɝ s ə l
rehearsals	ɹ ɪ h ɝ s ə l z
rehearse	ɹ ɪ h ɝ s
rehearsed	ɹ ɪ h ɝ s t
rehearsing	ɹ ɪ h ɝ s ɪ ŋ
rehnquist	ɹ ɛ n k w ɪ s t
reichert	ɹ aɪ k ɝ d
reign	ɝ eɪ n
reimbursements	ɹ i ɪ m b ɝ s m ə n t s
reims	ɹ i m z
reinhardt	ɹ aɪ n h ɑ ɹ d
reintroduces	ɹ i ɪ n t ɹ ə d u s ɪ z
reinvent	ɹ i ɪ n v ɛ n t
reinvented	ɹ i ɪ n v ɛ n t ɪ d
reinventing	ɹ i ɪ n v ɛ n t ɪ ŋ
reinvention	ɹ i ɪ n v ɛ n ʃ ə n
reis	ɹ i s
reissuing	ɹ i ɪ ʃ u ɪ ŋ
rejections	ɹ ɪ dʒ ɛ k ʃ ə n z
rejoicing	ɹ i dʒ ɔɪ s ɪ ŋ
rejoinder	ɹ ɪ dʒ ɔɪ n d ɝ
rejuvenated	ɹ i dʒ u v ə n eɪ t ɪ d
rejuvenating	ɹ i dʒ u v ə n eɪ t ɪ ŋ
relapses	ɹ i l æ p s ɪ z
related	ɹ ɪ l eɪ t ɪ d
relations	ɹ i l eɪ ʃ ə n s
relations	ɹ i l eɪ ʃ ə n ʃ
relativistic	ɹ ɛ l ə t ɪ v ɪ s t ɪ k
relax	ɹ i l æ k s
relaxation	ɹ ɪ l æ k s eɪ ʃ ə n
relaxing	ɹ i l æ k s ɪ ŋ
relayed	ɹ ɪ l eɪ d
release	ɹ ɪ l i z
relented	ɹ i l ɛ n t ɪ d
relentless	ɹ i l ɛ n t l ə s
relentlessly	ɹ i l ɛ n t l ə s l i
reliable	ɹ ɪ l aɪ ə b ə l
reliant	ɹ ɪ l aɪ ə n t
relied	ɹ i l aɪ d
relies	ɹ i l aɪ z
relieve	ɹ i l i f
relieved	ɹ i l i v t
religion	ɹ ɪ l i dʒ ə n
religion	ɹ i l i dʒ ə n
religions	ɹ i l ɪ dʒ ə n z
relinquished	ɹ ɪ l ɪ ŋ k w ɪ ʃ t
relit	ɹ i l ɪ t
reluctant	ɹ i l ʌ k t ə n t
rely	ɹ ɪ l aɪ
rem	ɹ ɛ m
remained	ɹ i n eɪ m d
remand	ɹ i m æ n d
remarked	ɹ i m ɑ k t
remember	m ɛ m b ɝ
remi	ɹ æ m i
remifentanil	ɹ ɛ m i f ɛ n t ə n ɪ l
reminders	ɹ ɪ m aɪ n d ɝ z
remittance	ɹ ɪ m ɪ t ə n s
remittances	ɹ ɪ m ɪ t ə n s ɪ z
remitted	ɹ ɪ m ɪ t ɪ d
remote	ɹ ɪ m oʊ t
removable	ɹ i m u v ə b ə l
removal	ɹ i m u v ə l
removed	ɹ i m u v t
remuneration	ɹ i m j u n ɝ eɪ ʃ ə n
renaissance	ɹ ɛ n ə z ɑ n s
renaissance	ɹ ɛ n ə s ɑ n z
renamed	ɹ i m eɪ m d
renaming	ɹ ɪ m eɪ n ɪ ŋ
renato	ɹ ə n ɑ d oʊ
renault	ɹ ɪ n ɔ l t
rene	ɹ ɪ n
renew	ɹ i n u
renewable	ɹ i n u ə b ə l
renewal	ɹ i n u ə l
renewed	ɹ i n u t
renewed	ɹ ɪ n u d
renewing	ɹ i n u ɪ ŋ
rennard	ɹ ɪ n ɑ ɹ d
rennet	ɹ ɛ n ɪ d
renovated	ɹ ɛ n ə f eɪ t ɪ d
renowned	ɹ i n aʊ n d
rent	ɹ æ n d
rented	ɹ ɛ n t ɪ t
rented	ɹ ɛ n d ɪ d
rentz	ɹ ɛ n t s
renumbered	ɹ i n ʌ m b ɝ d
reorder	ɹ i ɔ ɹ d ɝ
reordering	ɹ i ɔ ɹ d ɝ ɪ ŋ
rep	ɹ æ p
repair	ɹ i p ɛ ɹ
repaired	ɹ i p ɛ ɹ d
repairing	ɹ i p ɛ ɹ ɪ ŋ
repairs	ɹ i p ɛ ɹ z
repairs	ɹ ɪ p ɛ ɝ z
repeal	ɹ ɪ p i l
repealed	ɹ ɪ p i l d
repeat	ɹ i p i t
repeaters	ɹ i p i t ɝ z
repeats	ɹ i p i t s
repercussion	ɹ i p ɝ k ʌ ʃ ə n
repercussions	ɹ i p ɝ k ʌ ʃ ə n z
repetitive	ɹ ɪ p ɛ t ɪ t ɪ v
replace	ɹ i p l eɪ s
replaced	ɹ i p l eɪ s t
replacement	ɹ i p l eɪ s m ə n t
replacing	ɹ i p l eɪ s ɪ ŋ
replica	ɹ æ p l ɪ k ə
reply	ɹ ɪ p l aɪ
report	ɹ i p ɔ ɹ t
report	ɹ i p ɔ t
reported	ɹ ɪ b ɔ ɹ d ɪ d
reported	ɹ ɪ p ɔ ɹ d ɪ d
reporter	ɹ i p ɔ ɹ t ɝ
reports	ɹ i p ɔ ɹ t s
reports	ɹ i b ɔ t s
reposition	ɹ i p ə z ɪ ʃ ə n
repositioning	ɹ i p ə z ɪ ʃ ə n ɪ ŋ
repositories	ɹ ɪ p ɑ z ə t ɔ ɹ i z
repository	ɹ ɪ p ɑ z ə t ɔ ɹ i
represented	ɹ ɛ p ɹ ə z ɛ n ə d
represented	ɹ ɛ p ɹ ə z ɛ n ə t
represented	ɹ ɛ p ɹ i z ɛ n ɪ d
represented	ɹ ɛ p ɹ i z ɛ n t ɪ d
represents	ɹ ɛ p ɹ i z ɛ n t s
repressed	ɹ ɪ p ɹ ɛ s t
repression	ɹ ɪ p ɹ ɛ ʃ ə n
reprimanded	ɹ ɛ p ɹ ə m ɛ n d ɪ d
repudiated	ɹ ɪ p j u d i eɪ t ɪ d
repudiates	ɹ ɪ p j u d i eɪ t s
repulsed	ɹ ɪ p ʌ l s t
repulsion	ɹ ɪ p ʌ l ʃ ə n
request	ɹ i k w ɛ s t
requests	ɹ ɪ k w ɛ s
require	ɹ i k w aɪ ɝ
requirement	ɹ i k w aɪ ɝ m ə n t
requirements	ɹ i k w aɪ ɝ m ə n t s
requirements	ɹ i k w aɪ ɚ m ə n t s
requiring	ɹ i k w aɪ ɹ ɪ ŋ
reruns	ɹ i ɹ ʌ n z
rescind	ɹ ɪ s ɪ n t
rescinded	ɹ i s ɪ n d ə d
rescinded	ɹ ɪ s ɪ n d ə d
rescinding	ɹ i s ɪ n d ɪ ŋ
rescript	ɹ ɪ s k ɹ ɪ p t
rescued	ɝ ɛ s k j u d
reseller	ɹ i s ɛ l ɝ
resellers	ɹ i s ɛ l ɝ z
resells	ɹ i s ɛ l z
resembles	ɹ i s ɛ m b ə l z
resembling	ɹ i z ɛ m b l ɪ ŋ
resented	ɹ ɪ z ɛ n t ə d
reserve	ɹ i z ɝ f
reservoir	ɹ ɛ s ɝ v w ɑ ɹ
reside	ɹ i z aɪ d
resided	ɹ i s aɪ t ɪ d
resided	ɹ i z aɪ d ɪ d
residencies	ɹ ɛ z ɪ d ə n s ɪ z
resident	ɹ ɛ s ɪ d ə n t
residential	ɹ ɛ z ɪ d ɛ n ʃ ə l
resides	ɹ i z aɪ d z
resides	ɹ ɪ s aɪ d z
residual	ɹ i z ɪ dʒ u ə l
resign	ɹ i s aɪ n
resign	ɹ i z aɪ n
resigned	ɹ i s aɪ n d
resigned	ɹ i z aɪ n d
resigned	ɹ ɪ s aɪ n d
resigning	ɹ ɪ s aɪ n ɪ ŋ
resin	ɹ ɛ z ə n
resin	ɹ ɛ s ɪ n
resins	ɹ ɛ z ə n z
resist	ɹ i z ɪ s t
resist	ɹ ɪ s ɪ s t
resistances	ɹ ɪ z ɪ s t ə n s ɪ s
resistant	ɹ i z ɪ s t ə n t
resisted	ɹ ɪ z ɪ s t ə d
resistor	ɹ ɪ z ɪ s t ɝ
resistors	ɹ ɪ z ɪ s t ɝ z
resists	ɹ ɪ z ɪ s
resnick	ɹ ɛ z n ɪ k
resnik	ɹ ɛ z n ɪ k
resolving	ɹ i s ɑ l v ɪ ŋ
resonance	ɹ ɛ s ə n ə n s
resonant	ɹ ɛ s ə n ə n t
resort	ɹ i z ɔ ɹ t
resort	ɹ ɪ z ɔ ɹ t
resorted	ɹ i z ɔ ɹ t ɪ d
resorting	ɹ i z ɔ ɹ t ɪ ŋ
resorts	ɹ i z ɔ ɹ t s
resound	ɹ i z aʊ n d
respires	ɹ ɪ s p aɪ ɝ z
responded	ɹ ɪ s p ɑ n d ə d
responder	ɹ ɪ s p ɑ n d ɝ
responders	ɹ ɪ s p ɑ n d ɝ z
response	ɹ i s p ɑ n s
response	ɹ ɪ s p ɑ n z
responses	ɹ ɪ s p ɑ n s ə z
restaurant	ɹ ɛ s t ɹ ɑ n t
resting	ɹ ɛ s t ɪ n
restore	ɹ i s t ɔ ɹ
restore	ɹ i s t ɔ
restored	ɹ i s t ɔ ɹ d
restorers	ɹ i s t ɔ ɹ ɝ z
restrained	ɹ ɪ s t ɹ eɪ n d
restraint	ɹ i s t ɹ eɪ n d
restricted	ɹ i s t ɹ ɪ k t ɪ d
result	ɹ i s ʌ l t
resumed	ɝ i z u m d
resumed	ɹ i s u m d
resurface	ɹ i s ɝ f ə s
resurfaced	ɹ i s ɝ f ə s t
resurfacing	ɹ i s ɝ f ə s ɪ ŋ
resurrection	ɹ ɛ s ɝ ɛ k ʃ ə n
retaliate	ɹ i t æ l i eɪ t
retaliated	ɹ i t æ l i eɪ t ɪ d
retardant	ɹ ɪ t ɑ ɹ d ə n t
retested	ɹ i t ɛ s t ɪ d
reti	ɹ ɛ t i
retina	ɹ ɛ d ə n ə
retinue	ɹ ɛ t ə n u
retire	ɹ i t aɪ ɝ
retirement	ɹ i t aɪ ɝ m ə n t
retirements	ɹ i t aɪ ɝ m ə n t s
retires	ɹ i t aɪ ɝ z
retiring	ɹ i t aɪ ɝ ɪ ŋ
retooled	ɹ i t u l d
retracting	ɹ ɪ t ɹ æ k t ɪ ŋ
retraction	ɹ ɪ t ɹ æ k ʃ ə n
retransmission	ɹ i t ɹ æ n z m ɪ ʃ ə n
retrieved	ɹ ɪ t ɹ i v d
return	ɹ i d ɝ n
reusable	ɹ i u z ə b ə l
reused	ɹ i u z d
reuter	ɹ ɔɪ d ɝ
revalued	ɹ i v æ l j u d
reverberation	ɹ ɪ v ɝ b ɝ eɪ ʃ ə n
revere	ɹ ə v ɪ ɹ
revered	ɹ i v ɪ ɹ d
reverend	ɹ ɛ v ɝ ə n t
reverse	ɹ ɪ f ɝ s
reverse	ɹ i v ɝ s
reversed	ɹ i v ɝ s t
reverses	ɹ i v ɝ s ɪ z
review's	ɹ i v j u z
reviewed	ɹ i f j u d
reviews	ɹ i f j u z
revised	ɹ ɪ v aɪ z d
revising	ɹ i v aɪ z ɪ ŋ
revision	ɹ ɪ v ɪ ʒ ə n
revisionism	ɹ i v ɪ ʒ ə n ɪ z ə m
revisionist	ɹ i v ɪ ʒ ə n ɪ s t
revisionists	ɹ ɪ v ɪ ʒ ə n ɪ s t s
revisions	ɹ ɪ v ɪ ʒ ə n z
revitalize	ɹ i v aɪ d ə l aɪ z
revitalizing	ɹ i v aɪ d ə l aɪ z ɪ ŋ
revolution	ɹ ɛ v ə l u s ə n
revolver	ɹ ɪ v ɑ l v ɝ
revue	ɹ i v j u
revues	ɹ i v j u z
revulsion	ɹ i v ʌ l ʒ ə n
revved	ɹ ɛ v d
rework	ɹ i w ɝ k
reworked	ɹ i w ɝ k t
reworking	ɹ i w ɝ k ɪ ŋ
rhapsody	ɹ æ p s ə t i
rhetoric	ɹ ɛ t ɝ ɪ k
rhetoric	ɹ ɛ d ɝ ɪ k
rhetoric	ɹ ɛ d ɹ ɪ k
rhett	ɹ ɛ t
rhett	ɹ æ t
rhodesia	ɹ oʊ d i ʃ ə
rhododendrons	ɹ oʊ d ə d ɛ n d ɹ ə m z
rhys	ɹ i s
rhythm	ɹ ɪ θ ə m
rhythmic	ɹ ɪ θ m ɪ k
rib	ɹ ɪ p
ribblesdale	ɹ ɪ p ə l z d eɪ l
ribbons	ɹ i b ə n z
ribeiro	ɹ ɪ b ɛ ɹ oʊ
ricard	ɹ ɪ k ɑ ɹ d
riccardo	ɹ ɪ k ɑ ɹ d oʊ
rice's	ɹ aɪ z ɪ z
richard	ɹ ɪ tʃ ɝ t
richelieu	ɹ i ʃ ə l u
richmond	ɹ ɪ tʃ m ə n t
rick	ɹ ɪ ɡ
ricketson	ɹ ɪ k ɪ d s ə n
rickshaws	ɹ ɪ k ʃ ɔ s
rickson	ɹ ɪ k s ə n
ricky	ɹ i k i
rico	ɝ i k oʊ
rico	ɹ i ɡ oʊ
ricochet	ɝ ɪ k ə ʃ eɪ
ridden	ɹ ɪ t ə n
ridden	ɹ i d ə n
riddick	ɹ ɪ d ɪ k
ride	ɹ aɪ t
rider	ɹ aɪ t ɝ
riders	ɹ aɪ t ɝ z
rides	ɹ aɪ t s
rides	ɹ aɪ d s
riding	ɹ aɪ t ɪ ŋ
ridings	ɹ aɪ t ɪ ŋ z
ried	ɹ i d
ries	ɹ i s
riffe	ɹ ɪ f
riffs	ɹ ɪ f s
riga	ɹ ɪ k ə
right	ɹ aɪ d
rights	ɹ aɪ t z
rigs	ɹ ɪ ɡ s
rika	ɹ ɪ k ə
riksdag	ɹ ɪ k s t æ ɡ
riksdag	ɹ ɪ k s t ʌ k
riksdag	ɹ ɪ k s t ɑ ɡ
rinconada	ɹ ɪ n k ə n ɑ d ə
ring	ɹ i ŋ
ringling	ɹ ɪ ŋ l ɪ ŋ
ringo	ɹ ɪ ŋ k oʊ
riposte	ɹ i p oʊ s t
ripped	ɹ i p t
ripper	ɹ ɪ p ɹ
rise	ɹ aɪ s
rise	ɝ aɪ z
rises	ɹ aɪ z ɪ s
rises	ɝ aɪ z ɪ z
rishi	ɹ ɪ ʃ i
rising	ɝ aɪ z ɪ ŋ
risner	ɹ ɪ s n ɝ
riss	ɹ ɪ s
rita	ɹ i d ə
rita's	ɹ i d ə z
ritchie's	ɹ ɪ tʃ ɪ z
ritter	ɹ ɪ d ɝ
rittman	ɹ ɪ t m ə n
rival	ɝ aɪ v ə l
river	ɹ ɪ f ɝ
river	ɹ i v ɝ
rivera's	ɹ ɪ v ɝ ə s
riverine	ɹ ɪ v ɝ i n
rivers	ɹ i v ɝ z
rivers	ɹ i v ɝ s
rivers	ɹ ɪ f ɝ z
riverside	ɹ ɪ f ɝ s aɪ d
riyadh	ɹ i ɑ d
riz	ɹ i z
road	ɹ oʊ t
roam	ɹ oʊ n
rob	ɹ ɑ p
rob's	ɹ ɑ p s
robbed	ɹ ɑ p t
robbins's	ɹ ɑ b ɪ n s ɪ z
roberta	ɹ ə b ɝ t ə
roberts	ɹ ɑ b ɝ d s
robertson	ɹ ɑ b ɝ d s ə n
robin	ɹ ɑ b ə n
robin	ɹ ʌ b ɪ n
roblin	ɹ ɑ b l ɪ n
robot	ɹ oʊ b ɑ t
robotic	ɹ oʊ b ɑ d ɪ k
roche	ɹ oʊ s
rock	ɹ ɑ ɡ
rock	ɹ ʌ k
rocked	ɹ ʌ k t
rocker	ɹ ʌ k ɝ
rocketry	ɹ ɑ k ə t ɹ i
rockman	ɹ ɑ k m ə n
rocky	ɹ ʌ k i
rod	ɹ ɑ t
roddenberry	ɹ ɑ d ə n b ɛ ɹ i
roddy	ɹ ʌ d i
rode	ɹ oʊ t
roderick	ɹ ɑ d ɝ ɪ k
rodney	ɝ ɑ d n i
rodrigo	ɹ ɑ d ɝ i ɡ oʊ
rojas	ɹ oʊ h ɑ z
roles	ɹ oʊ l s
rolf's	ɹ oʊ l f z
rolla	ɹ ɑ l ə
roller	ɹ oʊ l ɹ
roller	ɹ oʊ l ɚ
rollicking	ɹ ɑ l ɪ k i ŋ
rolling	ɹ oʊ l ɪ n
rolling	ɹ oʊ l i ŋ
rolls	ɹ oʊ l s
rom	ɹ ɑ m
rome	ɹ oʊ n
ronk	ɹ ɑ ŋ k
ronna	ɹ ɑ n ə
ronnie	ɹ ʌ n i
ronning	ɹ ʌ n ɪ ŋ
roofing	ɹ ʊ f ɪ ŋ
roofs	ɹ u v z
rooker	ɹ ʊ k ɝ
rookeries	ɹ u k ɝ i z
roope	ɹ u p
roos	ɹ u s
roose	ɹ u s
roosevelt	ɹ u s ə v ɛ l t
root	ɹ u d
roots	ɹ u d s
roots	ɹ u d z
ropes	ɹ oʊ b z
rosa	ɹ oʊ s ə
rosana	ɹ oʊ s ɑ n ə
roscoe	ɝ ɑ ʃ k oʊ
roseau	ɹ oʊ s oʊ
rosetta	ɹ ə z ɛ t ə
roslyn	ɹ ɑ z l ɪ ŋ
ross	ɹ ɑ z
ross's	ɹ ɑ s ɪ z
rossa	ɹ ʌ s ə
roster	ɹ ɔ s t ɝ
roster	ɹ ʌ s t ɝ
rostral	ɹ ʌ s t ɹ ə l
rostrum	ɹ ʌ s t ɹ ə m
roswell	ɹ ɑ z w ɛ l
rota	ɹ oʊ d ə
rotary	ɹ oʊ d ɝ i
rother	ɹ ɑ ð ɝ
rotor	ɹ oʊ d ɝ
rotors	ɹ oʊ d ɝ z
rotterdam	ɹ ɑ d ɝ d æ m
rotterdam	ɹ ɑ t ɝ d æ n
rotting	ɹ ɑ d ɪ ŋ
rouge	ɹ u z
round	ɝ aʊ n d
roundish	ɝ aʊ n d ɪ ʃ
route	ɹ u d
routed	ɹ u d ɪ d
router	ɹ aʊ d ɝ
routers	ɹ u t ɝ z
routes	ɹ u d z
rowdies	ɹ aʊ t i z
rowdiness	ɹ aʊ t i n ə s
rowdy	ɹ aʊ t i
rox	ɹ ɑ k s
roxbury	ɹ ʌ ɡ z b ɛ ɹ i
ruas	ɹ u ə s
rubber	ɹ ɑ b ɝ
rubbing	ɹ ɑ b ɪ ŋ
rubbing	ɹ ɑ p ɪ ŋ
rubble	ɹ ʌ p ə l
rube	ɹ u p
rubik's	ɹ u b ɪ k s
rubin's	ɹ u b ɪ n z
ruckman	ɹ ɑ k m ə n
rucks	ɹ ɑ k s
rudimentary	ɹ u d ə m ɛ n t ɝ i
rudimentary	ɹ u d ə m ɛ n t ɹ i
rudman	ɹ ʌ d m ə n
rudolf	ɹ u d ɑ l f
rufer	ɹ u f ɝ
ruffling	ɹ ʌ f l ɪ ŋ
rugby	ɹ ɑ k b i
rugby	ɹ ʌ k b i
rugged	ɹ ʌ k t
rugose	ɹ u ɡ oʊ s
ruin	ɹ u ə n
ruin	ɹ u ɪ ŋ
ruing	ɹ u ɪ n
ruins	ɹ u ə n z
ruiz	ɹ u ɪ z
rumba	ɹ u m b ə
rumba	ɹ ɑ m b ə
rumsfeld	ɹ ʌ m z f ɛ l d
rumsfeld	ɹ ʌ m s f ɛ l d
run	ɹ ɑ n
runes	ɹ u m z
running	ɹ ʌ n ɪ n
runoff	ɹ ʌ n ɔ f
runyan	ɹ ʌ n j ə n
rupert	ɹ u b ɝ t
rus	ɹ u z
rus	ɹ ɑ s
ruse	ɹ u s
rushdie	ɹ ʌ ʃ t i
russell	ɹ ɑ s ə l
rustling	ɹ ʌ s l ɪ ŋ
rutan	ɹ u t ə n
rutgers	ɹ ɑ t ɡ ɝ s
rutgers	ɹ ʌ t k ɝ z
ruthenium	ɹ u θ ɪ n i ə m
rutherford	ɹ ʌ ð ɝ f ɝ d
rutherford's	ɹ ʌ ð ɝ f ɝ d z
ruthven	ɹ ʌ θ f ə n
rutland	ɹ ɑ t l ə n d
rutt	ɹ ʌ t
rutter	ɹ ʌ d ɝ
ruud	ɹ u d
ryba	ɹ ɪ b ə
rydell	ɹ ɪ d ə l
ryder	ɹ aɪ t ɝ
ryerson	ɹ aɪ ɝ s ə n
s	æ s
s	ʃ
saanich	s ɛ n ɪ tʃ
sabir	s ə b ɪ ɹ
sabotage	s æ p ə t ɑ ʒ
sabu	s ɛ b u
saccharin	s æ k ɹ ə n
sacral	s ɛ k ɝ ə l
sacred	s eɪ k ɹ ɪ t
sad	s æ t
saddle	s æ t ə l
saddle	s ɛ d ə l
sadism	s eɪ t ɪ z ə m
sadler	s æ t l ɝ
saffron's	s ɛ f ɹ ə n z
saggers	s ɛ ɡ ɝ z
sago	s eɪ k oʊ
said	s eɪ t
said	s ɛ t
said	s æ d
said	s æ t
sainsbury	s eɪ n z b ɛ ɹ i
saladin	s æ l ə d i n
saladin	s ɛ l ə d i n
salamanca	s ɛ l ə m æ ŋ k ə
salamander	s ɛ l ə m æ n d ɝ
salford	s ɛ l f ɝ d
sally	s ɛ l i
salmon	s ʌ m ə n
salomon	s ɛ l ə m ə n
salter's	s ɔ l t ɝ s
saluzzo	s ə l u s oʊ
salvadoran	s æ l v ə d ɔ ɹ ə n
salvadorans	s æ l v ə d ɔ ɹ ə n z
salvaged	s æ l v ɪ dʒ t
salvatore	s æ l v ə t ɔ ɹ i
salvatore	s æ l v ə t ɔ ɹ
salvos	s æ l v oʊ s
salvos	s æ l f oʊ z
sam	s æ n
samantha	s ə m ɛ n θ ə
same	s eɪ n
samford	s æ n f ɝ d
sami	s ʌ m i
samir	s ə m ɪ ɹ
samples	s æ m b ə l z
sampras	s æ m p ɹ ə s
samsung	s æ m s ə n
samurai	s ɛ m ɝ aɪ
san	s ɛ n
san	s æ m
san	s æ ŋ
sanatoria	s ɛ n ə t ɔ ɹ i ə
sanatorium	s æ m ə t ɔ ɹ i ə m
sanders	s æ n d ɝ s
sandhill	s æ n t h ɪ l
sandra	s æ n t ɹ ə
sandwich	s æ n w ɪ tʃ
sandwiches	s æ n w ɪ tʃ ɪ z
sankey's	ʃ æ ŋ k i z
sannox	s æ m ə k s
sanskrit	s æ n s k ɝ ɪ t
sanskrit	s æ n s k ɹ ɪ d
santa	s ɛ n t ə
santissimo	s ɛ n t ɪ s ɪ m oʊ
santos	s æ n t oʊ z
sardinian	s ɑ ɹ d ɪ n i ə n
sarkar	s ɑ ɹ k ɑ ɹ
sarney	s ɑ ɹ n i
saskatoon	s ɛ s k ə t u n
sat	s ɛ t
satellite	s æ d ə l aɪ t
satin	s ɛ t ɪ n
satisfactorily	s æ t ə s f æ k t ɝ ə l i
satriani	s æ t ɹ i ɑ n i
saudi	s ɔ t i
saudi	s aʊ t i
saulsberry	s ɔ l z b ɛ ɹ i
saussure	s ɔ s ɝ
savage	s æ f ɪ dʒ
save	s eɪ f
saving	s eɪ v ɪ n
saxon	s ɛ k s ə n
saxophone	s ɛ k s ə f oʊ n
saying	s eɪ ɪ n
says	s i z
scabrous	s k æ b ɝ ə s
scaly	s k eɪ l ɪ
scams	s k æ n z
scarab	s k ɛ ɹ ə b
scarabs	s k ɛ ɹ ə p z
scarborough	s k ɑ ɹ p ɝ oʊ
scarecrow	s k ɛ ɹ k ɹ oʊ
scarier	s k ɛ ɹ i ɝ
scarves	s k ɑ ɹ f s
scene	s i m
scene	z i n
scene	s ɪ n
scenery	s ɪ n ɝ i
scenes	s ɪ ŋ z
scenic	s ɪ n ɪ k
scharf	ʃ ɑ ɹ f
schecter	ʃ æ k t ɝ
scheme	s k ɪ m
schenk	ʃ æ ŋ k
schenker	ʃ æ ŋ k ɝ
schertz	s ɝ t s
schinkel	ʃ ɪ ŋ ɡ ə l
schismatic	s k ɪ z m æ d ɪ k
schizophrenia	s k ɪ s ə f ɹ ɪ n i ə
schleswig	ʃ l ɛ s w ɪ k
schmid	ʃ m ɪ t
schmidt	ʃ m ɪ d
school	ʃ k u l
schools	s k u l s
schor	ʃ ɔ ɹ
schreck	ʃ ɹ ɛ k
schweitzer	ʃ w aɪ t s ɝ
schwerin	s w ɛ ɹ ɪ ŋ
scissors	s i z ɝ z
scooby	s k u p i
scooter	s k u d ɝ
scor	s k ɔ ɹ
scores	s k ɔ s
scotties	s k ɑ d i z
scouts	s k aʊ t z
scratching	s k ɹ æ tʃ ɪ n
scream	s k ɹ i n
screamin	s k ɹ i m ɪ ŋ
screen	s k ɹ i m
screen	s k ɹ ɪ n
screen	s k ɹ i ŋ
screening	s k ɹ i n ɪ n
scripted	s k ɹ ɪ p t ɪ d
scripts	s k ɹ ɪ p s
scrum	s k ɹ ɑ m
scrumpy	s k ɹ ʌ m b i
scuba	s k u p ə
scudder	s k ʌ t ɝ
sculptured	s k ʌ l p tʃ ɝ t
scythian	s i θ i ə n
seal	s ɪ l
sears	s i ɹ z
sears	s ɪ ɝ z
seas	s i s
season	s i s ə n
seasons	s i ʒ ə n z
seat	s i d
seat	s ɪ t
seat	ʃ i t
seated	s i d ɪ d
seater	s i d ɝ
seating	s i d ɪ ŋ
seating	s ɪ t ɪ ŋ
seats	s i t z
seats	s i d z
seats	s ɪ t s
seattle	s i æ d ə l
seaver	s i f ɝ
second	s æ k ə n
secret	s i k ɹ ɪ d
secrete	s i k ɹ i t
secretion	s ɪ k ɹ i ʃ ə n
sedans	s ɪ d æ m z
sedative	s ɛ t ə t ɪ v
sedatives	s ɛ t ə t ɪ v z
seddon	s ɛ t ə n
sediments	s ɛ t ə m ə n t s
seebeck	s i b æ k
seed	s ɪ d
seed	s i t
seeded	s i t ɪ d
seeds	s i t s
seeking	s ɪ k ɪ ŋ
seen	s ɪ ŋ
seen	s i ŋ
seen	s i m
seepage	s i p i dʒ
seeps	s i p z
seer	s i ɝ
seer	s ɪ ɹ
seers	s ɪ ɹ z
segar	s i k ɝ
seismic	s aɪ s m ɪ k
seleucia	s ɪ l u s i ə
seligman	s ɛ l ɪ k m ə n
selsdon	s ɛ l s t ə n
selva	s æ l v ə
semantic	s ɪ m ɛ n t ɪ k
semantics	s ɪ m ɛ n t ɪ k s
seme	s ɪ m
semester	s ɪ m ɛ s t ɝ
semester	s ə m æ s t ɝ
seminarian	s ɛ m ə n ɛ ɹ i ə n
seminarians	s ɛ m ə n ɛ ɹ i ə n z
seminars	s æ m ə n ɑ ɹ z
seminole	s ɛ m i n oʊ l
sempre	s ɛ m p ɹ
senate	s æ m ə t
senator	s ɛ n ə d ɝ
senators	s ɛ n ə d ɝ z
send	s ɛ n t
sender	s æ n d ɝ
sends	s ɛ n t s
senegal	s æ n ə ɡ ə l
seng	s æ ŋ
seniors	s i n j ɹ z
senna	s æ n ə
sense	s ɛ n z
sensing	s ɛ n s ɪ n
sensitizer	s ɛ n s ə d aɪ z ɝ
sensors	s æ n z ɝ z
sensors	s æ n s ɝ z
sensors	s ɛ n z ɝ z
sentinels	s ɛ n t ə n ə l s
separated	s ɛ b ɝ eɪ t ɪ d
sephardic	s ɪ f ɑ ɹ t ɪ k
sephardic	s ə f ɑ ɹ t ɪ k
sepulchre	s ɛ p ə l k ɝ
sequels	s i k w ə l s
sequences	s ɪ k w ə n s ɪ z
sequences	s i k w ə n s ɪ s
serbs	s ɝ p s
serbs	s ɝ b s
serfdom	s ɝ f t ə m
serfs	s ɝ v s
series	s ɪ ɹ i s
serious	s ɪ ɹ i ə z
serv	s ɝ f
served	ʃ ɝ v d
serves	s ɝ v s
service	s ɝ f ə s
service	s ɝ v i s
services	s ɝ f ə s ə z
services	s ɝ v ə s ə s
servilia	s ɝ v ɪ l i ə
serving	s ɝ v ɪ n
servos	s ɝ v oʊ z
sessions	s ɛ s ə n z
set	s ɛ d
set	s æ t
set	s æ d
setting	s ɛ d ɪ ŋ
settings	s ɛ t ɪ ŋ s
settings	s æ t ɪ ŋ z
settle	s æ t ə l
settlement	s ɛ t l m ə n t
settlers	s æ t l ɝ z
settlers	s ɛ t l ə s
settlers	s æ t ə l ɝ z
setup	s æ t ʌ p
several	s ɛ f ɹ ə l
seville	s ə v i l
seward	s u ɝ t
sex	s æ k s
sexual	s ɛ k s u ə l
sexuality	s ɛ k s u æ l ə t i
seybert	s eɪ b ɝ d
seyfried	s eɪ f ɹ i d
seymour	s ɪ m ɔ ɹ
sgraffito	s k ɹ ə f i t oʊ
sh	s
shaanxi	ʃ æ ŋ s i
shaanxi	ʃ æ ŋ z i
shades	ʃ eɪ t s
shadow	ʃ æ t oʊ
shadows	ʃ ɛ d oʊ z
shadwell	ʃ ɛ d w ɛ l
shags	ʃ æ k s
shakespeare	ʃ eɪ k s p ɪ ɹ
shakespeare's	ʃ eɪ k s p ɪ ɹ z
shakespeares	ʃ eɪ k s p ɪ ɹ z
shakespearian	ʃ eɪ k s p ɪ ɹ i ə n
shaking	ʃ eɪ k ɪ n
shalford	ʃ ɛ l f ɝ d
shallow	ʃ ɛ l oʊ
shamans	ʃ ɑ m ə n z
shandy	ʃ æ n t i
shankar	ʃ æ ŋ k ɑ ɹ
shannon	ʃ æ m ə n
shapers	ʃ eɪ b ɝ z
shapira	ʃ ə p ɪ ɹ ə
shapiro	ʃ ə p i ɹ oʊ
shara	ʃ ɑ ɹ ə
shards	ʃ ɑ ɹ d z
sharecroppers	ʃ ɛ ɹ k ɹ ɑ p ɝ z
shared	ʃ ɛ ɹ t
shared	s ɛ ɹ d
shareware	ʃ ɛ ɹ w ɛ ɹ
sharing	ʃ ɛ ɹ ɪ n
sharma	ʃ ɑ ɹ m ə
sharma's	ʃ ɑ ɹ m ə z
sharon's	ʃ ɛ ɹ ə n z
sharpe	ʃ ɑ ɹ b
she	s i
she	ʃ ɪ
shear	ʃ i ɹ
shed	ʃ ɛ t
shed	ʃ d
shed	s ɛ t
shedding	ʃ ɛ t ɪ ŋ
sheens	ʃ ɪ n z
sheerness	ʃ ɪ ɹ n ə s
sheets	ʃ i t z
sheffield	ʃ æ f i l d
shefford	ʃ ɛ f ɝ t
sheik's	s i k s
shelby	ʃ æ l b i
shelby's	ʃ ɛ l b ɪ s
shenandoah	ʃ æ n ə n d oʊ ə
sheng	ʃ æ ŋ
shenker	ʃ æ ŋ k ɝ
shenley	ʃ æ n l i
shensi	ʃ ɛ n s i
sherbet	ʃ ɝ b ɝ t
sheriff's	ʃ ɛ ɹ ə v s
sheriff's	ʃ ɛ ɹ ɪ f s
sherrie	ʃ ɛ ɹ i
sheryl	s ɛ ɹ ə l
shibata	ʃ ɪ b ɑ t ə
shibuya	ʃ i b u j ə
shield	ʃ ɪ l t
shimon	ʃ ɪ m ə n
shinnecock	s ɪ n ɪ k ɑ k
shinto	ʃ i n t oʊ
shiny	ʃ aɪ n ɪ
ship	ʃ i p
ship	s i p
shipped	s ɪ p t
ships	ʃ i p s
shire	ʃ aɪ ɝ
shires	ʃ aɪ ɝ z
shiv	ʃ ɪ f
shoddy	ʃ ɑ t i
shoes	ʃ u s
shoot	ʃ ʊ d
shooting	ʃ u d ɪ n
shop	ʃ ɑ b
shopping	ʃ ɑ p ɪ n
shopping	s ɑ p ɪ ŋ
short	s ɔ ɹ t
shortfall	ʃ ɔ ɹ t f ɔ l
shortfalls	ʃ ɔ ɹ t f ɔ l z
shot	ʃ ʌ t
should	s ʊ d
shovels	ʃ ʌ f ə l z
show	s oʊ
showcases	s oʊ k eɪ s ɪ z
showing	ʃ oʊ ɪ n
shredded	s ɹ ɛ d ɪ d
shredders	ʃ ɹ ɛ t ɝ z
shreveport	ʃ ɹ i f p ɔ ɹ t
shropshire	ʃ ɹ ɑ p ʃ aɪ ɝ
shudder	ʃ ʌ t ɝ
shut	ʃ ɑ t
shuttle	ʃ ʌ d ə l
sibling	s ɪ p l ɪ ŋ
siblings	s ɪ p l ɪ ŋ z
siblings	s ɪ b l ɪ n z
siblings	s ɪ b l ɪ ŋ s
sidcup	s ɪ t k ʌ b
side	s aɪ t
sides	s aɪ t s
sides	s aɪ t z
sideways	s aɪ d w eɪ s
sidi	s ɪ t i
sidi	s i d i
siding	s aɪ t ɪ ŋ
siding	s aɪ d i ŋ
sidings	s aɪ t ɪ ŋ z
siege	s ɪ t s
siegel	s ɪ ɡ ə l
siegel	ʃ i ɡ ə l
siegfried's	s ɪ ɡ f ɹ i d z
siegmund	s ɪ ɡ m ə n d
siemens	z i m ə n z
siemens	s i m ə n s
sienna	s i æ n ə
sighted	s aɪ d ɪ d
sighting	s aɪ d ɪ ŋ
sightings	s aɪ d ɪ ŋ z
sigismund	s ɪ ɡ ɪ s m ə n d
sigma	s ɪ k m ə
signoria	s ɪ ɡ n ɔ ɹ i ə
signs	s aɪ n s
signs	s aɪ ŋ z
sikh	ʃ i k
sikkim	s ɪ k i m
silurian	s ɪ l ʊ ɹ i ə m
silveira	s ɪ l v ɛ ɹ ə
silver	s ɪ l f ɝ
silvera	s ɪ l v ɛ ɹ ə
silvestre	s ɪ l v ɛ s t ɹ
silvestre	s ɪ l v ɛ s t ɝ
silvestre's	s ɪ l v ɛ s t ɝ z
sim	s i m
simek	s i m ɪ k
simi	s ɪ m i
simms	s ɪ m s
simons	s aɪ m ə n s
simples	s ɪ m b ə l z
simplified	s ɪ m p l ə v aɪ d
simply	s ɪ m p l ɪ
sinatra	s ə n ɑ t ɹ ə
sinclair	s ɪ ŋ k l ɛ ɹ
sindh	s ɪ n t
singapore	s ɪ ŋ ə p ɔ ɹ
singapore's	s ɪ ŋ ə p ɔ ɹ z
singer	s i ŋ ɝ
singer	s i n ɝ
singh	s i n
singing	s ɪ ŋ ɪ n
sinise	s ɪ n i s
sins	s ɪ n s
sires	s aɪ ɝ z
siskin	ʃ ɪ s k ɪ n
sissons	s ɪ z ə n z
sissons	s i z ə n z
sister	s ɪ s t ɹ
sisters	s ɪ s t ə s
sisyphus	s ɪ s i f ə s
sit	s i t
sita	s ɪ t ə
sita	s i d ə
sitar	s i t ɑ ɹ
sitcoms	s ɪ d k ɑ m z
site	s aɪ d
site	ʃ aɪ t
sites	s aɪ d z
sits	s i t s
sitter	s ɪ d ɝ
sitting	ʃ ɪ t ɪ ŋ
siva	s i v ə
sixteen	s ɪ k s t i m
size	s aɪ s
sizing	s aɪ z i ŋ
skater	ʃ k eɪ t ɝ
skating	s k eɪ d ɪ ŋ
skeg	s k æ ɡ
skene	s k i m
skid	s k ɪ t
skidding	s k ɪ t ɪ ŋ
skier	s k ɪ ɹ
skiers	s k ɪ ɹ z
skiing	s k ɪ ɪ ŋ
skilled	s ɡ ɪ l d
skinny	s k ɪ m i
skittles	s k ɪ d ə l z
slabs	s l æ p s
slade's	s l eɪ d s
slapper	s l æ p ɝ
slaps	s l æ b z
slate	ʃ l eɪ t
slate	s l eɪ d
slater	s l eɪ d ɝ
slates	s l eɪ t z
slaughter's	s l ɔ d ɝ z
sledding	s l ɛ t ɪ ŋ
sleepers	s l ɪ p ɝ z
sleeping	s l ɪ p ɪ ŋ
slide	s l aɪ t
slinky	z l ɪ ŋ k i
slips	s l i p s
sliter	s l ɪ d ɝ
slot	s l ʌ t
slotted	s l ɑ d ɪ d
slough	s l ɑ f
slovenian	s l ə v ɪ n i ə n
sluiter	s l u d ɝ
slumped	s l ɑ m p t
smeared	s n ɪ ɹ d
smeaton's	s m ɪ t ə n z
smelled	s m ɛ l t
smellie	s m æ l i
smooth	s m u θ
smurfs	s m ɝ v z
smythe	s m aɪ θ
snail	s m eɪ l
snodgrass	s n ɑ t ɡ ɹ æ s
snooker	s n u k ɝ
snorkeling	s n ɔ ɹ k ə l ɪ ŋ
snow	ʃ n oʊ
snowy	s n oʊ ɪ
so	ʃ oʊ
soapy	s oʊ b i
sober	ʃ oʊ b ɝ
soccer	s ʌ k ɝ
soccer	ʃ ɑ k ɝ
social	ʃ oʊ ʃ ə l
sociological	s oʊ ʃ i ə l ɑ dʒ ɪ k ə l
sociologist	s oʊ ʃ i ɑ l ə dʒ ɪ s t
sociologists	s oʊ ʃ i ɑ l ə dʒ ɪ s t s
sociology	s oʊ ʃ i ɑ l ə dʒ i
sock	ʃ ɑ k
software	s ɔ f t w ɛ
software's	s ɔ f w ɛ ɹ z
soldered	s ɑ t ɝ d
soldering	s ɑ t ɝ ɪ ŋ
soldiers	ʃ oʊ l dʒ ɝ z
solemn	s ʌ l ə n
solid	s ɑ l ə t
solid	ʃ ɑ l ɪ d
solids	s ɑ l ə d s
solo	ʃ oʊ l oʊ
solomon	s ʌ l ə m ə n
solomon's	s ʌ l ə m ə n s
som	s ʌ m
sombrero	s ʌ m b ɹ ɛ ɹ oʊ
some	s ʌ n
somersworth	s ɑ m ɝ z w ɝ θ
something	s ʌ m θ ɪ n
sometime	s ʌ n t aɪ m
sondheim	s ɑ n t h aɪ m
song	s ɔ n
song	s ʌ ŋ
song	s ʌ n
song's	s ɔ ŋ s
songs	s ʌ n z
songs	s ɑ n z
songs	s ʌ ŋ z
sonnenberg	s ɑ n ə m b ɝ ɡ
sonny	s ʌ m i
sonny	s ɑ n i
soong	s u n
soos	s u s
soot's	s u t s
sooty	s u d i
sorensen	s ɔ ɹ ɪ n s ə n
sort	ʃ ɔ ɹ t
sorted	s ɔ ɹ d ɪ d
sorting	ʃ ɔ ɹ t ɪ ŋ
soto	s oʊ d oʊ
soup	z u p
source	s ɔ z
source	s ɔ ɹ z
sources	s ɔ ɹ ʃ ɪ s
sourly	s aʊ ɝ l i
sous	s u ʃ
southeast	s aʊ θ ɪ s t
southgate	s aʊ θ k eɪ t
sovereign	s ɑ v ɝ ə n
spaced	s p eɪ z d
spade	s p eɪ t
spam	s p æ n
spanish	s p æ n ɪ s
spanned	s p ɛ n t
spanned	s p æ n t
sparrows	s p æ ɹ oʊ z
spas	s p ɑ s
spasskaya	s p æ z k aɪ ə
speakeasy	s p ɪ k i z i
speaking	s p i k ɪ n
spearheaded	s p ɪ ɹ h ɛ d ɪ d
spears	s p ɪ ɹ s
specialising	s p ɛ s ə l aɪ z ɪ ŋ
specialized	s p ɛ s ə l aɪ z d
specialty	s p ɛ ʃ ə l d i
species	s p i s ɪ z
species	s p i s ɪ s
species	s p i ʃ ɪ z
specification	s p æ s ə f ə k eɪ ʃ ə n
specimens	s p ɛ s ə m ə m z
specious	s p i ʃ ə z
specular	s p ɛ k j ə l ɝ
sped	s p ɛ t
speed	s p i t
speedwell	s p i t w ɛ l
spelled	s p ɛ l t
spells	s p æ l s
spelt	s p ɛ l d
spend	s p ɛ n t
spent	s p ɛ n d
sperm	s p ɝ n
spherical	s f ɪ ɹ ɪ k ə l
spielberg	s p ɪ l b ɝ ɡ
spielhagen's	s p ɪ l h eɪ ɡ ə n z
spies	s p aɪ s
spined	s p aɪ n t
spinoza's	s p ɪ n oʊ s ə z
spire	s p aɪ ɝ
spires	s p aɪ ɝ z
splendour	s p l ɛ n d ɝ
splinter	s p l ɪ n d ɝ
spoken	s p oʊ k ə ŋ
sporadic	s p ɝ æ t ɪ k
sporadically	s p ɝ æ t ɪ k l i
sporting	s p ɔ ɹ t i n
sporting	s b ɔ ɹ t ɪ ŋ
sportswear	s p ɔ ɹ t s w ɛ ɹ
spousal	s p aʊ s ə l
spouses	s p aʊ s ɪ z
spouses	s p aʊ s ɪ s
spradlin	s p ɹ æ d l ɪ n
spreadsheets	s p ɹ ɛ d ʃ i t s
spreen	s p ɹ i n
springboard	s p ɹ ɪ ŋ b ɔ ɹ d
springerville	s p ɹ ɪ ŋ ɝ v ɪ l
springs	s p ɹ ɪ ŋ s
springs	s p ɹ ɪ n s
springsteen	s p ɹ ɪ ŋ s t i n
springsteen's	s p ɹ ɪ ŋ s t i n z
sprinkling	s p ɹ ɪ ŋ k ə l ɪ ŋ
squadron	s k w ɑ d ɹ ə m
squat	s k w ɑ d
squatters	s k w ɑ d ɝ z
squire	s k w aɪ ɝ
squire's	s k w aɪ ɝ z
squires	s k w aɪ ɹ z
sri	s ɝ i
sri	ʃ ɹ i
sta	s t ɑ
stab	s t æ p
stable	s t eɪ p ə l
stabs	s t æ p z
stadion	s t eɪ d i ə m
staff	s t ʌ f
stag	s t æ k
stages	s t eɪ dʒ ɪ s
stainless	s t eɪ ŋ l ə s
stairs	s t ɛ ɹ s
stalin	s t æ l ɪ ŋ
stamps	s t æ n p s
stance	s t æ n z
standard	s t æ n d ɝ t
standing	s t æ n t ɪ ŋ
standing	s t æ n d ɪ n
stanford	s t æ m f ɝ d
stanford	s t æ n f ɝ t
stanley	s t æ m l i
stanleys	s t æ m l i z
staple	s t eɪ b ə l
star's	s t ɑ ɹ s
stardom	s t ɑ ɹ t ə m
starker	s t ɑ ɹ k ɝ
starlet	s t ɑ ɹ l ə t
starlin	s t ɑ ɹ l ɪ ŋ
starr's	s t ɑ ɹ s
starred	s t ɑ ɹ t
stars	s t ɑ ɹ s
started	s t ɑ d ɪ d
started	s t ɑ t ɪ t
starting	s t ʌ d ɪ ŋ
starting	s t ɑ ɹ t ɪ n
startups	s t ɑ ɹ d ə p s
startups	s t ɑ ɹ t ə p s
state	s t eɪ d
state	s d eɪ d
station	s t eɪ ʃ ə m
statues	s t æ tʃ u s
status	s t ɛ t ə z
status	s t æ t ə ʃ
staubach	s t aʊ b ʌ k
steadman	s t æ t m ə n
steady	s t æ d ɪ
steal	s t ɪ l
steam	s t ɪ n
stearic	s t ɪ ɹ ɪ k
steel	s t ɪ l
steele	s t ɪ l
steffi	s t æ f i
stegner	s t ɛ k n ɝ
stela	s d ɛ l ə
stem	s t æ m
stemmed	s t æ m d
stencil	s t ɛ m s ə l
stengel	s t æ ŋ ɡ ə l
stenhouse	s t æ n h aʊ s
stephen	s t i f ə n
stephen	s t ɪ f ə n
stephens	s t i f ə n z
steppe	s t æ p
stern	ʃ t ɝ n
sternberg	s t ɝ n b ɝ k
stetson	s t ɛ d s ə n
steubenville	s t u p ə n v ɪ l
steve	s t i f
stevia	s t i v i ə
steward	s t u ɝ t
stewardesses	s t u ɝ t ə s ɪ z
stewart	s t u ɝ d
stichomythia	s t ɪ k ə m ɪ θ i ə
stick	s t i k
sticking	s t ɪ k i ŋ
stigmata	s t ɪ ɡ m ɑ d ə
still	s t i l
stillborn	s t ɪ l b ɔ ɹ n
stilson	s t ɪ l s ə m
stilts	s t ɪ l t z
stint	s t ɪ n d
stock	s t ʌ k
stoddard's	s t ɑ t ɝ d z
stomping	s t ʌ m p ɪ ŋ
stone	s d oʊ n
stood	s t u d
stop	s t ʌ p
stopped	s t ɑ p d
store	s d ɔ
store	s d ɔ ɹ
stores	s d ɔ ɹ z
storm	ʃ t ɔ m
storm	s t ɔ n
straddles	s t ɹ æ t ə l z
stram	s t ɹ æ m
stranded	s t ɹ æ n d ə d
strassman	s t ɹ ɛ s m ə n
stratford	s t ɹ æ t f ɝ t
strathclyde	s t ɹ ɛ θ k l aɪ d
stratton	s t ɹ ɛ t ə n
strauss	ʃ t ɹ aʊ s
stravinsky's	s t ɹ ə v ɪ n s k i z
stream	s t ɹ i n
streatley	ʃ t ɹ i t l i
streep	s t ɹ i p
street	ʃ t ɹ i t
strength	s t ɹ ɛ n θ
stress	s t ɹ æ s
stressor	s t ɹ ɛ s ɝ
stressors	s t ɹ ɛ s ɝ z
stretton	s t ɹ æ t ə n
stricker	s t ɹ ɪ k ɝ
strickland's	ʃ t ɹ ɪ k l ə n d z
strickler	s t ɹ ɪ k l ɝ
stringed	s t ɹ ɪ ŋ d
strip	ʃ t ɹ ɪ p
strip's	s t ɹ ɪ p s
stripped	ʃ t ɹ ɪ p t
strive	s d ɹ aɪ v
strong	ʃ t ɹ ɔ ŋ
struggle	ʃ t ɹ ʌ ɡ ə l
strutt	s t ɹ ɑ t
struve	ʃ t ɹ u v
stuart	s t u ɝ d
stuck	s t ɑ k
studd	s t ʌ t
studded	s t ʌ d i d
studied	s t ɑ d i d
studied	s t ʌ d ɪ d
studied	s t ɑ d ɪ d
studies	s t ʌ d i s
studies	s t ɑ d i z
studios	s t u d i oʊ s
studying	s t ɑ d i ɪ ŋ
stunt	s t ʌ n d
stuttering	s t ʌ d ɝ ɪ ŋ
stutters	s t ʌ d ɝ z
stuttgart	s t u t k ɑ ɹ t
stuttgart	ʃ t u t ɡ ɑ ɹ t
stuttgart	s t u t k ɑ ɹ d
stuttgart	ʃ t u d ɡ ɑ ɹ t
styles	s t aɪ l s
sub	s ʌ p
suba	s u p ə
subaerial	s ʌ p ɛ ɹ i ə l
subdivision	z ʌ b t ɪ v ɪ ʒ ə n
subdued	ʃ ə b t u d
subsequently	s ʌ p s ə k w ə n t l i
subset	s ʌ b s ɛ d
subsidiarity	s ə b s ɪ d i ɛ ɹ ɪ t i
subsidy	s ʌ b s ɪ t i
subspecies	s ʌ b s p i s i z
subtly	s ʌ d ə l i
suburb	s ʌ p ɝ p
suburban	s ə b ɝ b ə m
subversive	s ə b v ɝ s ɪ f
succubus	s ʌ k j ə p ə s
sudbury	s ʌ t b ɛ ɹ i
sudden	s ʌ t ə n
sued	s u t
suffren	s ʌ f ɝ ɪ n
sugars	ʃ u k ɝ s
suing	s u ɪ n
suir	s u ɹ
suit	s u d
suit	ʃ u t
suite	s w ɪ t
suite	s w i d
suites	s w i t z
sulfur	s ʌ l f ɹ
sulfuric	s ə l f j ʊ ɹ ɪ k
sumida	s u m i t ə
summer	s ʌ m ɹ
sumrall	s ɑ m ɝ ə l
sun	s ʌ m
sun	s ɑ n
sund	s ɑ n t
sung	s ʌ n
sunspot	s ʌ n z b ɑ d
sunstar	s ʌ n s t ɑ ɹ
superheated	s u p ɝ h i d ɪ d
superheated	s u p ɝ h ɪ t ɪ d
superintendent	s u p ɝ ə n t ɛ n d ə n d
supermarket	s u p ɝ m ɑ ɹ k ə t
superstar	s u p ɝ s t ɑ ɹ
superstars	s u p ɝ s t ɑ ɹ z
supervising	s u p ɝ f aɪ z ɪ ŋ
supervisors	s u p ɝ f aɪ z ɝ z
support	s ə p ɔ ɹ d
supported	s ə p ɔ ɹ t ə d
supported	s ə b ɔ ɹ d ɪ d
suppressor	s ə p ɹ ɛ s ɝ
surfaced	s ɝ v ə s t
surfaces	s ɝ v ə s ə z
surfaces	s ɝ f ə s ə s
surfer	s ɝ f ɹ
surfing	s ɝ f ɪ n
surfing	s ɝ v ɪ ŋ
surfing	s ɝ f i n
surfs	s ɝ v z
surmounted	s ɝ m aʊ n d ɪ d
surreal	s ɝ ɪ l
surroundings	ʃ ɝ aʊ n d ɪ ŋ s
surtees	s ɝ d i z
surtur	s ɝ d ɝ
surveillance	s ɝ v eɪ l ə n z
surveys	s ɝ f eɪ z
survive	s ɚ v aɪ v
survivors	s ɝ f aɪ v ɝ z
susan	s u s ə n
susanna	s u z æ m ə
suspected	z ə s p ɛ k t ɪ d
suspension	s ə s p æ n ʃ ə n
susy	s u s i
sutcliffe	s ʌ d k l ɪ f
sutter	s ʌ d ɝ
sutton	s ʌ d ə n
suzuki	z ə z u k i
swabs	s w ɑ b s
swaby	s w ɑ b ɪ
swagger	s w æ k ɝ
swapped	s w ɑ b d
swarts	s w ɔ ɹ t s
swartz	ʃ w ɔ ɹ t s
swartzwelder	s w ɔ ɹ t s w ɛ l d ɝ
swather	s w ɑ ð ɝ
swaziland	s w ɑ z i l ə n d
swaziland	s w ɑ s i l æ n d
swazis	s w ɑ z i z
sweater	ʃ w ɛ t ɝ
swedish	s w ɪ d ɪ ʃ
sweeney	s w ɪ n i
sweeney's	s w ɪ n i z
sweet	s w i d
sweet	s w ɪ t
sweete	s w i d
sweeting	s w i d ɪ n
sweetish	s w i d ɪ ʃ
sweets	s w i d z
sweets	s w i d s
swim	s w ɪ n
swimming	s w ɪ m ɪ n
swimwear	s w ɪ m w ɛ ɹ
swiss	s w ɪ ʃ
switch	s w i tʃ
switching	s w ɪ tʃ ɪ n
sword	s ɔ t
swords	s ɔ ɹ t s
swordsman	ʃ ɔ ɹ t s m ə n
swung	s w ʌ n
sydney	s ɪ t n i
sydney's	s ɪ t n i z
sylhet	s i l h ɛ d
symphony	s ɪ n f ə n i
symplectic	s ɪ m p l æ k t ɪ k
symposia	s ɪ m p oʊ z i ə
synchronic	s ɪ n k ɹ ɑ n ɪ k
syncopated	s ɪ n k ə p eɪ t ɪ d
syncretic	s ɪ m k ɹ ɛ t ɪ k
synergy	s ɪ n ɝ dʒ i
synge	s ɪ n
syntax	s ɪ n t ɛ k s
synthesis	s ɪ m θ ə s ə s
syracuse	s ɪ ɹ ə k j u s
syria's	s ɪ ɹ i ə s
system	s ɪ s t ə n
systems	s ɪ s t ə n s
t	d
tabbed	t æ b t
taboos	d æ b u z
tabor's	t eɪ p ɝ z
tachycardia	t æ k i k ɑ ɹ t i ə
tachycardia	t æ k i k ɑ ɹ d i ə
tachycardia	t æ k ɪ k ɑ ɹ t i ə
tacitus	t æ s ɪ d ə s
tactician	t ɛ k t ɪ ʃ ə n
tactile	t ɛ k t aɪ l
tag	t æ k
tagalog	t æ ɡ ə l ɑ k
taggart	t æ ɡ ɝ d
tagged	d æ k t
tagged	t æ k t
tags	t æ ɡ s
tags	t æ k s
tajik	t æ dʒ ɪ k
taken	d eɪ k ə n
taking	t eɪ ɡ ɪ n
talbot	d æ l b ə t
talcott	t ɛ l k ə t
talent	d ɛ l ə n t
talk	d ɔ k
talking	t ɔ k ɪ n
tall	d ɔ l
tally	t æ l ɪ
talmud	t æ l m u d
talmud	t æ l m ə t
tama	d ɑ m ə
tamara	t ɛ m ɝ ə
tamara	t ə m ɑ ɹ ə
tamil	t ɛ m ɪ l
tamil	t ɛ m ə l
tamil	t ə m i l
tampa	t ɛ m p ə
tampa	t æ m b ə
tams	t ɛ m z
tan	t ɛ n
tan's	d æ n z
tancred	t ɛ n k ɹ ɪ d
tandem	t ɛ n d ə m
tanganyika	t æ n ɡ ə n i k ə
tango	d æ ŋ ɡ oʊ
tanks	t æ ŋ ɡ z
tanner	t ɛ n ɝ
tansy	t æ n s i
tao	t aʊ
taoism	t aʊ ɪ z ə m
tapas	t ɑ p ə z
tapas	t æ p ə z
tapas	t ɑ p ə s
tapir	t eɪ p i ɹ
tara	t ɛ ɹ ə
taras	t ɑ ɹ ə s
tare	t ɛ
target	d ɑ ɹ k ə t
targeteers	t ɑ ɹ ɡ ə t ɪ ɹ z
targum	t ɑ ɹ ɡ ə n
tarot	t ɛ ɹ oʊ
tarquin	t ɑ ɹ k w ɪ n
tarsus	t ɑ ʃ ə s
tarts	t ɑ ɹ t z
tarzan	t ɑ ɹ z ə n
tasman	t æ s m ə n
tasmania	t æ s m eɪ n i ə
tatars	t ɑ t ɑ ɹ z
tattoo	t æ d u
tattooed	t æ t u t
tattoos	t æ t u s
tax	t ɛ k s
tax	d æ k s
taxi	t ɛ k s i
taxis	t æ k s ɪ z
taxonomy	t ɛ k s ɑ n ə m i
teach	d ɪ tʃ
teachers	t ɪ tʃ ɝ z
teaches	t i tʃ ɪ s
teaching	t i tʃ i n
teaching	t i tʃ ɪ n
teague	t i k
teal	t ɪ l
team	t ɪ m
team	t ɪ n
team	t i n
team's	t i n z
team's	d i m z
team's	t ɪ m z
teams	t i n z
teaneck	t i n æ k
tear	t ɛ ɹ
tearing	t ɪ ɹ ɪ ŋ
teat	d i d
tech	t æ k
tech	d ɛ k
technique	t ɛ k n ɪ k
techno	t æ k n oʊ
teck	d ɛ k
teen	t i m
teen	t ɪ n
teenage	t i n i dʒ
teenage	t i m eɪ dʒ
teenager	t i m eɪ dʒ ɝ
teenagers	t i m eɪ dʒ ɝ z
teens	t i m z
teh	t æ
tektronix	t ɛ k t ɹ ɑ n ɪ k s
telangana	t ɛ l ə ŋ ɡ ɑ n ə
telecast	t æ l ə k æ s t
telecast	d ɛ l ə k æ s t
telecasts	t æ l ə k æ s t s
telecom	t æ l ə k ɑ m
teleconference	t ɛ l ə k ɑ n f ɹ ə n s
teleport	t ɛ l ə p ɔ ɹ d
telescope	t æ l ə s k oʊ p
telescopes	d ɛ l ə s k oʊ p s
television	t ɛ l ə v ɪ ʃ ə n
television	t ɛ l ə v ɪ ʒ ə m
television	t ɛ l ə f ɪ ʃ ə n
telfer	t æ l f ɝ
telling	t æ l ɪ ŋ
telugu	t ɛ l u ɡ u
temp	t æ m p
temperature	t ɛ m p ɝ ə tʃ ɝ
temple	d ɛ m p ə l
temporal	t ɛ m p ɹ ə l
temporaries	t ɛ m p ɝ ɛ ɹ i z
tempore	t ɛ m p ɔ ɝ
tempore	t ɛ m p ɔ ɹ i
tempura	t ɛ m p ɝ ə
ten	t æ n
ten	d æ n
ten	t ɛ m
tended	t æ n d ɪ d
tendered	t æ n d ɝ d
tendons	t ɛ n d ə n s
teng	t æ ŋ
tennessee	t ɛ m ə s i
tennis	t ɛ m ə s
tennis	t ɛ n ɪ z
tennyson's	t ɛ n i s ə n z
tensor	t ɛ n s ɝ
tent	t æ n t
terbutaline	t ɝ b j u d ə l i n
teresa	t ɝ ɪ s ə
teresa	t ɝ i z ə
teri	t ɛ ɹ i
term	t ɝ n
term	d ɝ m
termed	t ɝ n d
termination	d ɝ m ə n eɪ ʃ ə n
terminology	t ɝ m ə n ɑ l ə dʒ i
terrain	t ɹ eɪ n
terrain	t ɚ eɪ n
terri	t ɛ ɹ i
terrie	t ɛ ɹ i
terrington	t ɛ ɹ ɪ ŋ t ə n
territory's	t ɛ ɹ ɪ t ɔ ɹ i z
terror	t ɛ ɹ
terrorists	t ɛ ɹ ɚ ɪ s t s
terry	t ɛ ɹ ɪ
tesh	t æ ʃ
tesla	t æ s l ə
tesla's	t ɛ s l ə s
tessa	t æ s ə
test	t æ s t
testes	t ɛ s t i s
testing	t ɛ s t ɪ n
testis	t ɛ s t i z
tests	t æ s t s
tet	t ɛ d
tetrahedral	t ɛ t ɹ ə h i d ɹ ə l
texas	t ɛ k s ə z
text	t æ k s t
textile	t æ k s t aɪ l
texts	t æ k s
texture	t æ k s tʃ ɝ
thai	d aɪ
thames	t ɛ n z
than	ð ɛ n
than	θ æ n
thasos	θ eɪ s oʊ s
that	θ æ t
that	ð æ d
that's	ð ɛ t s
thats	ð æ t s
the	ð
the	θ i
the	θ ə
the	θ ɪ
the	θ ʌ
the	ð ɑ
theater	θ i ə d ɝ
theatres	θ i ə t ɝ s
their	θ ɛ ɹ
them	ð ɛ n
them	θ ə m
them	ð æ n
thematic	θ ɪ m ɛ t ɪ k
theme	θ ɪ m
theme	θ i n
themes	θ ɪ m z
themes	θ i n z
then	ð æ n
then	ð ɛ m
thence	θ ɛ n s
theorem	θ i ɝ ə m
theorem	θ i ɹ ə m
theorem	θ ɪ ɝ ə m
theorems	θ i ɝ ə m z
theorems	θ i ɹ ə m z
theories	θ ɪ ɝ i z
theory	θ ɪ ɝ i
theory	θ i ɹ i
theory	θ i ɹ ɪ
thera	θ ɛ ɹ ə
therapies	θ ɛ ɹ ə p i z
therapists	θ ɛ ɹ ə p ɪ s t s
there	ð ɛ
there	ð æ
these	ð ɪ s
these	ð i s
these	θ i z
thesis	θ i z ə s
thessaloniki	θ æ s ə l ə n ɪ k i
thessaly	θ ɛ s ə l i
theta	θ i d ə
they	θ eɪ
thierry	θ i ɹ i
thierry	θ i ɝ i
thin	ð ɪ n
things	θ ɪ ŋ s
thinking	θ ɪ ŋ k ɪ n
third	θ ɝ t
this	θ ɪ s
this	ð i z
this	ð i s
this	θ ə s
this	ð ɪ z
thoas	θ oʊ ə s
thomas	d ɑ m ə s
thompson	t ɑ m p ʃ ə n
thorner	θ ɔ ɹ n ɝ
those	θ oʊ z
though	θ oʊ
thought	θ ɔ d
thrash	θ ɹ ɛ ʃ
thread	θ ɹ ɛ t
threat	θ ɹ ɛ d
threatened	θ ɹ æ t ə n d
thus	θ ʌ s
thwarted	θ w ɔ ɹ t ɪ d
thwarted	θ w ɔ ɹ d ɪ d
thyroid	θ aɪ ɝ ɔɪ d
tibet	d ə p ɛ t
tibetan	d ɪ b ɛ d ə n
tibetan	t ɪ p ɛ t ə n
tidal	t aɪ t ə l
tide	t aɪ t
tides	t aɪ d s
tidy	t aɪ t i
tier	t i ɹ
tiered	t ɪ ɹ d
tiernan	t ɪ ɹ m ə n
tiers	t ɪ ɹ z
ties	d aɪ z
ties	t aɪ s
tigers	t aɪ ɡ ɝ s
tigger	t ɪ ɡ ɝ
tight	d aɪ t
tighter	t aɪ d ɝ
tigres	t i ɡ ɝ z
tilings	t aɪ l i n z
tim	t ɪ n
timber	d ɪ m b ɝ
timbre	t ɛ m b ɝ
timbre	t ɪ m p ɝ
time	t aɪ n
time	d aɪ m
timing	t aɪ n ɪ ŋ
timor	t ɪ m ɔ ɹ
tine	t aɪ m
tinsley	t ɪ n z l i
tinsman	t ɪ n z m ə n
tips	t ɪ b z
tips	t i p s
tire	t aɪ ɹ
tiring	t aɪ ɝ ɪ ŋ
tisdale	t ɪ z d eɪ l
tissue	t ɪ s u
tissue	t ɪ ʃ j u
tissue	d ɪ ʃ u
tissues	t ɪ ʃ j u z
titanium	t aɪ t eɪ n i ə n
titans	d aɪ t ə n z
titans	t aɪ t ə m z
tithe	t aɪ θ
tithes	t aɪ θ s
title	t aɪ d ə l
tito	t ɪ t oʊ
tittle	t ɪ d ə l
titusville	t aɪ t ə s v i l
to	d u
to	d oʊ
to	d ə
to	d ɪ
to	t i
to	d i
tobias	d ə b aɪ ə s
todos	t oʊ d oʊ s
toledo	t ə l i t oʊ
tomcat	t ʌ m k æ t
ton	t ɑ n
tongan	t ɑ ŋ ɡ ə n
tongue	t ɑ ŋ
tongue	t ʌ n
tons	t ɑ n z
too	t ʊ
too	d u
took	d u k
took	t u k
took	d ʊ k
top	t ʌ p
top	d ɑ p
topic	d ɑ p ɪ k
toronto's	t ɝ ɑ n d oʊ z
torque	d ɔ k
torrance	t ɔ ɹ ə n z
torre	t ɔ ɹ
torrens	t ɔ ɹ ə n s
torstar	t ɔ ɹ s t ɑ ɹ
totem	t oʊ d ə m
totems	t oʊ d ə m z
toti	t oʊ d i
tottenham	t ʌ t ə n h æ m
touchdowns	t ʌ tʃ t aʊ n z
tough	t ɑ f
toulouse	t ə l u s
toulouse	t u l u s
tour	t ɔ
tour	t u ɝ
tour	d ɔ ɹ
tour	d ɔ
toured	t ʊ ɝ d
toured	t u ɝ d
touring	t ɔ ɹ ɪ n
touring	t u ɹ ɪ ŋ
tourist	t ʊ ɹ ə s t
tourists	t ʊ ɹ ə s t s
tournament	d ɔ n ə m ə n t
tours	t ɔ ɹ z
tours	t u ɹ z
tours	t u ɝ z
tours	t ʊ ɝ z
touted	t aʊ d ɪ d
toward	t ɔ ɝ d
tower	t aʊ ɹ
towing	d oʊ ɪ ŋ
town	d aʊ n
town	t aʊ m
town's	d aʊ n z
town's	t aʊ n s
towns	d aʊ n z
townsend	t aʊ n s ə n d
township	t aʊ n s ɪ p
toxin	t ɑ k ʃ ə n
tozer	t oʊ s ɝ
trabert	t ɹ æ p ɝ t
track	t ɹ æ ɡ
tracking	d ɹ æ k ɪ ŋ
tracking	t ɹ æ k ɪ n
tracks	t ɹ æ ɡ s
tracks	d ɹ æ ɡ z
trade	t ɹ eɪ t
traded	t ɹ eɪ t ɪ d
trader	t ɹ eɪ t ɝ
traders	t ɹ eɪ t ɝ z
trades	t ɹ eɪ t s
traditionalist	t ɹ ə d ɪ ʃ ə n ə l ɪ s t
trainee	t ɹ eɪ n ɪ
training	d ɹ eɪ n ɪ ŋ
traitors	t ɹ eɪ d ɝ z
traits	t ɹ eɪ d z
trak	t ɹ æ k
tram	d ɹ æ m
trampoline	t ɹ æ m p ə l ɪ n
trams	t ɹ æ n z
tranquility	t ɹ æ n k w ɪ l ɪ t i
trans	t ɹ æ n s
transaction	t ɹ æ n s æ k ʃ ə n
transactions	t ɹ æ n s ɛ k ʃ ə n z
transcended	t ɹ æ n s ɛ n d ɪ d
transcendental	t ɹ æ n s ə n d ɛ n ə l
transducer	t ɹ æ n z d u s ɝ
transducers	t ɹ æ n z d u s ɝ z
transforms	t ɹ æ n s f ɔ ɹ n s
transforms	t ɹ æ n z f ɔ ɹ m z
transfusions	t ɹ æ n s f j u ʒ ə n z
transgender	t ɹ æ n z dʒ ɛ n d ɝ
transgender	t ɹ æ n s dʒ ɛ n d ɝ
transgressions	t ɹ æ n s ɡ ɹ ɛ ʃ ə n z
transgressive	t ɹ æ n s ɡ ɹ ɛ s ɪ v
transistor	t ɹ æ n s ɪ s t ɝ
transitioning	t ɹ æ n z ɪ ʃ ə n ɪ ŋ
translates	t ɹ æ n s l eɪ t s
transliterated	t ɹ æ n z l ɪ t ɝ eɪ t ɪ d
transliteration	t ɹ æ n z l ɪ t ɝ eɪ ʃ ə n
transmissions	t ɹ æ n s m ɪ ʃ ə n z
transmittable	t ɹ æ n s m ɪ t ə b ə l
transmitter	t ɹ æ n z m ɪ t ɝ
transmitters	t ɹ æ n z m ɪ t ɝ z
transmitting	t ɹ æ n z m ɪ t ɪ ŋ
transmutation	t ɹ æ n z m j u t eɪ ʃ ə n
transnational	t ɹ æ n z n æ ʃ ə n ə l
transplantation	t ɹ æ n s p l æ n t eɪ ʃ ə n
transponder	t ɹ æ n s p ɑ n d ɝ
transponders	t ɹ æ n s p ɑ n d ɝ z
transport	t ɹ æ n s p ɔ t
traveled	t ɹ æ f ə l d
travelers	t ɹ æ v l ɝ z
travers	t ɹ ɛ v ɝ z
traverse	t ɹ ə v ɝ z
traverse	t ɹ æ v ɝ s
tre	t ɹ
treasurer	t ɹ ɛ ʃ ɝ ɝ
treasures	t ɹ ɛ ʒ ɝ s
treasury	t ɹ ɛ ʃ ɝ i
treatable	t ɹ i t ə b ə l
treaties	t ɹ i t i s
treatise	t ɹ i t i z
treatise	t ɹ i t i s
treaty	t ɹ i d ɪ
trebles	t ɹ æ b ə l z
tree	t ɹ ɪ
trek	t ɹ æ k
trekkers	t ɹ æ k ɝ z
trekking	t ɹ æ k ɪ ŋ
treks	t ɹ æ k s
trellis	t ɹ ɛ l ə s
tremblay	t ɹ ɛ m p l eɪ
trend	t ɹ ɛ n t
trended	t ɹ ɛ n d ɪ d
trends	t ɹ æ n z
trends	t ɹ ɛ n z
trendy	t ɹ æ n d i
trent	t ɹ æ n t
trespassing	t ɹ ɛ s p æ s ɪ ŋ
tricia	t ɹ ɪ ʃ ə
tricks	t ɹ i k s
tricky	t ɹ ɪ k ɪ
triennial	t ɹ aɪ æ n i ə l
trieste	t ɹ i s t
trieste	t ɹ ɪ s t
trigger	t ɹ ɪ k ɝ
trimmed	t ɹ ɪ m t
trip	t ɹ i p
tripolis	t ɹ ɪ p ə l i z
trish	t ɹ ɪ ʃ
triumvirs	t ɹ aɪ ʌ m f ɝ z
troas	t ɹ oʊ ə s
trombone	t ɹ ʌ m b oʊ n
troubling	t ɹ ʌ b l ɪ ŋ
trove	t ɹ oʊ f
troy	d ɹ ɔɪ
trudeau	t ɹ u t oʊ
trudeau	d ɹ u d oʊ
trudy	t ɝ u d i
trump	t ɹ ɑ m p
trump's	t ɹ ʌ m p s
trumpet	d ɹ ʌ m p ə t
trunk	t ɹ ɑ ŋ k
tsar	s ɑ ɹ
tsar	s ɑ
tsarist	s ɑ ɹ ɪ s t
tseng	s æ ŋ
tuba	t u p ə
tubby	t ʌ p i
tube	t u p
tucking	t ʌ ɡ ɪ ŋ
tudor	t u t ɝ
tudor's	t u t ɝ z
tullahoma	t ɑ l ə h oʊ m ə
tully	t ɑ l i
tulsa	t ɑ l s ə
tulsi	d u l s i
tun	t ɑ n
tundra	t ɑ n d ɹ ə
tungsten	t ɑ ŋ s t ə n
tunisia	t u n i ʃ ə
tunisian	t u n i ʃ ə n
tunisians	d u n i ʃ ə n z
tunnels	d ʌ n ə l z
tunstall	t ɑ n s t ə l
tupman	t ɑ p m ə n
tuppy	t ɑ p i
tuppy	t ʌ b i
tuppy's	d ɑ p ɪ z
turbid	t ɝ p ɪ d
turbot	t ɝ b ɑ t
turf	d ɝ f
turing	t ɝ ɪ n
turkeys	t ɝ k ɪ s
turn	t ɝ m
turn	d ɝ n
turner	d ɝ m ɝ
turnpike	t ɝ m p aɪ k
turns	t ɝ m z
turret	t ɝ ɪ t
turtles	d ɝ t ə l z
turton	t ɝ d ə n
tuskegee	t ə s k i k i
tutti	t u d i
tuttle	t ʌ d ə l
tuttle's	t ʌ d ə l z
tuxedo	t ɑ k s i t oʊ
tweak	t w i ɡ
two	d u
tying	d aɪ ɪ ŋ
tyne	t aɪ m
types	t aɪ p z
tyre	t aɪ ɝ
tyres	t aɪ ɝ z
ubiquitous	j u b ɪ k w ə d ə s
ubuntu	u b u n t u
uffizi	u f i t s i
ugandan	j u k æ n d ə n
uh	ɑ
uist	j ʊ ɪ s t
uist	ʊ ɪ s t
ukrainian	j u k ɹ eɪ n i ə m
ulster	ʌ l s t ɹ
ultima	ɑ l t ə m ə
umbels	ʌ m p ə l z
umbrellas	ə m b ɹ ɛ l ə z
unable	ɑ n ə b ə l
unalaska	ɑ n ə l æ s k ə
unassociated	ʌ n ə s oʊ ʃ i eɪ t ə d
unaware	ə n ə w ɛ ɹ
uncas	ʌ ŋ k ə s
unclear	ʌ n k l ɪ ɹ
undead	ɑ n d ɛ d
undemocratic	ə n d ɛ m ə k ɹ æ t ɪ k
underperformed	ʌ n d ɝ p ɝ f ɔ ɹ m d
underserved	ʌ n d ɝ s ɝ v d
understory	ʌ n d ɝ s t ɔ ɹ i
underwriting	ʌ n d ɝ ɹ aɪ d ɪ ŋ
unemotional	ʌ n ɪ m oʊ ʃ ə n ə l
unequivocal	ʌ n ɪ k w ɪ v ə k ə l
uneventful	ʌ n ɪ v ɛ n t f ə l
unfilled	ə n f i l d
unheard	ə n h ɝ t
unhurt	ə n h ɝ d
unicellular	j u n i s ɛ l j ə l ɝ
unicode	j u n ɪ k oʊ t
uniforms	j u n ɪ f ɔ ɹ m z
unifying	j u n ə f aɪ ɪ n
unique	j u n ɪ k
university	j u n ə f ɝ s ə t i
unleash	ə n l i s
unpaid	ə m p eɪ d
unreleased	ʌ n ɹ i l i s t
unreleased	ə n ɹ i l i s t
unrepentant	ʌ n ɹ ɪ p ɛ n t ə n t
unreported	ʌ n ɹ ɪ p ɔ ɹ t ɪ d
unseat	ə n s ɪ t
unsettling	ə n s æ t ə l ɪ ŋ
unsworth	ʌ n z w ɝ θ
untreatable	ə n t ɹ i t ə b ə l
unusable	ə n j u s ə b ə l
unworthy	ə n w ɝ θ i
up	ɑ p
upholstery	ə p oʊ l s t ɹ i
upmarket	ʌ p m ɑ ɹ k ə t
upper	ɑ p ɝ
uppsala	u p s ɑ l ə
uprising	ʌ p ɹ aɪ z ɪ n
upset	ə b s ɛ t
upstream	ʌ p s t ɹ i n
urartian	ɹ ɑ ɹ ʃ ə n
urban	ɹ b ə n
urbisaglia	ɝ b ə z ɑ ɡ l i ə
urdu	ɹ d u
urine	j ʊ ɹ ə n
urine	j ʊ ɹ i n
urine	j ɹ ə n
urraca	ɹ ɑ k ə
urticaria	ɝ d ɪ k ɑ ɹ i ə
usability	j u s ə b ɪ l ɪ t i
used	j u s d
used	j u z t
usenet	j u z n æ t
usenet	j u s n ɛ t
user	j u s ɝ
users	j u s ɝ z
uses	j u s ɪ s
uses	j u z ə s
usher's	ɑ ʃ ɝ z
using	j u s ɪ ŋ
using	j u z ɪ n
usually	j u z ə l i
usually	j u ʃ ə l i
utica	j u d ɪ k ə
utilizing	j u t ə l aɪ z ɪ n
uxbridge	ɑ k s b ɹ ɪ dʒ
v	f i
vaccinated	f æ k s ə n eɪ t ɪ d
vaccine	f æ k s i n
vader	v eɪ t ɝ
valance	f ɛ l ə n s
valdez	v æ l d ɛ s
vale	f eɪ l
valera	v ə l ɛ ɹ ə
valid	v æ l i d
validity	f ə l ɪ d ɪ t i
valkyrie	v æ l k ɝ i
valley	f ɛ l i
valleys	v ɛ l i z
valve	v æ l f
valve	f ɛ l f
valves	f ɛ l f z
vampire	v æ m p aɪ ɝ
vampires	v æ m p aɪ ɝ z
van	v ɛ n
van	f ɛ n
van	f æ n
vanadium	f ə n eɪ d i ə m
vance	f æ n s
vancouver	v æ ŋ k u v ɝ
vancouver	f æ ŋ k u v ɝ
vanderbilt	v æ n d ɝ b ɪ l d
vanessa	f ə n ɛ s ə
vang	v æ n
vanish	f æ n ɪ ʃ
vargas	v ɑ ɹ ɡ ə s
varies	f ɛ ɹ i z
variety	f ɝ aɪ ə t i
various	f ɛ ɹ i ə s
varma	v ɑ ɹ m ə
vary	f ɛ ɹ i
varying	v ɛ ɹ ɪ ɪ ŋ
vase	f eɪ z
vase	f eɪ s
vases	v ɑ s ɪ z
vassal	v æ z ə l
vassals	v ɛ s ə l z
vassar	v æ ʃ ɝ
vatican	v æ d ɪ k ə n
vatican	v ɛ t ɪ k ə n
vaughan	f ɔ n
vector	f ɛ k t ɝ
vectors	f ɛ k t ɝ z
vectors	f æ k t ɝ z
veer	f ɪ ɹ
vegan	f i ɡ ə n
vegetation	f ɛ dʒ ə t eɪ ʃ ə n
vehicles	f i h ɪ k ə l z
vehicular	v ɪ h ɪ k j ə l ɝ
velvet	v æ l v ɪ t
vendettas	f ɛ n d ɛ t ə z
vendor	f ɛ n d ɝ
vendor	v ɛ n t ɝ
vendors	f ɛ n d ɝ z
venetian	v ə n ɪ ʃ ə n
venezuela	v ɛ n ɪ s w eɪ l ə
vents	v ɛ n d z
venture	f ɛ n tʃ ə
ventus	f ɛ n t ə s
venue	v æ n j u
ver	f ɝ
verboon	f ɝ b u n
vercelli	f ɝ tʃ ɛ l i
verdigris	v ɝ t ə ɡ ɹ ɪ s
vergara	f ɝ ɡ ɑ ɹ ə
veritable	v ɛ ɹ ɪ t ə b ə l
verlaine	f ɝ l eɪ n
verner	f ɝ n ɝ
vernix	f ɝ n ɪ k s
verse	f ɝ s
verse	v ɝ z
version	v ɝ ʃ ə n
version	v ɝ s ə n
version	f ɝ ʃ ə n
versions	v ɝ ʃ ə n z
versions	v ɝ s ə n z
versus	f ɝ s
vertebrate	v ɝ t ə b ɹ eɪ d
vertices	v ɝ d ɪ s i z
verve	f ɝ v
very	f ɛ ɹ i
vesicles	v ɛ s ɪ k ə l z
vessel	v æ s ə l
vessel	f ɛ s ə l
vessels	f ɛ s ə l z
vestibular	v ɛ s t ɪ b j ə l ɝ
vestigial	v ɛ s t ɪ dʒ i ə l
veterinarian	v ɛ t ɝ ə n ɛ ɹ i ə n
veterinarians	v ɛ t ɝ ə n ɛ ɹ i ə n z
veterinary	v ɛ t ɝ ə n ɛ ɹ i
veto	v i d oʊ
vetoed	v i d oʊ d
vetter	v ɛ d ɝ
via	f i ə
via	f aɪ ə
via	f ɪ ə
vibhu	f i b u
viborg	v i b ɝ ɡ
vibrant	f aɪ b ɹ ə n t
vic	f ɪ k
vicarious	f ə k ɛ ɹ i ə s
vicenza	f ɪ s ɛ n z ə
viceroy	v aɪ s ɝ ɔɪ
vichy	v ɪ ʃ i
vicious	v ɪ ʃ ə z
vicki	f ɪ k i
vicki	v i k i
victoria's	v ɪ k t ɔ ɹ i ə s
victories	v ɪ k t ɹ i s
victory's	v ɪ k t ɝ i z
vicus	v ɪ k ə z
video	v i d i oʊ
video	f i d i oʊ
video	f ɪ d i oʊ
vidrine	v ɪ d ɹ i n
vieira	v i ɛ ɹ ə
viereck	v i ɹ ɪ k
view	f j u
viewing	f j u ɪ ŋ
views	f j u z
views	v j u s
vigour	v ɪ ɡ ɝ
viking	v aɪ k ɪ n
vikings	v aɪ k ɪ n z
vila	v ɪ l ə
villa	v i l ə
villa	f i l ə
villa	f ɪ l ə
village	f ɪ l ɪ dʒ
vincenz	v ɪ n tʃ ɛ n z
vincenzo	v ɪ n tʃ ɛ n z oʊ
vine	f aɪ n
vinegar	f ɪ n ɪ k ɝ
vini	v ɪ n i
virgilio	v ɝ dʒ i l i oʊ
virgin	f ɝ dʒ ɪ n
virginia	f ɝ dʒ ɪ n j ə
virginius	v ɝ dʒ ɪ n j ə z
virtually	f ɝ tʃ u ə l i
vis	v i s
visas	v i s ə z
visby	v ɪ s p i
visby	v ɪ z b i
viscardi	v ɪ s k ɑ ɹ d i
viscous	f ɪ s k ə z
vises	v aɪ s ɪ z
visibility	v ɪ s ə b ɪ l ɪ t i
visible	v ɪ s ə b ə l
visible	v i z ə b ə l
visible	v ɪ ʒ ə b ə l
visible	f ɪ s ə b ə l
visible	f ɪ z ə b ə l
visigoths	v ɪ s ə ɡ ɑ θ s
vision	f ɪ ʃ ə n
visit	f ɪ s ɪ t
visitation	v ɪ s ə t eɪ ʃ ə n
visitor	f ɪ ʃ ə t ɝ
visitors	v ɪ z ɪ t ɝ s
visits	v ɪ s ɪ t s
vistula	f ɪ s tʃ u l ə
vita	v aɪ d ə
vital	f aɪ t ə l
vitale	f ɪ t ɑ l i
vito	v i d oʊ
vitro	v i t ɹ oʊ
vitry	v i t ɹ i
vittorio	v ɪ t ɔ ɹ i oʊ
vivian	v i v i ə n
vividly	f ɪ f ə d l i
viz	v ɪ z
vizier	v ɪ z i ɝ
vizier	v i z ɪ ɝ
vizier	v i z i ɹ
vocables	f oʊ k ə b ə l z
vocal	f oʊ k ə l
vocalized	f oʊ k ə l aɪ z d
vocals	f oʊ k ə l z
vocational	f oʊ k eɪ ʃ ə n ə l
vogel	f oʊ k ə l
vogue	f oʊ k
vogue	v oʊ k
voiced	f ɔɪ s t
voiceless	f ɔɪ s l ə s
voices	f ɔɪ s ɪ z
voided	v ɔɪ t ɪ d
volcanic	f ɑ l k æ n ɪ k
volga	v ʌ l ɡ ə
voss	f ɔ s
vote	f oʊ t
votes	v oʊ d z
wada	w ɑ t ə
wadded	w ɑ t ɪ d
waddington	w ɑ t ɪ ŋ t ə n
waddle	w ɑ t ə l
wading	w eɪ t ɪ ŋ
wadis	w ɑ d i z
waffle	w ʌ f ə l
wagner	v ɑ ɡ n ɝ
wagner	f ɑ ɡ n ɝ
waiting	w eɪ d ɪ ŋ
walker	w ɑ k ɝ
walking	w ɔ k ɪ n
wallis	w ɔ l i s
walls	w ɔ l s
wallstreet	w ɔ l s t ɹ i t
walmsley	w ɔ l m z l i
walnuts	w ɔ l n ɑ t s
walser	w ɔ l s ɝ
walsingham	w ɔ l z ɪ ŋ h æ m
walsworth	w ɔ l z w ɝ θ
walt	w ɔ l d
wan	w ʌ n
wanda	w ɑ n t ə
wandering	w ʌ n d ɝ ɪ ŋ
war	w ɔ ɝ
warehousing	w ɛ ɹ h aʊ s ɪ ŋ
wareing	w ɛ ɹ ɪ ŋ
warhead	w ɔ ɹ h æ d
warhurst	w ɔ ɹ h ɝ s t
warm	w ɔ ɹ n
warneke	w ɔ ɹ n ɪ k
waronker	w ɔ ɹ ɑ ŋ k ɝ
warrior	w ɔ ɹ i ɝ
warriors	w ɔ ɹ i ɝ z
wars	w ɔ ɹ s
warwick	w ɔ ɹ ɪ ɡ
was	w ɑ s
was	w ɔ s
was	w ʌ s
was	w ɑ ʃ
watch	w ɑ t s
watchet	w ɑ tʃ ə d
water	w ɔ ɾ ɝ
water	w ɔ t ɚ
waters	w ɑ t ɝ z
watershed	w ɔ t ɝ s ɛ d
watervliet	w ɔ t ɝ f l i t
watkins	w ʌ t k ɪ n z
watrous	w ɑ t ɹ ə s
watt	w ʌ t
wattle	w ɑ d ə l
wattles	w ɑ d ə l z
watty	w ɑ d i
waves	w eɪ v s
wavy	w eɪ f i
we	w ɪ
we're	w ɛ ɹ
weapons	w ɛ b ə n z
wearing	w ɛ ɹ ɪ n
weathersby	w ɛ ð ɝ z b i
webb	w ɛ p
weed	w i t
weft	w æ f t
weighed	w eɪ t
weight	w eɪ d
weighted	w eɪ d ɪ d
weights	w eɪ t z
weir	w i ɝ
weir's	w ɪ ɹ z
weirs	w i ɝ z
weiser	w aɪ z ɝ
weismann's	w aɪ z m ə n z
weissman	w aɪ z m ə n
wellborn	w ɛ l b ɔ ɹ n
wellesley	w ɛ l s l i
wellhead	w ɛ l h æ d
wells	w ɛ l ʃ
wellsville	w ɛ l z v ɪ l
welsh	w ɛ l z
welsh	w ɛ l s
wembley	w ɛ n b l i
wendorf	w ɛ n d ɔ ɹ f
wensleydale	w ɛ n z l i d eɪ l
went	w ɛ n d
wesleyan	w ɛ s l i ə n
wesleyans	w ɛ s l i ə n z
west	w æ s t
westphalian	w ɛ s t v eɪ l j ə n
westville	w ɛ s t f ɪ l
wetzel	w ɛ t s ə l
wexford	w ɛ k s f ɝ t
wharton	w ɔ ɹ d ə n
wharves	w ɔ ɹ f s
wheaties	w i d i z
wheel	w ɪ l
wheelchair	w ɪ l tʃ ɛ ɹ
wheelock	w ɪ l ɑ k
wheels	w ɪ l z
whelan	w i l ə m
when	w æ n
where	w ɛ ɹ
where's	w ɛ ɹ z
whereas	w ɛ ɹ æ z
whereas	h w ɛ ɹ æ s
whereas	w ɛ ɹ æ s
wherein	w ɛ ɹ ɪ n
whereupon	w ɛ ɹ ə p ɑ n
wherever	w ɛ ɹ ɛ v ɝ
whichever	w ɪ tʃ ɛ v ɝ
whig	w i k
whimsical	h w ɪ m s ɪ k ə l
whimsical	w ɪ m s ɪ k ə l
whisper	w ɪ ʃ p ɝ
whitacre	w ɪ t ə k ɹ
white	h w aɪ d
whitgift	w ɪ t k ɪ f t
whittier	w ɪ t ɪ ɹ
whittier	h w ɪ t ɪ ɹ
whittle's	w ɪ d ə l z
who's	h u s
whoopee	w ʊ b i
wicked	w ɪ k ə t
wicked	w ɪ k d
wicked	w ɪ k ɪ t
wicker	w i k ɝ
wicket	w i k ə t
wide	w aɪ t
wider	w aɪ t ɝ
widow	w i d oʊ
widths	w ɪ t θ s
wier	w ɪ ɹ
wigley	w ɪ k l i
wii	w ɪ
wikipedia	w ɪ k ə p i t i ə
wikis	w i k ɪ z
wilfried	w ɪ l f ɹ ɪ d
will	w i l
willamette	w ɪ l ə m ɛ d
willed	w i l d
willesden	w ɪ l ɪ s t ə n
williamsport	w ɪ l j ə m z p ɔ ɹ t
williamstown	w ɪ l j ə m z t aʊ n
willmore	w ɪ l m ɔ ɹ
wills	w ɪ l s
wimbledon	w ɪ m b ə l t ə n
windom	w ɪ n d ə n
windsor	w ɪ n s ɝ
wing	w ɪ n
wingers	w ɪ n ɝ z
winkle	w ɪ ŋ ɡ ə l
winning	w i n ɪ ŋ
winslett	w ɪ n z l ɪ t
winslow	w ɪ n z l oʊ
winter	w ɪ n ɝ
winterbourne	w ɪ n t ɝ b ɔ ɹ n
wiped	w aɪ p d
wire	w aɪ ɝ
wire	w aɪ ɚ
wireless	w aɪ ɝ l ə s
wires	w aɪ ɝ z
wisdom	w ɪ s t ə m
wise	w aɪ s
wisent	w ɪ s ə n t
wishing	w ɪ ʃ ɪ n
wisner	w ɪ z n ɝ
wissner	w ɪ z n ɝ
with	w i θ
with	w i v
with	w i ɪ
with	w ɪ f
without	w ɪ θ aʊ t
witte	w i t
witte	w ɪ d
wittgenstein	w ɪ t k ə n s t aɪ n
witty	w ɪ d i
wives	w aɪ f s
wizard	w ɪ s ɝ d
wolfram	w ʊ l f ɹ ə m
wolverine	w ʊ l f ɝ i n
wolverton	w ʊ l f ɝ t ə n
wolves	w ʊ l f s
women	w i m ə n
women's	w ɪ m ə n s
wonder	w ɑ n d ɝ
wonderin	w ʌ n d ɝ ɪ ŋ
wood	w u d
wood	w ʊ t
woods	w u t s
woodson	w ʊ d z ə n
wool	w u l
woolsey	w ʊ l s i
wooster	w ʊ s t ɝ
wooster	w u ʃ t ɝ
wooten	w u d ə n
wootton	w u d ə n
worcestershire	w ʊ s t ɝ ʃ ɝ
worcestershire	w ɪ s t ɝ ʃ ɪ ɹ
word	w ɝ t
wording	w ɝ d ɪ n
words	w ɝ d s
worked	w ɝ k d
workers	w ɝ k ɝ s
working	w ɝ k ɪ n
worthing	w ɝ ð ɪ ŋ
wotan	w oʊ d ə n
would	w ʊ t
wound	w u n t
wrangling	ɹ æ ŋ k l ɪ ŋ
wreckage	ɹ æ k ɪ dʒ
wrecked	ɹ ɛ k d
wrecks	ɹ æ k s
wrestler	ɹ ɛ s l ɝ
wrestlers	ɹ ɛ s l ɝ z
wrestling	ɹ ɛ s l ɪ n
wrestling	ɹ ɛ s ə l ɪ n
wretched	ɹ ɛ tʃ ɪ t
write	ɹ aɪ d
writer	ɹ aɪ d ɝ
writers	ɹ aɪ d ɝ z
writing	ɹ aɪ d ɪ ŋ
written	ɹ ɪ d ə n
written	ɝ ɪ t ə n
wrote	ɹ oʊ d
wum	w ɑ m
wurzburg	w ɝ s b ɝ ɡ
wuthering	w ʌ ð ɹ ɪ ŋ
wyndham	w ɪ n t ə m
wyre	w aɪ ɝ
x	æ k s
xander	z æ n d ɝ
xander	s æ n d ɝ
xanthippus	s ɛ n θ ɪ b ə s
xanthos	z æ m θ oʊ s
xanthos	z æ n θ oʊ s
xavier	s eɪ v j ɝ
xavier's	s eɪ v j ɝ z
xeric	z ɪ ɹ ɪ k
xerox	s ɪ ɹ ɑ k s
xerox	z ɪ ɹ ɑ k s
xmas	s m ə s
xtra	ɛ k s t ɹ ə
xuan	z w ɑ n
yablonsky	j ə p l ɑ n s k i
yachting	j ɑ d ɪ ŋ
yachts	j ɑ t z
yahya	j ɑ j ə
yamada	j ə m ɑ t ə
yancy	j æ n z i
yangtze	j æ ŋ s i
yankees	j æ ŋ k i s
yard	j ɑ t
yarrell	j ɛ ɹ ə l
yasna	j æ ʃ n ə
yeah	j ɛ
year	j ɪ ɚ
yearlong	j ɪ ɹ l ɔ ŋ
years	j ɪ ɚ z
years	j ɪ ɹ s
yearwood	j ɪ ɹ w ʊ d
yemen	j æ m ə n
yemeni	j ɛ m ɪ n i
yen	j æ n
yerevan	j ɛ ɹ ə v ə n
yes	j ɛ z
yeti	j ɛ d i
yiddish	j ɪ t ɪ ʃ
yiddish	j i d ɪ ʃ
ynez	ɪ n ɛ z
yonge	j ʌ n dʒ
yorkshire	j ɔ ɹ k ʃ ɝ
yorkshire	j ɔ ɹ k ʃ aɪ ɝ
you're	j ʊ ɹ
younger	j ʌ ŋ ɡ ɝ
younger	j ʌ ŋ ɚ
youngstown	j ʌ ŋ s t aʊ n
your	j u ɹ
youre	j u ɹ
yt	i
yttrium	i t ɹ i ə m
yugoslav	j u k ə s l ɑ v
yugoslavia	j u k ə s l ɑ v i ə
yury	j ʊ ɹ i
yvonne	i v ɑ n
z	s
z	s ɛ d
zab	z æ p
zabriskie	s ɛ b ɹ ɪ s k i
zachary	s æ k ɝ i
zack's	s ɛ k s
zadora	z ə d ɔ ɹ ə
zambia	s æ m b i ə
zanzibar	z æ n s ə b ɑ ɹ
zara	z ɛ ɹ ə
zawiya	z ɑ w i ə
zealand	s i l ə n d
zealand's	s i l ə n d z
zealous	s ɛ l ə s
zecca	s ɛ k ə
zeitgeist	z aɪ d k aɪ s t
zeke	s i k
zelda	s ɛ l d ə
zen	z æ n
zephaniah	s ɛ f ə n aɪ ə
zero	z i ɹ oʊ
zero	s ɪ ɹ oʊ
zero's	z i ɹ oʊ z
zeta	z eɪ d ə
zeta	z i d ə
zeus	z u z
zhou	z u
zicari	z ɪ k ɑ ɹ i
ziegler	z ɪ ɡ l ɝ
ziemba	z ɪ m b ə
zigzags	s ɪ ɡ z æ ɡ z
zimbabwe	s ɪ m b ɑ b w eɪ
zimmer	s ɪ m ɝ
zinc	s ɪ ŋ k
zither	z ɪ θ ɝ
zombies	z ɑ m b i s
zone	s oʊ n
zoned	s oʊ n d
zones	s oʊ n z
zoo	s u
zoological	s u ə l ɑ dʒ ɪ k ə l
zoos	s u z
zorka	s ɔ ɹ k ə
