a	æ i
a	ʌ
a	ɛ
aaron's	æ ɹ ə n z
aberration	æ p ɝ eɪ ʃ ə n
abort	ə b ɔ ɹ d
activision	æ k t ɪ v ɪ z ə m
ada	æ t ə
adams	æ d ə n z
addition	ə d ɪ ʒ ə n
additive	æ t ə t ɪ v
admired	æ d m aɪ ɝ d
adverse	æ d f ɝ s
advices	æ d v aɪ z ɪ z
aeronautics	ɛ ɹ ə n ɔ t ɪ k s
aesthetics	æ s θ ɛ t ɪ k s
africans	æ f ɹ ɪ k ə n s
ago	ə k oʊ
ainslie	eɪ n s l i
ainsworth	eɪ n z w ɝ θ
air	æ
airbus	æ b ʌ s
aircraft's	ɛ ɹ k ɹ æ f t s
airfields	ɛ ɹ f i l d z
airforce	ɛ ɹ f ɔ ɹ s
airworthiness	ɛ ɹ w ɝ ð i n ə s
album	æ l b ə n
album	ɛ l b ə m
album's	æ l b ə n z
alcyon	ɛ l s i ə n
alfredo	ɛ l f ɹ eɪ d oʊ
algorithm	æ l ɡ ɹ ɪ ð ə m
algorithm	æ l k ɝ ɪ ð ə m
ali	æ l ɪ
alice	ɛ l ə s
allegiance	ə l i dʒ ə n z
allen	ɛ l ə n
alma	ɛ l m ə
alonso	ə l ɑ n z oʊ
also	ɔ l z oʊ
alumni	ə l ɑ m n aɪ
amateur	æ m ə tʃ ʊ ɹ
ambushed	ɛ m b ʊ ʃ t
american	ə m ɛ ɹ ɪ k ə n
amma	ɛ m ə
amtrak	æ m t ɹ æ k
an	ɛ n
analyses	ə n æ l ɪ s ɪ s
analyzed	ɛ n ə l aɪ z d
anchor	æ n k ɝ
anchor	æ n k ə
anchored	æ n k ɝ d
and	ɛ n d
and	ɛ n t
andre	ɑ n d ɹ i
angeles	æ n dʒ ə l i z
angeles	æ n dʒ ə l i s
ann	ɛ n
anne	ɛ n
annie	ɛ n i
answer	æ n s ə
anthropology	ɛ n θ ɹ ə p ɑ l ə dʒ i
appling	æ p l ɪ n
aquarium	ə k w ɛ ɹ i ə n
aramid	æ ɹ ə m i d
arbor	ɑ p ə
arctic	ɑ ɹ t ɪ k
are	ɹ
are	ʌ ɹ
area's	ɛ ɹ i ə z
argentinian	ɑ ɹ dʒ ə n t ɪ n i ə n
argus	ɑ ɡ ə z
around	ɹ aʊ n d
arrest	ɹ ɛ s t
arrival	ɹ aɪ v ə l
arrives	ɹ aɪ v z
art	ɑ d
artist's	ɑ ɹ t ə s t s
artworks	ɑ ɹ t w ɝ k s
as	ə z
asiatic	eɪ z i æ t ɪ k
aside	ə s aɪ t
aspirin	æ s p ɝ ɪ n
associated	ə s oʊ ʃ i eɪ t ə d
associating	ə s oʊ ʃ i eɪ t ɪ ŋ
association	ə s oʊ s i eɪ ʃ ə n
assumed	ə ʃ u m d
asteroid	æ s t ɹ ɔɪ d
asteroids	æ s t ɹ ɔɪ d z
auden	ɔ d ə m
autumn	ɔ d ə m
award	ə w ɔ t
azure	æ ʃ ə
bab	b æ p
bagging	b æ ɡ ɪ n
bags	b æ k s
ballet	b ɛ l eɪ
bancroft	b æ ŋ k ɹ ɔ f t
bang	b æ ŋ k
bantry	b æ ŋ t ɹ i
baptist	b æ p t ə s
baptist	p æ p t ə s
barbara	b ɑ ɹ b ɹ ə
barbara's	b ɑ ɹ b ɝ ə s
baritone	b æ ɹ ə t oʊ n
barrel	b ɛ ɹ ə l
barrington	b ɛ ɹ ɪ ŋ t ə n
barron	b æ ɹ ə n
barry	b ɛ ɹ i
base	b eɪ z
batting	b ɛ t ɪ ŋ
batting	b æ d ɪ ŋ
be	b ɪ
bear	b ɛ
beat	b i d
beatles	b i d ə l z
became	b ɪ ɡ eɪ m
became	b ɪ k eɪ n
beck	b æ k
beck's	b æ k s
becquerel	b ɛ k ɹ ə l
bedford	b ɛ t f ɝ t
been	b ə ŋ
beer	b i
being	b i ɪ n
belgrade	b ɛ l ɡ ɹ eɪ t
belize	b ə l i s
bemba	b ɛ n b ə
bengal	b æ ŋ ɡ ə l
benzyl	b æ n z ɪ l
berenice	b ɛ ɹ ə n i s
berlin	b ɝ l ɪ ŋ
bert	b ɝ d
beryllium	p ɝ ɪ l i ə m
beswick	b ɛ z w ɪ k
bexley	b æ k s l i
bid	b ɪ t
billed	b ɪ l t
bills	b ɪ l s
birdied	b ɝ t i d
blackwood	b l æ k w ʊ t
blessed	b l ɛ s d
blockbuster	b l ɑ k b ʌ s t ɝ
blog	b l ɑ k
blog	b l ʌ ɡ
board	b ɔ t
boaters	b oʊ d ɝ z
boating	b oʊ d ɪ ŋ
boats	b oʊ t z
bodley	b ʌ d l i
body	b ʌ d i
body	b ʌ ɾ i
bomb	b ʌ m
bombs	b ʌ m z
bonkers	b ʌ ŋ k ɝ z
bonnie	b ʌ n i
bons	b ɑ n z
booed	b u t
boomed	b u n d
borough	b ɑ ɹ ə
borten	b ɔ ɹ t ə n
bosnia	b ʌ z n i ə
botanic	p ə t æ n ɪ k
botches	b ʌ tʃ ɪ z
bottom	b ɑ t ə n
boulevard	b ʊ l ə v ɑ d
boundary	b aʊ n d ɝ i
brackets	b ɹ æ k ə t s
bradford	b ɹ ɛ d f ɝ d
brannan	b ɹ ɛ n ə n
brannon	b ɹ æ m ə n
brasilia	b ɹ ə z ɪ l j ə
brendan	b ɹ æ n d ə n
brent	b ɹ æ n d
brickman	b ɹ ɪ k m ə n
brinsmade	b ɹ ɪ n z m eɪ d
brinson	b ɹ ɪ n s ə n
britain	p ɹ ɪ d ə n
broadcasters	b ɹ ɔ d k æ s t ɝ z
brodie	b ɹ oʊ d i
bronstein	b ɹ ɑ n s t i n
bronwyn	b ɹ ɑ n w ɪ n
brummell	b ɹ ɑ m ə l
buckinghamshire	b ʌ k ɪ ŋ h æ m ʃ aɪ ɝ
buckland	b ɑ k l ə n d
built	b ɪ l d
burgos	b ɝ ɡ oʊ s
burke	b ɝ ɡ
burma	b ɝ n ə
bursary	b ɝ s ɹ i
bus	b ɑ s
business	b ɪ s n ɪ s
button	b ɑ t ə m
by	p aɪ
cab	k æ p
cadillac	k æ t ə l æ k
calibre	k æ l ə b ɹ
came	k eɪ n
cameras	k æ m ɹ ə s
cameron	k æ m ɹ ə n
canberra	k æ m b ɹ ə
cannon	k æ m ə n
canterbury	k ɛ n t ə b ɝ i
canyon	k ɛ n j ə n
caracalla	k æ ɹ ə k ɛ l ə
card	k ɑ t
cardiac	k ɑ d i æ k
care	k ɛ
care	k æ
career	k ɝ i ɹ
carmel	k ɑ ɹ m ə l
caroline	k ɛ ɹ ə l i n
carrie	k æ ɹ i
carried	k æ ɹ i d
carrier	k ɛ ɹ i ə
carrier	k æ ɹ i ə
carrington	k ɛ ɹ ɪ ŋ t ə n
carroll	k ɛ ɹ ə l
carrollton	k ɛ ɹ ə l t ə n
carry	k ɛ ɹ i
carter	k ɑ d ə
carthusian	k ɑ ɹ θ u s i ə n
case	k eɪ z
casseroles	k æ s ɹ oʊ l z
cast	k ʌ s t
causes	k ɔ s ɪ z
ceased	s i z d
ceases	s i z ɪ z
cell	z ɛ l
cells	s æ l z
census	s ɛ n s ə z
centum	s æ n t ə m
cephas	s ɛ f ə s
chancellor	tʃ æ n s l ɝ
chant	tʃ æ m t
character	k ɛ ɹ ə k t ə
charismatic	k ɛ ɹ ɪ z m æ t ɪ k
chaska	tʃ ɛ s k ə
chen	tʃ æ n
chess	tʃ æ s
china's	tʃ aɪ n ə s
chios	tʃ i oʊ s
chittenden	tʃ ɪ t ə n t ə n
choirs	k w aɪ ɝ z
choose	tʃ u s
chrismon	k ɹ ɪ s m ə n
chromosomes	k ɹ oʊ m ə z oʊ n z
citizen	s ɪ t ə s ə n
citizens	s ɪ t ə s ə n z
clarence	ɡ l ɛ ɹ ə n z
clarification	k l æ ɹ ə f ə k eɪ ʃ ə n
clarity	k l ɛ ɹ ə d i
class	k l ʌ z
cleaning	k l ɪ n ɪ ŋ
cleansed	k l ɛ n s t
clifden	k l ɪ f t ə n
cliff	ɡ l ɪ f
clinton	k l ɪ ŋ t ə n
clog	k l ʌ k
close	k l oʊ s
clot	k l ɑ d
club	k l ʌ p
clumsily	k l ʌ m z ə l i
clypeus	k l ɪ p i ə s
coatings	k oʊ d ɪ ŋ z
cocking	k ɑ k ɪ n
coding	k oʊ t ɪ ŋ
coherence	k oʊ h i ɹ ə n s
collaborative	k ə l æ b ɹ ə t ɪ v
collar	k ʌ l ɝ
coloration	k ɑ l ɝ eɪ ʃ ə n
colour	k ɑ l ɝ
columbus	k ə l ʌ m p ə s
columnist	k ɑ l ə n ɪ s t
columns	k ɑ l ə n s
combatant	k ɑ m p ə t ə n t
comedy	k ɑ m ə t i
comic	k ɑ n ɪ k
commemorative	k ə m ɛ m ɝ ə t ɪ v
common	k ʌ m ə n
comparable	k ə m p ɛ ɹ ə b ə l
comparable	k ɑ m p ɹ ə b ə l
compare	k ə m p æ
comparison	k ə m p æ ɹ ə s ə n
complementary	k ɑ m p l ə m ɛ n t ɹ i
complementary	k ɑ m p l ə m ɛ n t ɝ i
compositions	k ɑ m p ə z ɪ ʃ ə n s
computers	k ə m p j u t ə s
condominium	k ɑ n d ə m i n i ə m
conferencing	k ɑ n f ɹ ə n s ɪ ŋ
congressional	k ə ŋ ɡ ɹ ɛ ʃ ə n ə l
conscientious	k ɑ n s i ɛ n ʃ ə s
consequence	k ɑ n s i k w ə n s
consumer	k ə n s u m ə
consumes	k ə n ʃ u m z
contrast	k ə n t ɹ æ s t
converters	k ə n v ɝ d ɝ z
conway's	k ɑ m w eɪ z
corrected	k ɹ ɛ k t ɪ d
corrosion	k ɹ oʊ ʒ ə n
court	k ɔ ɹ d
cover	k ʌ f ɝ
coverage	k ʌ v ɝ ɪ dʒ
covers	k ʌ f ɝ z
cowdray	k aʊ d ɝ eɪ
crabs	k ɹ æ p s
crafted	k ɹ æ f t ɪ d
crafted	ɡ ɹ æ f t ɪ d
crafts	k ɹ æ f s
craftsmanship	k ɹ æ f s m ə n ʃ ɪ p
credibility	k ɹ ɛ d ə b ɪ l ɪ t i
cremated	k ɹ ɪ m eɪ t ɪ d
crippling	k ɹ ɪ p l ɪ ŋ
crismon	k ɹ ɪ z m ə n
critique	k ɹ ə t i k
crooked	k ɹ ʊ k d
cropland	k ɹ ɑ p l æ n d
crosby	k ɹ ɔ s b i
cruciate	k ɹ u ʃ i ə t
cruel	k ɹ u l
crum	k ɹ ɑ m
crusher	k ɹ ɑ ʃ ə
cubs	k ɑ b z
cuddy	k ʌ t i
cuisine	k w i z i n
cullen	k ɑ l ə n
cup	k ɑ p
cup	k ʌ b
curatorial	k j ʊ ɹ ə t ɔ ɹ i ə l
curry	k ɑ ɹ i
cushion	k ʊ ʃ ə m
cut	k ɑ d
cut	k ɑ t
cypriots	s ɪ p ɹ i ɑ t s
dad	d ɛ d
dallas	d ɛ l ə s
danny	d ɛ n i
danzig	d æ n z ɪ k
dark	d ɑ ɡ
daryl	d æ ɹ ə l
dassler	d ɛ z l ɝ
daventry	d ɛ v ə n t ɹ i
davies	d eɪ v ɪ s
davis	d eɪ v ɪ z
day's	d eɪ s
days	d eɪ s
de	d ɪ
dead	d ɛ t
deanship	t i n ʃ ɪ p
deborah	d ɛ b ɹ ə
debugging	d ɪ b ʌ ɡ ɪ ŋ
decentralization	d i s ɛ n t ɹ ə l ɪ z eɪ ʃ ə n
decision	d ɪ s ɪ ʃ ə n
decision	d ɪ z ɪ ʃ ə n
deck	d æ k
decorative	d ɛ k ɝ ə t ɪ v
decreased	d ɪ k ɹ i s t
decryption	d i k ɹ ɪ p ʃ ə n
dede	d ɪ d
deep	t i p
degree	d ɪ k ɹ i
deliberately	d ɪ l ɪ p ɹ ə t l i
delivery	d ɪ l ɪ v ɹ i
denim	d ɛ n ə n
depicts	t ɪ p ɪ k s
depopulation	d i p ɑ p j ə l eɪ ʃ ə n
deserted	d ɪ s ɝ t ɪ d
deserves	d i z ɝ v z
desperate	d ɛ s p ɹ eɪ t
detailed	d i t eɪ l d
detailing	d i t eɪ l ɪ ŋ
detroit	d ɪ t ɹ ɔɪ t
diagnosed	d aɪ ə ɡ n oʊ z d
dichotomy	d aɪ k ɑ d ə m i
did	d ɪ t
differently	d ɪ f ɝ ə n t l i
dilley	d i l i
dim	t ɪ m
diocese	d aɪ ə s ɪ s
director	d ɝ ɛ k t ɹ
discoveries	d ɪ s k ʌ v ɹ i z
discussed	d ɪ s ɡ ʌ s t
disguised	d ɪ s k aɪ z d
dispersion	d ɪ s p ɝ ʃ ə n
distinct	d ɪ s d ɪ ŋ k t
diverse	d ɪ v ɝ z
doctoral	d ɑ k t ɹ ə l
doctrine	d ɑ k t ɹ i n
dodge	d ʌ dʒ
does	d ɑ z
dollar	d ʌ l ɝ
dollery's	d ʌ l ɝ i z
don	d ʌ n
donnie	d ʌ n i
dorsal	d ɔ z ə l
dorsally	d ɔ ɹ s ə l i
doubles	t ʌ b ə l z
dowdy	d aʊ t i
drabble	t ɹ æ b ə l
dredd	d ɹ ɛ d
drive	t ɹ aɪ f
drs	t ɝ z
drupe	t ɹ u p
drusilla	t ɹ u s ɪ l ə
druze	t ɹ u z
due	t u
dumas	d u m ə s
dumfries	d ʌ m f ɹ i z
dundas	d ʌ n d ə s
during	t ɹ ɪ n
during	d ʊ ɹ ɪ n
duties	d u d i z
dwarves	d w ɔ ɹ f s
east	ɪ s t
eat	i d
ebook	i b ʊ k
ecclesiastical	ɛ k l i s i æ s t ɪ k ə l
ecuadorian	ɛ k w ə d ɔ ɹ i ə n
eddie	ɛ t i
edinburgh	ɛ d ə m b ɝ ɡ
edit	æ d ɪ d
edition	ɪ d ɪ ʒ ə n
eggs	æ k s
either	aɪ θ ɝ
elaine	i l eɪ n
elementary	ɛ l ə m ɛ n t ɹ i
elena	ɛ l i n ə
elevated	æ l ə v eɪ t ɪ d
ellison	æ l ɪ s ə n
embrun	æ m b ɹ ə n
emerald	ɛ m ɝ ə l d
emeralds	ɛ m ɝ ə l d z
emitter	ɪ m ɪ t ə
emperor	ɛ m p ɝ ə
emphysema	ɛ m f ə s i m ə
end	æ n d
endear	ɛ n d ɪ ɹ
endearing	ɛ n d ɪ ɹ ɪ ŋ
enduring	ɪ n d ʊ ɹ ɪ ŋ
enduring	ɪ n d j ʊ ɹ ɪ ŋ
enforced	ɪ m f ɔ ɹ s t
engine	æ n dʒ ɪ n
engines	ɛ n dʒ ə n s
england	ɪ n ɡ l ə n d
enquiry	ɪ n k w aɪ ɝ i
enrique	æ n ɹ i k
ensued	ɪ n ʃ u d
ensured	ɪ n ʃ ʊ ɹ d
entropy	æ n t ɹ ə p i
epsilon	æ p s ə l ɑ n
epsom	ɛ p s ə n
era	ɪ ɹ ə
error	ɛ ɹ
error	ɛ ɝ
erupted	ɪ ɹ ʌ p t ɪ d
eruptions	ɪ ɹ ʌ p ʃ ə n z
escalators	ɛ s k ə l eɪ d ɝ z
essential	ɪ s ɛ n tʃ ə l
essential	ɪ z æ n ʃ ə l
evaluation	i v æ l j u eɪ ʃ ə n
evans's	ɛ v ə n s ɪ z
evasion	ɪ v eɪ ʒ ə n
eventually	i v ɛ n tʃ u l i
evoked	ɪ v oʊ k t
evolution	ɛ v ə l u ʒ ə n
exception	ɪ ɡ z ɛ p ʃ ə n
exclusionary	ɪ k s k l u ʒ ə n ɛ ɹ i
executed	ɛ ɡ s ə k j u t ɪ d
executive	ɪ k z ɛ k j ə t ɪ v
exile	ɛ k s aɪ l
exile	ɛ k z aɪ l
exits	ɛ ɡ s ɪ t s
expanding	ɪ k s p ɛ n d ɪ ŋ
expertise	ɛ k s p ɝ t i s
expire	ɪ k s p aɪ ɝ
expiry	ɪ k s p aɪ ɝ i
exploration	ɪ k s p l ɔ ɝ eɪ ʃ ə n
exports	ɛ k s p ɔ ɹ t s
expressionistic	ɪ k s p ɹ ɛ ʃ ə n ɪ s t ɪ k
extracurricular	ɛ k s t ɹ ə k ɝ ɪ k j ə l ɝ
eyesight	aɪ s aɪ d
facility	f ə z ɪ l ə t i
fair	v ɛ ɹ
fair	v ɛ
fallowfield	f ɛ l oʊ f i l d
famed	f eɪ n d
famous	f eɪ m ə z
fans	f ɛ n z
fans	f æ m z
faringdon	f ɛ ɹ ɪ ŋ d ə n
farming	f ʌ n ɪ ŋ
farming	f ɑ n i ŋ
fast	v æ s t
favorite	f eɪ v ɝ ə t
federalists	f ɛ d ɹ ə l ɪ s
federally	f ɛ d ɹ ə l i
feeding	f ɪ t ɪ ŋ
feeling	f ɪ l ɪ ŋ
feliciana	f ə l ɪ s i ɑ n ə
fetterman	f ɛ d ɝ m ə n
fidelity	f ə d æ l ə t i
field	f ɪ l d
figs	f ɪ k s
figure	f ɪ ɡ ɝ
figure	f i ɡ ə
files	v aɪ l z
filling	f i l ɪ ŋ
firewood	f aɪ ɝ w ʊ d
fireworks	f aɪ ɝ w ɝ k s
firing	f aɪ ɝ ɪ ŋ
fishing	f ɪ ʃ ɪ n
fleece	f l i z
flipping	f l ɪ p ɪ n
flopping	f l ʌ p ɪ ŋ
fluorescent	f l ɔ ɹ ɛ s ə n t
following	f ɑ l oʊ ɪ n
fonda	f ʌ n d ə
fondi	f ʌ n d i
font	f ʌ n t
food	f ʊ d
foot	f u d
football	f u t b ɔ l
for	f ɹ
for	v ə
forensic	f ɔ ɹ ɛ n z ɪ k
forms	f ɔ n z
forrest	f ɔ ɹ ə s t
forte	f ɔ ɹ t
fortes	f ɔ ɹ t s
forward	f ɔ d
foster	f ɔ s t ɝ
fox	f ʌ k s
france	f ɹ ɛ n s
frances	f ɹ æ n s ɪ s
frankel	f ɹ æ ŋ k ə l
frazier	f ɹ eɪ z ɝ
frederick	f ɹ ɛ d ɹ i k
frederik	f ɹ ɛ d ɹ ɪ k
freed	f ɹ i t
friend's	f ɹ ɛ n d z
full	f u l
fun	f ʌ m
furthest	f ɝ ð ə s t
gad	ɡ æ t
gadsden	ɡ æ d s t ə n
gains	ɡ eɪ m z
gama	ɡ ʌ m ə
game's	ɡ eɪ n z
gandalf	ɡ æ n d ɑ l v
gant	ɡ æ n d
garrick's	ɡ ɛ ɹ ɪ k s
garrigan	ɡ ɛ ɹ ɪ ɡ ə n
garrison	ɡ æ ɹ ɪ z ə n
garron	ɡ ɛ ɹ ə n
gartner	ɡ ɑ ɹ d n ɝ
gary	ɡ æ ɹ i
gee	k i
general's	dʒ ɛ n ɝ ə l z
generalization	dʒ ɛ n ɝ ə l ɪ z eɪ ʃ ə n
generally	dʒ ɛ n ɝ l i
genes	dʒ i m z
genetic	dʒ ə n æ t ɪ k
genre	ʃ ɑ n ɹ ə
gettysburg	ɡ ɛ t ɪ z b ɝ ɡ
ghana	ɡ æ m ə
gibson	ɡ ɪ p s ə n
gig	k ɪ ɡ
ginsberg	ɡ ɪ n z b ɝ ɡ
glasgow	ɡ l æ z ɡ oʊ
gleeson	ɡ l i s ə n
glued	k l u d
golf	ɡ ʌ l f
gonta	ɡ ʌ n t ə
gonzalez	ɡ ɑ n z ɑ l ə s
good	k ʊ d
goole	k u l
gorton	ɡ ɔ ɹ d ə n
gothic	k ɑ θ ɪ k
government	ɡ ʌ v ɝ n m ə n t
govinda	ɡ oʊ v ɪ n d ə
grade	ɡ ɹ eɪ t
graham	ɡ ɹ æ n
grainger	ɡ ɹ eɪ n dʒ ɝ
grandiose	ɡ ɹ æ n d i oʊ z
grant	ɡ ɹ æ n d
graph	k ɹ æ f
gratuity	ɡ ɹ ə t u ə t i
great	ɡ ɹ eɪ d
great	k ɹ eɪ t
greeks	k ɹ i k s
green	ɡ ɹ ɪ n
green	k ɹ i n
gregg	k ɹ ɛ ɡ
gritting	ɡ ɹ ɪ d ɪ ŋ
groceries	ɡ ɹ oʊ s ɝ i z
group	k ɹ u p
groups	k ɹ u p s
grown	ɡ ɹ oʊ ŋ
guardian	ɡ ɑ d i ə n
guatemala	ɡ w ɑ d ə m ɑ l ə
guild	ɡ ɪ l t
guilt	ɡ ɪ l d
guitar	k ə t ɑ ɹ
guns	ɡ ʌ m z
gutted	ɡ ʌ d ɪ d
habitat	h æ b ə t ɛ t
habitat	h æ p ə t æ t
habsburg	h æ b s b ɝ ɡ
halogen	h ɛ l ə dʒ ə n
hampden	h æ m p t ə n
hand	h æ n t
handkerchief	h æ ŋ k ɝ tʃ i f
handley	h æ n t l i
harness	h ɑ ɹ m ə s
harrison's	h æ ɹ ɪ s ə n z
harrisonburg	h æ ɹ ɪ s ə n b ɝ ɡ
harrods	h æ ɹ ə d z
harrogate	h æ ɹ ə ɡ eɪ t
hartsfield	h ɑ ɹ t s f i l d
harvested	h ɑ ɹ v ə s t ɪ d
has	h æ s
hated	h eɪ d ɪ d
hausa	h aʊ z ə
he	ɪ
he	h ɪ
he's	h i s
he's	h ɪ z
head	h æ d
headlam	h æ d l ə m
headquartered	h ɛ d k w ɔ ɹ t ɝ d
heads	h æ d z
heals	h ɪ l z
heart	h ɑ d
heartland	h ɑ ɹ t l æ n d
hearts	h ɑ d s
helena	h ɛ l i n ə
hello	h æ l oʊ
helping	h ɛ l p ɪ n
hemel	h æ m ə l
hempstead	h æ m p s t ɛ d
hendrickson	h ɛ n d ɹ ɪ k s ə n
henri	ɑ n ɹ i
henslow	h ɛ n z l oʊ
henson	h æ n s ə n
here	h i
hero	h ɪ ɹ oʊ
hero's	h i ɹ oʊ z
hers	ɝ z
hers	ɝ s
hers	h ɝ s
herself	ɝ s ɛ l f
hetzer	h ɛ d s ɝ
hidden	h ɪ t ə n
hill	h i l
him	ɪ n
hire	h aɪ ɝ
hiring	h aɪ ɝ ɪ ŋ
hirsute	h ɝ ʃ u d
his	h i s
his	h i z
hit	h ɪ d
hogged	h ʌ ɡ d
hollow	h ɑ l ɝ
honourable	ɑ n ɹ ə b ə l
horde	h ɔ t
horror	h ɔ ɹ
hospital	h ɑ s b ɪ t ə l
hospital	h ʌ s p ɪ t ə l
hotchkiss	h ɑ tʃ k i z
hour	aʊ ɝ
house	h aʊ z
housed	h aʊ z d
housemate	h aʊ s m eɪ d
houses	h aʊ z ɪ z
housing	h aʊ s ɪ ŋ
hsu	s u
hub	h ɑ b
hudson	h ʌ d z ə n
hull	h ɑ l
humanitarian	h j u m æ n ɪ t ɛ ɹ i ə n
humor	j u m ɝ
humour	j u m ɝ
hundred	h ɑ n d ɹ ə d
hungary	h ʌ ŋ ɡ ɹ i
huntingdon	h ʌ n t ɪ ŋ t ə n
hurt	h ɝ d
hut	h ɑ t
ideals	aɪ d ɪ l z
illicit	ɪ l ɪ z ɪ t
illusory	ɪ l u z ɝ i
imbued	ɪ n b j u d
implantation	ɪ n p l æ n t eɪ ʃ ə n
imprisonment	ɪ n p ɹ ɪ z ə n m ə n t
improving	ɪ n p ɹ u v ɪ ŋ
impurity	ɪ n p j ʊ ɹ ɪ t i
in	ɪ ŋ
in	i n
in	ɪ m
inbred	ɪ n b ɹ ɛ d
indices	ɪ n d ə s i z
indira	ɪ n d i ɹ ə
indira	ɪ n d ɪ ɹ ə
inland	ɪ n l ə n t
inquire	ɪ n k w aɪ ɝ
inquiry	ɪ n k w aɪ ɝ i
inspire	ɪ n s p aɪ ɹ
interaction	ɪ n t ɹ æ k ʃ ə n
intercourse	ɪ n ɝ k ɔ ɹ s
interim	ɪ n t ɹ ə m
international	ɪ n t ɝ n æ ʃ ə n ə l
internationale	ɪ n t ɝ n æ ʃ ə n ə l
inuit	ɪ n u ɪ t
invariant	ɪ n v ɛ ɹ i ə n t
is	ɪ s
is	ɪ ʒ
is	i s
is	i z
is	ɪ ʃ
isa	ɪ s ə
isabella	ɪ s ə b ɛ l ə
isidoro	ɪ z ɪ d ɔ ɹ oʊ
islam	ɪ s l ə m
islington	ɪ s l ɪ ŋ t ə n
israel	ɪ s ɹ i ə l
ivories	aɪ v ɝ i z
jackie	dʒ ɛ k i
jams	dʒ ɛ m z
janitor	dʒ æ n ɪ t ɝ
jason	dʒ eɪ z ə n
jeanne	dʒ ɪ n
jeddah	dʒ ɛ t ə
jeffery	dʒ ɛ f ɹ i
jenkins	dʒ ɛ n k ɪ n z
jenkyns	dʒ ɛ n k ɪ n z
jesus	dʒ i z ə z
jewish	dʒ u ɪ s
jib	dʒ ɪ p
jogging	dʒ ʌ ɡ ɪ ŋ
joseph's	dʒ oʊ s ə f s
judge	dʒ ɑ dʒ
jutland	dʒ ɑ t l ə n d
kane	k eɪ m
kansas	k æ n s ə s
karate	k ɝ ɑ d i
kasper	k æ s b ɝ
kata	k ʌ t ə
katy	k eɪ d i
kemp	k æ m p
kendal	k æ n d ə l
kennebec	k æ n ə b ɛ k
kennett	k æ n ɪ t
kent	k æ n t
keppel	k æ p ə l
keswick	k ɛ z w ɪ k
kettle	k ɛ d ə l
kettles	k æ t ə l z
keynes	k ɪ n z
kid	k ɪ t
king	k ɪ n
kirkpatrick	k ɝ k p æ t ɹ ɪ k
kittrell	k ɪ t ɹ ə l
kobold	k oʊ b oʊ l t
korean	k ɝ i ə n
korean	k ɔ ɹ i ə n
kostek	k ɑ s t æ k
kristina	k ɹ ɪ s t i n ə
kristine	k ɹ ɪ s t i n
kristol's	k ɹ ɪ s t ə l z
krystal	k ɹ ɪ s t ə l
lab	l æ p
labs	l æ p s
lad	l ɛ d
ladder	l ɛ t ɝ
ladder	l æ t ɝ
lake	l eɪ ɡ
lancashire	l æ ŋ k ə ʃ aɪ ɝ
lance	l æ n z
lansbury	l æ n z b ɛ ɹ i
lansdowne	l æ n z d aʊ n
later	l eɪ d ɝ
latrocinium	l ɛ t ɹ ə s ɪ n i ə m
lattices	l æ t ə s i z
lawton	l ɔ d ə n
leads	l i t s
league	l i k
league's	l ɪ ɡ z
lear	l i ə
lease	l i z
led	l ɛ t
leffel	l ɛ v ə l
lefty	l ɛ f t ɪ
leg	l æ ɡ
legacies	l ɛ ɡ ə s ɪ z
legacy	l ɛ ɡ ə z i
legros	l ɛ ɡ ɹ oʊ s
legs	l ɛ ɡ s
leisure	l ɛ ʒ ə
leisurely	l i ʒ ɝ l i
lenders	l æ n d ɝ z
lens	l ɛ n s
leonidas	l i ə n i d ə s
lesbos	l ɛ z b oʊ s
letter	l ɛ t ə
letters	l ɛ t ə s
lichtenstein	l ɪ k t ə n ʃ t aɪ n
ligatures	l ɪ k ə tʃ ɝ z
light	l aɪ d
lisbon	l ɪ s p ə n
littered	l ɪ d ɝ d
live	l aɪ f
livia	l i v i ə
llamas	l ɑ m ə s
loam	l u n
loans	l oʊ m z
lobes	l oʊ p z
log	l ʌ ɡ
logarithmic	l ɑ ɡ ɹ ɪ ð m ɪ k
long	l ɔ n
longer	l ɔ ŋ ɡ ɝ
looting	l u d ɪ ŋ
loss	l ɔ z
louis	l u ɪ
louis	l u i z
lubbock	l ɑ b ə k
luck	l ɑ k
luxembourg	l ʌ k s ə n b ɝ ɡ
luxury	l ʌ k ʃ ɝ i
luxury	l ʌ k ʒ ɝ i
lyndon	l ɪ ŋ d ə n
m	æ m
macabre	m ə k ɑ b ɹ
mahdi	m ɑ t i
maksim	m æ k s ɪ m
malacca	m ə l ɛ k ə
malta	m ʌ l t ə
man's	m ɛ n z
mandarin	m æ n d ɹ ə n
mandarin	m æ n d ɹ ə m
manga	m ʌ ŋ ɡ ə
mankins	m æ n k ɪ n z
marathon	m ɛ ɹ ə θ ə n
marci	m ɑ ɹ s i
marcus	m ɑ k ə z
margaret	m ɑ ɡ ɝ ɪ t
marijuana	m ɛ ɹ ə w ɑ n ə
markets	m ɑ ɹ k ə t s
marquess	m ɑ k w ɪ z
married	m ɛ ɹ ɪ d
mars	m ɑ s
marsden	m ɑ ɹ s t ə n
marshes	m ɑ ɹ ʃ ɪ z
martin	m ɑ ɹ t ə n
martin	m ɑ ɹ t i n
maryland	m ɛ ɹ i l ə n d
mason	m eɪ z ə n
mass	m ɛ s
mattison	m æ d ɪ s ə n
mawes	m ɔ s
maxim	m æ k s i m
may	n eɪ
mayor	m ɛ ɹ
mayor	m eɪ ɹ
mayor	m æ ɹ
mayos	m eɪ oʊ s
mccaffrey	m ə k æ f ɹ i
mccleary	m ə k l ɪ ɹ i
mccreary	m ə k ɹ ɪ ɹ i
mccusker	m ə k ɑ s k ɝ
mcnally	m ə k n ɛ l i
mcpherson	m ə k f ɝ z ə n
mechs	m æ k s
media	m ɪ d i ə
median	m i d i ə m
meeting	m i d ɪ ŋ
melnik	m ɛ l m ɪ k
members	m ɛ n b ɝ z
mentor	m æ n t ɔ
merchandise	m ɝ tʃ ə n d aɪ s
merrimack	m ɛ ɹ i m æ k
metal	m ɛ d ə l
metals	m ɛ d ə l z
meteor	m i d i ɔ
metra	m ɛ t ɹ ə
mildred	m ɪ l d ɹ ɪ d
millennium	m ɪ l ɛ n i ə m
minas	m ɪ n ə s
ministerial	m ɪ n ɪ s t ɪ ɹ i ə l
mission	m ɪ ʒ ə n
missouri	m ɪ s ʊ ɹ i
missouri	m ɪ s ɝ i
missouri	m ɪ s ɔ ɹ i
mistress	m ɪ s t ɹ ə s
misunderstood	m ɪ s ə n d ɝ s t u d
model	m ʌ d ə l
models	m ʌ d ə l z
moffitt	m ʌ f ɪ t
mong	m ɑ ŋ
monotonic	m ɑ n ə t ɑ m ɪ k
months	m ʌ m θ s
mooney	m u n ɪ
moons	m u m z
moore	m ɔ ɹ
morrie	m ɔ ɹ i
moscow	m ʌ s k oʊ
mose	m oʊ s
mosquitos	m ə s k i t oʊ z
motif	m oʊ t ɪ v
motif	n oʊ t ɪ v
motors	m oʊ d ɝ z
mott's	m ʌ t s
motto	m ɑ d oʊ
mrs	m ɪ s ɪ s
much	m ɑ tʃ
mukden	m ʊ k t ə n
mulatto	m ə l ɑ d oʊ
murray	m ɑ ɹ i
muslim	m ʌ s l ə m
muslims	m ʌ s l ə m z
mutations	m j u t eɪ ʃ ə n s
mysteries	m ɪ s t ɹ i z
mysteriously	m ɪ s t ɪ ɹ i ə s l i
named	n eɪ n d
namely	m eɪ n l i
nance	m æ n z
nashville	n æ ʃ f i l
nasmith	n ɛ s m ɪ θ
naturalized	n æ tʃ ɝ ə l aɪ z d
near	n i
near	m i
neck	n æ k
needs	m i t s
nesbitt	n ɛ z b i t
nevada	n i v ɑ d ə
neville	n æ v ə l
newry	n ʊ ɹ i
newton	m u t ə n
ni	n ɪ
nils	n i l z
none	n ɑ n
northam	n ɔ ɹ ð ə n
northern	n ɔ θ ə n
northern	n ɔ ɹ θ ɝ n
nowadays	n aʊ ə t eɪ z
nudge	n ɑ dʒ
number	n ʌ m ɝ
oceanic	oʊ s i æ n ɪ k
odessa	oʊ d æ s ə
of	ʌ f
of	ɔ f
of	ɑ v
off	ʌ v
offering	ɔ f ɹ ɪ ŋ
olav	oʊ l ʌ v
oldenburg	oʊ l d ə m b ɝ ɡ
one	w ɑ n
operas	ɑ p ɝ ə z
operate	ʌ p ɝ eɪ t
operated	ʌ p ɝ eɪ t ɪ d
operated	ɑ p ɹ eɪ t ɪ d
operates	ʌ p ɝ eɪ t s
operating	ʌ p ɝ eɪ t ɪ ŋ
ophelia	ə f i l i ə
opposition	ʌ p ə z ɪ ʃ ə n
or	ɹ
originally	ɚ ɪ dʒ ə n ə l i
orthodontist	ɔ ɹ θ ə d ɑ n t ə s t
orwell	ɔ w ɛ l
oscar	ɑ s k ɝ
osmond	ɑ z m ə n d
packer	p ɛ k ə
paddy	p æ t i
palm	p ʌ m
panicked	p ɛ n ɪ k t
parade	p ɹ eɪ d
paragon	p ɛ ɹ ə ɡ ə n
parallax	p ɛ ɹ ə l ɛ k s
paralympic	p ɛ ɹ ə l ɪ m p ɪ k
paramedic	p ɛ ɹ ə m ɛ t ɪ k
parametric	p ɛ ɹ ə m ɛ t ɹ ɪ k
parasite	p ɛ ɹ ə s aɪ d
parish	p ɛ ɹ ɪ s
parisian	p ɝ i ʒ ə n
parking	p ɑ k i ŋ
parkland	p ɑ ɹ k l æ n d
parliamentary	p ɑ ɹ l ə m ɛ n t ɹ i
partially	p ɑ ɹ ʃ l i
parts	p ɑ d z
party	p ɑ d i
pat	p ɛ t
paths	p ɑ θ s
patricks	p æ t ɹ ɪ k s
pawn	b ɔ n
peak	p ɪ k
peak	p ɪ ɡ
peaks	p ɪ ɡ s
peaks	p ɪ k s
peas	p i s
pegs	p æ k s
pellet	p æ l ə t
penn	p æ n
penza	p æ n z ə
perchloric	p ɝ k l ɔ ɹ ɪ k
periods	p ɪ ɹ i ə d z
personnel	p ɝ s n æ l
pest	p æ s t
petals	p ɛ d ə l z
pewsey	p j u s i
pham	f æ n
phase	f eɪ s
phil	f i l
philipp	f ɪ l i p
philosophers	f ə l ɑ s ə f ɝ s
phonetics	f ə n æ t ɪ k s
photographs	f oʊ t ə k ɹ æ f s
picked	p ɪ ɡ d
pieces	p i z ɪ z
pieces	p i z i z
pigs	p ɪ k s
pini	p ɪ n i
pinna	p i n ə
pinos	p i n oʊ s
pisa	p i z ə
pisano	p ɪ s ɑ n oʊ
pitching	p ɪ tʃ ɪ n
place	b l eɪ z
place	p l eɪ z
planetarium	p l æ n ɪ t ɛ ɹ i ə m
plant	b l æ n t
playing	p l eɪ ɪ n
plays	p l eɪ s
plaza	p l ɑ s ə
polyester	p ɑ l i ɛ s t ɚ
pool	p ʊ l
poor	p ɔ
poppe	p ʌ p
possessor	p ə s ɛ s ɝ
possibles	p ɑ z ə b ə l z
pot	p ɑ d
potsdam	p ɑ t s t æ m
pottery	p ɑ t ɹ i
pozzi	p ʌ z i
practicing	p ɹ æ k t ə z ɪ ŋ
praise	p ɹ eɪ s
precambrian	p ɹ i k æ m b ɹ i ə n
preceded	p ɹ ɪ s i d ə d
preceded	p ɹ i s i d ə d
precedes	p ɹ i s i d z
precinct	p ɹ i s ɪ ŋ k
precincts	p ɹ i s ɪ ŋ k t s
precocious	p ɹ ɪ k oʊ ʃ ə s
predator	p ɹ ɛ d ə d ə
predatory	p ɹ ɛ d ə d ɔ ɹ i
predecessor	p ɹ i d ə s ɛ s ɝ
predetermined	p ɹ i d ɪ t ɝ m ə n d
predictably	p ɹ ɪ d ɪ k t ə b l i
predominant	p ɹ i d ɑ m ə n ə n t
preferably	p ɹ ɛ f ɝ ə b l i
preferences	p ɹ ɛ f ɹ ə n s ɪ z
premier	p ɹ i m i ɝ
premier	p ɹ i m ɪ ɹ
premier	p ɹ i m i ɹ
premiums	p ɹ i m i ə n z
prep	p ɹ æ p
preparatory	p ɹ ɛ p ɝ ə t ɔ ɹ i
preschool	p ɹ i s k u l
presented	p ɹ i z ɛ n ə d
presented	p ɹ i z ɛ n t ə d
presented	p ɹ i z ɛ n t ɪ d
presented	p ɹ ɪ z ɛ n t ə d
presenter	p ɹ i z ɛ n t ɝ
presides	p ɹ ɪ z aɪ d z
presidium	p ɹ ɪ z i d i ə m
pretoria	p ɹ ɪ t ɔ ɹ i ə
price	p ɹ aɪ z
prices	p ɹ aɪ z ɪ z
prien	p ɹ ɪ n
primitive	p ɹ ɪ m ə t ɪ v
primm	p ɹ ɪ m
princesses	p ɹ ɪ n s ɛ s ɪ z
probability	p ɹ ɑ b ə b ɪ l ə t i
proceeds	p ɹ ə s i d z
processor	p ɹ ɑ s ɛ s ɝ
produces	p ɹ ə d u z ɪ z
product's	p ɹ ɑ d ə k t s
products	p ɹ ɑ d ə k s
professionally	p ɹ ə v ɛ ʃ ə n ə l i
promising	p ɹ ɑ m ə s ɪ ŋ
proposed	p ɹ ə p oʊ z t
prosperity	p ɹ ɑ s p ɛ ɹ ə t i
protestants	p ɹ ɑ d ə s t ə n t s
protests	p ɹ ə t ɛ s
province's	p ɹ ɑ v ə n s ɪ z
prue's	p ɹ u s
pseudonym	ʃ u d ə n ɪ m
pub	p ʌ p
pub	p ɑ p
public	p ʌ p l ɪ k
pucks	p ɑ k s
puerto	p ɔ ɹ t ə
pulled	p u l d
pulmonary	p u l m ə n ɛ ɹ i
pundit	p ɑ n d ə t
pup	p ɑ p
puppet	p ɑ p ə t
puss	p ɑ s
putt	p ɑ t
quang	k w ɑ n
quarterbacks	k w ɔ ɹ t ɝ b æ k s
quarters	k ɔ ɹ t ɝ z
quartzite	k w ɔ ɹ t s aɪ d
raccoon	ɹ ɛ k u n
raced	ɹ eɪ z t
racing	ɹ eɪ z ɪ ŋ
radford	ɹ ɛ d f ɝ d
radium	ɹ eɪ d i ə n
raised	ɹ eɪ s t
rally	ɹ ɛ l i
ramadan	ɹ æ m ə d ə n
ramey	ɹ æ m i
ramsay	ɹ æ m z i
ranch	ɹ ɛ n tʃ
ranking	ɹ æ ŋ k ɪ n
rankings	ɹ æ ŋ k ɪ ŋ z
rapping	ɹ ɛ p ɪ ŋ
raptors	ɹ æ p t ɝ z
ratings	ɹ eɪ d ɪ ŋ z
rats	ɹ ɛ t s
ravel	ɹ ə v ɛ l
ray's	ɹ eɪ s
reachable	ɹ ɪ tʃ ə b ə l
reactivity	ɹ i æ k t ɪ v ə t i
readings	ɹ i d ɪ ŋ z
real	ɹ ɪ l
really	ɹ i l ɪ
rear	ɹ i ə
reboot	ɹ i b u t
received	ɹ ɪ z i v d
recession	ɹ i s ɛ ʃ ə n
recovery	ɹ ɪ k ʌ v ɝ i
rector	ɝ ɛ k t ɝ
recurring	ɹ i k ɝ ɪ ŋ
red	ɹ ɛ t
redevelopment	ɹ i d ɪ v ɛ l ə p m ə n t
redraw	ɹ i d ɹ ɔ
reds	ɹ ɛ d s
reductions	ɹ ɪ d ʌ k ʃ ə n z
redundancy	ɹ i d ʌ n d ə n s i
reenactment	ɹ i ɪ n æ k t m ə n t
reeser	ɹ i z ɝ
reestablished	ɹ i i s t æ b l ɪ ʃ t
reestablishing	ɹ i i s t æ b l ɪ ʃ ɪ ŋ
refectory	ɹ ɪ f ɛ k t ɝ i
refer	ɹ ɪ f ə
references	ɹ ɛ f ɹ ə n s ɪ z
referencing	ɹ ɛ f ɹ ə n s ɪ ŋ
referendum	ɹ ɛ f ɝ æ n d ə m
referrals	ɹ ɪ f ɝ ə l z
reformed	ɹ i f ɔ ɹ m d
regional	ɹ ɪ dʒ ə n ə l
regional	ɝ ɪ dʒ ə n ə l
regular	ɹ ɛ k j ə l ɝ
rehearsal	ɹ ɪ h ɝ s ə l
rehearsed	ɹ ɪ h ɝ s t
rehnquist	ɹ æ ŋ k w ɪ s t
related	ɹ ɪ l eɪ d ɪ d
relates	ɹ ɪ l eɪ t s
reliably	ɹ ɪ l aɪ ə b l i
relied	ɹ i l aɪ d
relies	ɹ i l aɪ z
rely	ɹ ɪ l aɪ
remarked	ɹ i m ɑ k t
remember	m ɛ m b ɝ
remembered	ɹ ɪ m ɛ m b ɝ d
remote	ɹ ɪ m oʊ t
removable	ɹ i m u v ə b ə l
renaissance	ɹ ɛ n ə z ɑ n s
renewal	ɹ i n u ə l
renewed	ɹ ɪ n u d
renn	ɹ ɛ n
renna	ɹ ɛ n ə
repel	ɹ i p ɛ l
represent	ɹ i p ɹ i z ɛ n t
represented	ɹ ɛ p ɹ ə z ɛ n ə d
reprisals	ɹ ɪ p ɹ aɪ z ə l z
repudiated	ɹ ɪ p j u d i eɪ t ɪ d
requests	ɹ ɪ k w ɛ s
require	ɹ i k w aɪ ɝ
require	ɹ i k w aɪ ɚ
requirement	ɹ i k w aɪ ɝ m ə n t
requirements	ɹ i k w aɪ ɝ m ə n t s
reruns	ɹ i ɹ ʌ n z
rescinded	ɹ i s ɪ n d ɪ d
resembling	ɹ i z ɛ m b l ɪ ŋ
resented	ɹ ɪ z ɛ n t ə d
resents	ɹ ɪ z ɛ n t s
reshuffling	ɹ i ʃ ʌ f ə l ɪ ŋ
reside	ɹ ɪ s aɪ d
resided	ɹ ɪ s aɪ d ɪ d
residential	ɹ ɛ z ɪ d ɛ n ʃ ə l
resides	ɹ ɪ s aɪ d z
resin	ɹ ɛ z ə n
resins	ɹ ɛ z ə n z
resins	ɹ ɛ s ɪ ŋ z
resisted	ɹ ɪ z ɪ s t ə d
resnick	ɹ ɛ s n ɪ k
resolved	ɹ i s ɑ l v d
resort	ɹ i z ɔ ɹ t
resources	ɹ i z ɔ ɹ s ɪ z
respiratory	ɹ ɛ s p ɝ ə t ɹ i
respond	ɹ ɪ s p ɑ n t
rest	ɹ æ s t
restricted	ɹ i s t ɹ ɪ k t ɪ d
restroom	ɹ ɛ s t ɹ u m
result	ɹ i s ʌ l t
retaliated	ɹ i t æ l i eɪ t ɪ d
retire	ɹ i t aɪ ɝ
retirement	ɹ i t aɪ ɝ m ə n t
retiring	ɹ i t aɪ ɝ ɪ ŋ
revamping	ɹ i v æ m p ɪ ŋ
revered	ɹ i v ɪ ɹ d
reverend	ɹ ɛ v ɝ ə n t
reverted	ɹ i v ɝ t ɪ d
revisions	ɹ ɪ v ɪ ʒ ə n z
revson	ɹ ɛ v s ə n
revues	ɹ i v j u z
rhythm	ɹ ɪ θ m
rhythmic	ɹ ɪ θ m ɪ k
ride	ɹ aɪ t
rider	ɹ aɪ t ɝ
riding	ɹ aɪ t ɪ ŋ
rigid	ɹ ɪ dʒ ɪ t
rim	ɹ i m
rise	ɹ aɪ s
rishi	ɹ ɪ ʃ i
rivard	ɹ ɪ v ɝ d
river	ɹ ɪ f ə
road	ɹ oʊ t
robbed	ɹ ʌ b d
robberies	ɹ ʌ b ɝ i z
robby	ɹ ʌ b i
robot	ɹ oʊ b ɑ t
robson	ɹ ɑ b z ə n
roddy	ɹ ʌ d i
rodney	ɹ ʌ d n i
roebuck	ɹ oʊ b ɑ k
rookies	ɹ u k i z
roots	ɹ u d s
roots	ɹ u d z
rosa	ɹ oʊ s ə
rose	ɝ oʊ z
ross	ɹ ʌ s
rossi	ɹ ʌ s i
roster	ɹ ʌ s t ɝ
roswell	ɹ ɑ z w ɛ l
round	ɝ aʊ n d
rubber	ɹ ɑ b ɝ
rucker	ɹ ɑ k ɝ
ruckus	ɹ ɑ k ə s
rug	ɹ ʌ k
rugby	ɹ ʌ k b i
ruins	ɹ u ə n z
rules	ɹ u l s
rutherford	ɹ ʌ ð ɝ f ɝ d
rutherford's	ɹ ʌ ð ɝ f ɝ d z
rwandan	ɹ ə w ɑ n d ə n
sabbatical	s ə b æ d ɪ k ə l
sackings	s ɛ k ɪ ŋ z
saddam	s ə d ɑ n
sadism	s eɪ t ɪ z ə m
salary	s ɛ l ɝ i
salford	s ɛ l f ɝ d
salmon	s ɛ m ə n
salsa	s ɛ l s ə
salvadoran	s æ l v ə d ɔ ɹ ə n
samba	s ʌ m b ə
samsung	s æ m s ə n
san	s ʌ n
sandwich	s æ n w ɪ tʃ
sandwiches	s æ n w ɪ tʃ ɪ z
sang	s æ n
sansom	s æ n s ə n
santas	s æ n t ə z
sat	s ɛ t
satellite	s æ d ə l aɪ t
saturn	s æ d ə n
saying	s eɪ ɪ n
scene	s i ŋ
scenes	s ɪ ŋ z
scheme	s k i n
schmid	ʃ m ɪ t
science	s aɪ ə n z
screams	s k ɹ i n z
scripted	s k ɹ ɪ p t ɪ d
scuba	s k u p ə
scythians	s ɪ ð i ə n z
sea	s ɪ
seal	s ɪ l
seamless	s i n l ə s
seating	s ɪ t ɪ ŋ
seating	s i d ɪ ŋ
sectors	s æ k t ɝ z
sediment	s ɛ t ə m ə n t
segment	s ɛ k m ə n t
selby	ʃ ɛ l b i
seminarians	s ɛ m ə n ɛ ɹ i ə n z
senator	s ɛ n ə d ə
send	s ɛ n t
seng	s ɛ n
separate	s ɛ p ɹ eɪ t
sequel	s ɪ k w ə l
sequence	s i k w ə n z
serves	s ɝ v s
service	s ɝ f ə s
sessions	s ɛ ʒ ə n z
settlers	s æ t l ɝ z
severn	s ɛ v ə n
sewerage	s ʊ ɹ ɪ dʒ
sh	s
shad	ʃ ɛ d
shading	ʃ eɪ t ɪ ŋ
shadow	ʃ æ t oʊ
shakespeare	ʃ eɪ k s p ɪ ɹ
shakespeare's	ʃ eɪ k s p ɪ ɹ z
shamans	ʃ ɑ m ə n z
shaped	ʃ eɪ p d
shared	ʃ æ d
sharp	ʃ ɑ b
shenandoah	ʃ æ n ə n d oʊ ə
sherritt	ʃ ɛ ɹ ɪ t
shilha	ʃ i l h ɑ
shimon	ʃ ɪ m ə n
shire	ʃ aɪ ɝ
shite	ʃ aɪ d
shoddy	ʃ ʌ d i
shortlived	ʃ ɔ ɹ t l ɪ f t
show	s oʊ
shropshire	ʃ ɹ ɑ p ʃ aɪ ɝ
shuttle	ʃ ʌ d ə l
siblings	s ɪ p l ɪ ŋ z
siddiqui	s ɪ d ɪ k w i
side	s aɪ t
sight	s aɪ d
sigrid	s i ɡ ɹ ɪ t
sims	s ɪ n z
sinatra	s ə n ɑ t ɹ ə
singapore	s ɪ ŋ ə p ɔ ɹ
sinuses	s aɪ m ə s ɪ s
sitcom	s ɪ t k ɑ n
sited	s aɪ d ɪ d
skater	s k eɪ d ɝ
slabs	s l æ p s
sledding	s l ɛ t ɪ ŋ
slip	s l i p
slits	s l ɪ d z
smythe	s m aɪ θ
snake	s m eɪ k
soccer	s ʌ k ɝ
sociology	s oʊ ʃ i ɑ l ə dʒ i
software	s ɔ f t w ɛ
some	s ʌ n
somme	s ʌ m
song	s ʌ ŋ
sorted	s ɔ d ɪ d
source	s ɔ z
sources	s ɔ z ɪ z
sousa	s u s ə
southern	s ɑ ð ə n
southern	s ɑ θ ə n
spaz	s p ɛ z
speakeasy	s p i k i z i
speed	s p ɪ t
spelled	s p ɛ l t
spend	s p ɛ n t
sperm	s p ɝ n
speyer	s p eɪ ɹ
spitze	s p ɪ t s
sporadically	s p ɝ æ t ɪ k l i
springsteen	s p ɹ ɪ ŋ s t i n
stackelberg	s t ɛ k ə l b ɝ ɡ
stadium	s t eɪ d i ə n
staff	s t ʌ f
staff	s t ɑ v
stalin	s t æ l ɪ ŋ
stamford	s t æ m f ɝ t
stance	s t æ n z
standardize	s t æ n d ɝ t aɪ z
state	s t eɪ d
state	s d eɪ t
steel	s t ɪ l
stena	s t æ n ə
steward	s t u ɝ t
stewards	s t u ɝ t s
stewart	s t u ɝ d
still	s t i l
stock	s d ɑ k
stood	s t u d
stratton	s t ɹ æ t ə m
street	ʃ t ɹ i t
string	s t ɹ i n
stuck	s t ɑ k
study	s t ɑ d i
stunt	s t ʌ m t
subordinate	s ə b ɔ ɹ d ə n ə t
subordinates	s ə b ɔ ɹ d ə n ə t s
subs	s ɑ b z
subspecies	s ʌ b s p i s i z
suite	s w i d
sulfuric	s ʌ l f j ʊ ɹ ɪ k
sunbeam	s ʌ n b i n
sundance	s ʌ m d æ n s
sunflower	s ʌ m f l aʊ ɝ
supernaturalism	s u p ɝ n æ tʃ ɝ ə l ɪ z ə m
superstore	s u p ɝ s t ɔ ɹ
surface	s ɝ v ə s
surfboards	s ɝ f b ɔ ɹ d z
surgical	s ɝ dʒ ɪ ɡ ə l
surrey	s ɑ ɹ i
sussex	s ʌ s æ k s
sweets	ʃ w i d s
swift	s w i f t
swimming	s w ɪ m ɪ n
sword	ʃ ɔ d
talented	t ɛ l ə n t ɪ d
tamara	t ə m ɑ ɹ ə
tamil	t ɛ m ə l
tana	t ɛ n ə
tandem	t ɛ n d ə n
tanning	t ɛ n ɪ ŋ
tao	t aʊ
taoism	t aʊ ɪ z ə m
taoists	t aʊ ɪ s t s
tap	t ɛ p
tatar	t ɑ t ɝ
tax	t ɛ k s
team	t ɪ m
technologies	t ɛ k n ɑ l ə dʒ ɪ s
teenager	t i m eɪ dʒ ɝ
teenagers	t i m eɪ dʒ ɝ z
teller	t æ l ə
telstra	t ɛ l s t ɹ ə
telugu	t ɛ l u ɡ u
ten	t æ n
ten	t æ m
tensor	t ɛ n s ɝ
teresa	t ɝ i z ə
teresa	t ɝ eɪ z ə
term	t ɝ n
terminology	t ɝ m ə n ɑ l ə dʒ i
terrain	t ɹ eɪ n
terrie	t ɛ ɹ i
terror	t ɛ ɹ
tetzel	t ɛ t s ə l
texas	t æ k s ə s
texts	t æ k s
thalamus	θ ɛ l ə m ə s
thames	t æ m z
thames	t ɛ n z
than	ð ɛ n
that	ð æ d
thats	ð æ t s
the	ð
the	θ ə
the	θ i
the	θ ɪ
theater	θ i ə d ə
them	ð ɛ n
thematic	θ ə m ɛ t ɪ k
theme	θ ɪ m
theorem	θ i ɝ ə m
theorem	θ ɪ ɝ ə m
theorems	θ i ɝ ə m z
theory	θ i ɹ i
theory	θ ɪ ɝ i
there	ð ɛ
there	ð æ
these	ð ɪ s
these	θ i z
they	θ eɪ
they'd	ð eɪ t
this	θ ɪ s
this	ð i s
this	ð ɪ z
thomson	θ ʌ m s ə n
thriving	θ ɝ aɪ v ɪ ŋ
thus	θ ʌ s
thwarted	θ w ɔ ɹ t ɪ d
tibetan	t ə b ɛ d ə n
tidal	t aɪ t ə l
tiers	t ɪ ɹ z
tigger	t ɪ k ə
tight	t aɪ d
to	d oʊ
to	d i
to	t i
to	d ɪ
tom	t ʌ m
tomboy	t ʌ m b ɔɪ
tommy	t ʌ m i
tomtom	t ʌ m t ə m
tonton	t ʌ n d ə n
totteridge	t ɑ t ɹ ɪ dʒ
tour	t ɔ
tourist	t ʊ ɹ ə s t
townsend	t aʊ n s ə n d
townsley	t aʊ n z l i
trade	t ɹ eɪ t
traditionalist	t ɹ ə d ɪ ʃ ə n ə l ɪ s t
traitor	t ɹ eɪ d ɝ
tram	t ɹ æ n
transitioning	t ɹ æ n z ɪ ʃ ə n ɪ ŋ
transliteration	t ɹ æ n z l ɪ t ɝ eɪ ʃ ə n
translucence	t ɹ æ n z l u s ə n s
transmitter	t ɹ æ n z m ɪ t ɝ
transmitter's	t ɹ æ n z m ɪ t ɝ z
transmitting	t ɹ æ n z m ɪ t ɪ ŋ
transport	t ɹ æ n s p ɔ t
transpositions	t ɹ æ n z p ə z ɪ ʃ ə n z
treasure	t ɹ ɛ z ɝ
treasury	t ɹ ɛ ʃ ɝ i
treatise	t ɹ i t i z
treatise	t ɹ i d ɪ s
trek	t ɹ æ k
trigger	t ɹ ɪ k ə
triggered	t ɹ i ɡ ɝ d
tripoli's	t ɹ ɪ p ə l i z
triptych	t ɹ ɪ p d ɪ k
trotsky	t ɹ ʌ t s k i
troupe's	t ɹ u p s
trump's	t ɹ ʌ m p s
tube	t u p
tubman	t ʌ p m ə n
tucker	t ɑ k ə
tun	t ɑ n
tunney	t ʌ n ɪ
turn	t ɝ m
tutorials	t u t ɔ ɹ i ə l z
types	t aɪ b z
tyres	t aɪ ɝ z
under	ʌ n t ɝ
understood	ʌ n d ɝ s t u d
uneventful	ʌ n ɪ v ɛ n t f ə l
uniforms	j u n ɪ f ɔ ɹ m z
unpalatable	ə m p æ l ə t ə b ə l
unreleased	ʌ n ɹ i l i s t
unremitting	ʌ n ɹ i m ɪ t ɪ ŋ
unreported	ʌ n ɹ ɪ p ɔ ɹ t ɪ d
up	ɑ p
upmarket	ʌ p m ɑ ɹ k ə t
uptick	ɑ p t ɪ k
user	j u s ə
vaccines	f æ k s i n z
vampire	v æ m p aɪ ɝ
van	v ɛ n
vanessa	v ə n æ s ə
various	f ɛ ɹ i ə s
venezuela	v ɛ n ɪ s w eɪ l ə
vic	f ɪ k
vice	f aɪ s
victorias	v ɪ k t ɔ ɹ i ə s
victory	f ɪ k t ɝ i
video	v i d i oʊ
vines	f aɪ n z
vitus	v aɪ t ə z
vizier	v ɪ z i ə
vocal	v oʊ ɡ ə l
vocals	f oʊ k ə l z
voice	v ɔɪ z
volunteers	v ɑ l ə n t i ɹ z
voters	v oʊ d ɝ z
wading	w eɪ t ɪ ŋ
wagner	v ɑ ɡ n ɝ
walking	w ɔ k ɪ n
wandering	w ʌ n d ɝ ɪ ŋ
warmup	w ɔ ɹ m ə p
warrior	w ɔ ɹ i ɝ
warriors	w ɔ ɹ i ɝ z
was	w ɑ s
was	w ə s
watches	w ʌ tʃ ɪ z
water	w ɔ ɾ ə
waterton	w ɔ t ɝ d ə n
we	w ɪ
web	w ɛ p
wells	w ɛ l s
wesleyan	w ɛ s l i ə n
wham	w æ n
where	w ɛ ɹ
whereas	w ɛ ɹ æ z
white	h w aɪ d
wicked	w ɪ k ə t
wicks	w i k s
wife	w aɪ v
wigan	w i k ə n
willesden	w ɪ l ɪ s t ə n
willis	w ɪ l i z
wind	w ɪ n t
wing	w ɪ n
wire	w aɪ ɝ
wires	w aɪ ɝ z
wisdom	w ɪ s t ə m
witherspoon	w ɪ ð ɝ z p u n
without	w ɪ θ aʊ t
witty	w ɪ d i
wombats	w ʌ n b æ t s
woodbury	w ʊ t b ɛ ɹ i
word	w ɝ t
worthing	w ɝ ð ɪ ŋ
would	w u d
wrestler	ɹ ɛ s l ɝ
writer	ɹ aɪ d ɝ
writers	ɹ aɪ d ɝ z
writes	ɹ aɪ d s
written	ɹ ɪ d ə n
wurtz	w ɝ d z
wynkoop	w ɪ n k u p
x	æ k s
xmas	s m ə s
yards	j ɑ ɹ t z
yeah	j ɛ
yeast	j ɪ s t
yeats	j i d z
yorkshire	j ɔ ɹ k ʃ ɝ
you're	j ʊ ɹ
younger	j ʌ ŋ ɡ ɝ
youre	j u ɹ
yugoslavia	j u k ə s l ɑ v i ə
zenica	z ɛ n i k ə
zero	z i ɹ oʊ
