a	eɪ
a	oʊ
a	ɛ
a	ɛ i
a	ʌ
abbas	ə b ə s
abdominal	æ b d ə m ə n ə l
abidjan	æ b ə dʒ ə n
abidjan	æ b ɪ dʒ ə n
absorption	ə b s ɔ ɹ p ʃ ə n
abutment	ə b ɔ t m ə n t
acadian	ɑ k eɪ d i ə n
achilles	ə k ɪ l i s
acid	ɛ s i d
acid	ɛ s ɪ d
acquire	ə k w aɪ ɹ
acquiring	ə k w aɪ ɹ ɪ ŋ
acre	æ k ɹ
action	ɛ k ʃ ə n
activity	ɛ k t ɪ v ə t i
ada	eɪ d ə
add	ɛ d
added	æ d ʌ d
adding	æ d ɪ n
ade	æ d
adenine	ɛ d ə n i n
adjuncts	æ dʒ ʌ n k t s
admired	æ d m aɪ ɝ d
adolf	æ d ɑ l f
adrian	æ d ɹ i ə n
adult	ə d ə l t
adulthood	ə d ə l t h ʊ d
adults	ə d ə l t s
adventure	ə d v ɛ n tʃ ɝ
adventures	ə d v ɛ n tʃ ɝ z
adversarial	æ d v ɝ s ɛ ɹ i ə l
advice	æ d v aɪ z
aeon	i ə n
aerobatic	ɛ ɹ ə b æ t ɪ k
aerobatics	ɛ ɹ ə b æ t ɪ k s
aesop	i s ɔ p
aesthetic	æ s θ ɛ t ɪ k
aesthetics	æ s θ ɛ t ɪ k s
aesthetics	ɛ s t æ t ɪ k s
affixes	ə f ɪ k s i z
afghanistan	æ f ɡ æ n ɪ s t ə n
aforementioned	æ f ɝ m ɛ n ʃ ə n d
africa	eɪ f ɹ ɪ k ə
africans	æ f ɹ ɪ k ə n z
afrikaans	æ f ɹ ə k ə n z
again	ə ɡ eɪ n
again	ə ɡ æ n
aggregation	ɛ ɡ ɹ ə ɡ eɪ ʃ ə n
aid	ɛ d
aileron	eɪ l ɝ ə n
aileron	ɛ l ɝ ɑ n
aint	æ n t
air	eɪ
air	æ
air	æ ɹ
airbus	æ ɹ b ə s
aircraft's	ɛ ɹ k ɹ æ f t s
airdrop	ɛ ɹ d ɹ ɑ p
aires	ɛ ɹ i z
airfields	ɛ ɹ f i l d z
airlifted	ɛ ɹ l ɪ f t ɪ d
airstrip	ɛ ɹ s t ɹ ɪ p
airworthy	ɛ ɹ w ɝ ð i
aladdin	ə l ɛ d ɪ ŋ
alastair	æ l ə s t ɝ
albrecht	oʊ l b ɹ ɛ k t
alcohol	æ l k ə h ə l
alcoholics	æ l k ə h ɔ l ɪ k s
alderete	oʊ l d ɝ i t
alderney	ɔ l d ɝ n i
aldrich	oʊ l d ɹ ɪ tʃ
aldrich's	oʊ l d ɹ ɪ tʃ ɪ z
ale	æ l
aleister	æ l ɪ s t ə
aleister	æ l ɪ s t ɝ
alesi	ə l æ s i
alesi	ə l ɛ s i
alfredson	æ l f ɹ ɪ d s ə n
alfredsson	æ l f ɹ ɪ d s ə n
ali	ɛ l i
alice	ɛ l ə s
alicia	ə l ɪ s i ə
all	oʊ l
allegheny	æ l ə ɡ æ n i
allegiance	ə l i dʒ ə n z
allen	ɛ l ə n
allotted	ə l ɔ t ɪ d
alma	ɛ l m ə
almond	oʊ l m ə n d
almonds	ɔ l m ə n d z
alone	ə l oʊ ŋ
alone	ə l ɔ ŋ
along	ə l oʊ ŋ
along	ə l ɔ n
alonso	ə l ɑ n z oʊ
alphonse's	æ l f ɑ n s ɪ z
alsace	æ l s ə s
also	oʊ l s oʊ
also	ə l s oʊ
alternate	oʊ l t ɝ n ə t
alternate	ʌ l t ɝ n eɪ t
alternating	oʊ l t ɝ n eɪ t ɪ ŋ
alternation	ɔ l t ɝ n eɪ ʃ ə n
alvarado	æ l f ɝ ɑ d oʊ
amara	ə m ɑ ɹ ə
amarillo	æ m ɝ i l oʊ
amazonas	æ m ə z oʊ n ə s
ambrose	æ m b ɹ oʊ s
ambroses	æ m b ɹ oʊ z ɪ z
amelia	ə m ɪ l j ə
amer	æ m ɝ
american	ə m ɛ ɹ ɪ k ə n
ames's	ɛ m s ɪ z
amide	æ m i d
amniotic	æ m n i ə t ɪ k
among	ə m ʌ n
amos	æ m ə s
amro	æ m ɝ oʊ
amtrak	æ m t ɹ æ k
amtrak's	æ m t ɹ æ k s
an	æ ŋ
an	ɑ n
an	ɛ n
an	ʌ n
analyses	ə n æ l ɪ s ɪ s
anarchist	æ n ɑ k ɪ s t
anarchy	æ n ɑ k i
anchored	æ n k ɝ d
ancient	eɪ n s ə n t
ancient	ɛ n s ə n t
and	ɔ n d
and	ʌ n d
andes	æ n d ɪ s
andrea's	æ n d ɹ i ə z
andretti	æ n d ɹ ɛ t i
andrews'	æ n d ɹ u z
andronicus	æ n d ɹ ɑ n ɪ k ə s
angas	æ ŋ ɡ ə s
angel	eɪ n dʒ ə l
angeles	æ n dʒ ə l i s
angeles	æ n dʒ ə l i z
angell	æ n dʒ ə l
anglican	æ ŋ ɡ l i k ə n
angola	æ n ɡ oʊ l ə
ankang	ɑ n k ə n
ankara	æ n k ɝ ə
ankara	æ ŋ k ɑ ɹ ə
annas	æ n ə s
annexation	æ n æ k s eɪ ʃ ə n
annie	ɛ n i
anomaly	ə n ɔ m ə l i
another	æ n ʌ ð ɝ
another	ə n ʌ θ ɝ
answer	æ n s ə
antenna	æ n t æ n ə
antennas	æ n t æ n ə z
anthem	ɛ n θ ə m
anthologies	æ n θ ɑ l ə dʒ ɪ s
antibacterial	æ n t i b æ k t ɪ ɹ i ə l
antibiotic	æ n t ɪ b i ɑ t ɪ k
antibiotics	æ n t ɪ b i ɑ t ɪ k s
antiphons	æ n t i f ə n z
antiphons	æ n t ɪ f ə n z
antique	æ n t ɪ k
antiquities	æ n t ɪ k w ə t ɪ s
antoinette	æ n t w ɑ n ɛ t
anton	æ n t ɑ n
any	æ n ɪ
anywhere	æ n i h w ɛ ɹ
anywhere	ɛ n i w ɛ ə
anywhere	ɛ n i w ɛ ɹ
aphorisms	ɛ f ɝ ɪ z ə m z
apis	eɪ p ɪ s
apopka	ə p oʊ p k ə
apostates	ə p ɑ s t eɪ t s
apparatus	æ p ɝ eɪ t ə s
appendices	ə p ɛ n d ə s i z
apsley	ɛ p s l i
arabia	ɑ ɹ eɪ b i ə
arafat	ɑ ɹ ə f ə t
aral	æ ɹ ə l
aral	ɑ ɹ ə l
aransas	ɹ æ n s ə s
arbor	ɑ b ɑ
arboreal	ɔ ɹ b ɔ ɹ i ə l
arbuckle	ɑ ɹ b ʌ k ə l
arch	ɑ ɹ t s
archaeologist	ɑ ɹ k i ə l ə dʒ ɪ s t
archibald	ɑ ɹ tʃ ə b oʊ l d
arctic	ɑ ɹ t ɪ k
are	eɪ ə
are	eɪ ɝ
are	ɔ ɹ
are	ɹ
are	ʌ ɹ
area	eɪ ɹ i ə
area's	ɛ ɹ i ə z
areas	eɪ ɹ i ə z
areas	ɛ ɹ i ə s
argentina	ɑ dʒ ə n t ɪ n ə
argentinian	ɑ ɹ dʒ ə n t ɪ n i ə n
argonauts	ɑ ɹ ɡ ə n ɑ t s
arid	æ ɹ ə d
ariel	æ ɹ i ə l
arion's	æ ɹ i ə n z
aristocratic	ɹ ɪ s t ə k ɹ æ t ɪ k
arizona	æ ɹ ɪ z oʊ n ə
arkansas	ɑ ɹ k æ n s ə s
arkansas'	ɑ ɹ k ə n s ɔ z
arkansas's	ɑ ɹ k ə n s ɔ z
armadale	ɑ ɹ m ə d eɪ l
armagh	ɑ m ə
armagh	ɑ ɹ m ə
armon	ɑ ɹ m ə n
armorica	ɑ ɹ m ɔ ɹ ɪ k ə
arms	ə m z
army	ɑ m ɪ
aromatics	æ ɹ ə m æ t ɪ k s
aron	æ ɹ ə n
aroostook	ɹ u s t ʊ k
around	ɹ aʊ n d
array	ɹ eɪ
arrested	ɹ ɛ s t ɪ d
arrow	ɛ ɹ oʊ
arsonist	ɑ ɹ s ə n ɪ s t
arsonist	ɔ s ə n ɪ s t
art	ɔ t
artifacts	ɑ ɹ t ə f ɛ k t s
artist's	ɑ ɹ t ə s t s
arum	æ ɹ ə m
arun	æ ɹ ə n
as	ɑ s
as	ɑ z
as	ɔ s
as	ə z
as	ɛ s
as	ʌ s
as	ʌ z
asana	ə s ɑ n ə
asda	æ z d ə
ash	eɪ s
ashdod	æ ʃ d ɔ d
ashkenazi	æ ʃ k ə n ə z i
ashraf	æ ʃ ɹ ə f
ashton	ɛ ʃ t ə n
ashworth	æ s w ɝ θ
asian	eɪ ʃ ə n
asiatic	eɪ z i æ t ɪ k
asiatic	æ s i æ t ɪ k
assembling	ə s ɛ m b l ɪ n
associated	ə s oʊ ʃ i eɪ t ə d
associated	ə ʃ oʊ ʃ i eɪ t ə d
associating	ə s oʊ ʃ i eɪ t ɪ ŋ
association	ə s oʊ s i eɪ ʃ ə n
assumes	ə ʃ u m z
asteroid	æ s t ɹ ɔɪ d
asteroids	ɛ s t ɝ ɔɪ d z
asteroids	ɛ s t ɹ ɔɪ d z
asthma	æ s m ə
astor	eɪ s t ɝ
astronaut	æ s t ɹ ə n oʊ t
astronaut	æ s t ɹ ə n ə t
astronauts	æ s t ɹ ə n ɔ t s
astronauts	æ s t ɹ ə n ɔ t z
astronauts'	æ s t ɹ ə n ɔ t s
astronomical	æ s t ɹ ə n ə m ɪ k ə l
asura	ə s ʊ ɹ ə
atari	ɑ t ɑ ɹ i
athi	æ θ i
athos	æ θ ɔ s
athos	æ θ ə s
atoll	æ t oʊ l
atoll	æ t ə l
attendee	ə t æ n d i
attleborough	æ t ə l b ɝ ə
auberge	oʊ b ɝ dʒ
auburn	oʊ b ɝ n
auburn	ɔ b ɝ n
auckland	oʊ k l ə n d
audacious	ɔ d eɪ ʃ ə s
audacity	ɔ d æ s ə t i
audible	ɔ d ə b ə l
audition	ə d ɪ ʃ ə n
auditioned	ə d ɪ ʃ ə n d
auditioning	ɔ d ɪ ʃ ə n ɪ ŋ
auditoriums	ɔ d ə t ɔ ɹ i ə m z
audley	oʊ d l i
audubon	ɔ d ə b ə n
augmentation	ɔ ɡ m ɛ n t eɪ ʃ ə n
augmented	ɔ ɡ m ɛ n t ɪ d
augusta	ɔ ɡ ə s t ə
augusta	ɔ ɡ ʌ s t ə
augusta	ə ɡ ɑ s t ə
augustin	ɔ ɡ ə s t ɪ n
augustus	ɔ ɡ ə s t ə s
auld	oʊ l d
aureum	ɔ ɹ i ə m
aureus	ɔ ɹ i ə s
aurora	ɹ ɔ ɹ ə
auspiciously	ɔ s p ɪ ʃ ə s l i
austin	ɔ s t i n
australia	oʊ s t ɹ eɪ l j ə
auteur	oʊ t ɝ
author	ɑ ð ə
authority	ɔ θ ɔ ɹ ə t i
authors	ɔ θ ə s
autobiography	oʊ t ə b aɪ ə ɡ ɹ ə f i
autobiography	ɔ t ə b aɪ ə ɡ ɹ ə f i
autograph	oʊ t ə ɡ ɹ æ f
autological	ɔ t ə l ɑ dʒ ɪ k ə l
automata	oʊ t ə m ɑ t ə
automatons	ɔ t ə m ə t ɑ n z
autonomous	oʊ t ɑ n ə m ə s
autonomous	ɑ t ə n ə m ə s
autonomous	ə t ɑ n ə m ə s
autonomy	oʊ t ɑ n ə m i
autry	ə t ɹ i
avant	ə v ə n t
average	æ v ɝ ɪ dʒ
averages	æ v ɝ ɪ dʒ ɪ z
avicenna	æ v ɪ tʃ ɛ n ə
avid	eɪ v ɪ d
aviv	ə v i v
avon	eɪ v ə n
avondale	eɪ v ə n d eɪ l
awry	ɹ aɪ
axes	æ k s i s
ayr	eɪ ɝ
azar	ə z ɑ ɹ
aztec	æ s t ɛ k
aztecs	æ s t eɪ k s
aztecs	æ s t ɛ k s
babcock	b æ b k ɑ k
bachelor	b æ tʃ ə l ɝ
backend	b æ k æ n d
backup	b æ k ɔ p
baden	b æ d ə n
badminton	b æ d m ɪ ŋ t ə n
bags	b æ ɡ s
bahri	b ɑ ɹ i
baja	b ɑ h ə
balade	b ə l ɑ d
balalaika	b æ l ə l aɪ k ə
balash	b ɛ l ə ʃ
bald	b oʊ l d
baldy	b oʊ l d i
balkan	b ʌ l k ə n
balkans	b ʌ l k ə n z
ball	b oʊ l
ball's	b oʊ l z
balls	b oʊ l z
ballymena	b æ l i m i n ə
balm	b oʊ m
balsam	b oʊ l s ə m
baltimore	b oʊ l t ə m ɔ ɹ
bancor	b æ ŋ k ɔ ɹ
bancroft	b æ ŋ k ɹ ɔ f t
band's	b æ n d s
bang	b ɛ ŋ
bangalore	b æ ŋ ɡ ə l oʊ
bangalore	b æ ŋ ɡ ə l ə
bangladesh	b æ ŋ ɡ l ə d æ ʃ
bangor	b ɛ n ɡ ɔ ɹ
banker	b æ n k ɝ
bankruptcy	b æ ŋ k ɹ ə p t s i
banks	b æ n k s
baptist	b æ p t i s t
barbara	b ɑ ɹ b ɹ ə
barbuda	b ɑ ɹ b u d ə
barclay	b ɑ ɹ k l i
barclays	b ɑ ɹ k l i z
barely	b æ ɹ l i
baritones	b æ ɹ ə t oʊ n z
barking	b ɑ ɹ k i n
baroness	b ɛ ɹ ə n ɛ s
barons	b æ ɹ ə n z
barren	b ɛ ɹ ə n
barrett	b ɛ ɹ ɪ t
barrie	b æ ɹ i
barring	b ɑ ɹ ɪ ŋ
barrington	b ɛ ɹ ɪ ŋ t ə n
barrios	b ɑ ɹ i oʊ s
barron	b æ ɹ ə n
barrow	b ɛ ɹ oʊ
basal	b eɪ z ə l
base	b eɪ z
base	b ɛ s
bashir	b ə ʃ ɪ ɹ
basic	b æ s ɪ k
basilica	b ə z ɪ l ɪ k ə
basle	b eɪ z ə l
bass	b eɪ s
bassett	b æ z ɪ t
basswood	b eɪ s w ʊ d
basta	b ɛ s t ə
batavia	b ə t eɪ v i ə
batches	b æ tʃ i z
bateson	b eɪ t s ə n
bath	b ɛ θ
batting	b ɛ t ɪ ŋ
battle	b ɛ t ə l
baum	b ɑ m
bawls	b oʊ l z
bay	b ɛ
bayard	b eɪ ɑ ɹ d
bayer	b ɛ ɹ
bays	b eɪ s
be	b ɪ
beach	b ɪ tʃ
beaird	b ɪ ɹ d
bear	b eɪ
bear	b æ
bear	b ɛ
beatrix	b i ə t ɹ ɪ k s
beaumont	b oʊ m ɑ n t
beaumont	b oʊ m ə n t
became	b ɪ k æ m
beck	b æ k
becky's	b ɛ k ɪ s
becoming	b ɪ k ʌ m ɪ n
beda	b ɛ d ə
bedloe's	b æ d l oʊ z
bedrock	b ɛ d ɹ ə k
beeches	b i tʃ i z
been	b eɪ n
beer	b i
before	b i f ɔ
begets	b ɪ ɡ æ t s
begun	b ɪ ɡ ə n
behemoth	b ə h i m ɔ θ
being	b i n
being	b i ɪ n
beliefs	b ɪ l i v s
belly	b æ l i
belmont	b ɛ l m ə n t
belt	b æ l t
benavente	b ɛ n ə v ɛ n t i
bend	b æ n d
bender	b æ n d ɝ
benevento	b ɛ n ə v ɛ n t oʊ
bengal	b æ ŋ ɡ oʊ l
bengal	b æ ŋ ɡ ə l
bengal	b ɛ n ɡ oʊ l
bengal	b ɛ n ɡ ə l
bengali	b ɛ n ɡ ɑ l i
bengali	b ɛ n ɡ ɔ l i
benner	b æ n ɝ
bent	b æ n t
benzoin	b ɛ n z oʊ ɪ n
berate	b i ɹ eɪ t
berbice	b ɝ b i s
berkeley	b ɑ ɹ k l i
berkshire	b ɑ ɹ k ʃ aɪ ɹ
bernabe	b ɝ n ɑ b
bernadette	b ɝ n ɑ d ɛ t
bernhard	b ɝ n h ɑ ɹ d
bernie	b ɝ n ɪ
berryman	b ɛ ɹ ɪ m ə n
berserk	b ə z ɝ k
besant	b æ s ə n t
bestwood	b æ s t w ʊ d
beth	b æ t
bethlehem	b ɛ θ l i h æ m
between	b ɪ t w ɪ n
bhutan	b u t ə n
biases	b aɪ ə s ɪ s
bichon	b i ʃ ə ŋ
biggest	b i ɡ ə s t
biggs	b ɪ ɡ s
bihar	b ɪ h ə
billabong	b ɪ l ə b ə ŋ
billings	b ɪ l ɪ n z
billy	b ɪ l ɪ
bing	b ɪ n
biographer	b aɪ ə ɡ ɹ ə f ɝ
biographers	b aɪ ə ɡ ɹ ə f ɝ z
biographies	b aɪ ə ɡ ɹ ə f i z
biography	b aɪ ə ɡ ɹ ə f i
biologist	b aɪ ə l ə dʒ ɪ s t
birbal's	b ɝ b ə l z
birch's	b ɑ ɹ tʃ ɪ z
birds	b ɑ ɹ d z
birds	b ɝ d s
blais	b l eɪ z
blankety	b l æ ŋ k ə t ɪ
bleeding	b l i d ɪ n
blob	b l ʌ b
blockbuster	b l ɑ k b ʌ s t ɝ
blockbuster's	b l ɑ k b ʌ s t ɝ z
blogger	b l ɑ ɡ ɝ
blom	b l ʌ m
blood	b l ɑ d
blues	b l u s
blyth	b l aɪ θ
board	b ʌ d
boat	b ɔ t
bob	b oʊ b
bob	b ʌ b
bobcats	b ɑ b k æ t s
bobcats	b ʌ b k æ t s
bock	b oʊ k
body	b ʌ d i
bog	b oʊ ɡ
bogs	b oʊ ɡ z
bogs	b ɑ ɡ z
bohr	b oʊ ɝ
bois	b ɔɪ z
bold	b ɔ l d
bolivar	b ɑ l ə v ɑ ɹ
bollywood	b ɑ l i w ʊ d
bolshevik	b ʌ l ʃ ə v ɪ k
bomb	b ʌ m
bombings	b ʌ m ɪ ŋ z
bombom	b ɑ m b ə m
bon	b ɔ n
bonaventure	b oʊ n ə v ɛ n tʃ ɝ
bond	b ɔ n d
bone	b ɔ n
bong	b oʊ n
bong	b oʊ ŋ
boniface	b ɑ n i f eɪ s
bonk	b ʌ ŋ k
bonn	b ɔ n
bonnard	b ɑ n ɑ ɹ d
book	b u k
bookcase	b u k eɪ s
books	b u k s
booleans	b u l i ə n z
booth	b u ð
borders	b ɑ d ə z
bore	b ɑ
boreas	b ɔ ɹ i ə s
bored	b oʊ ɹ d
born	b oʊ n
born	b ʌ n
borough	b ɑ ɹ ə
bosch	b ɑ ʃ
bosco	b ɑ s k oʊ
boscombe	b ɑ s k ə m
bose	b oʊ s
bosh	b ɔ ʃ
bosman	b ɑ z m ə n
bothe	b oʊ θ
bottler	b ʌ t l ɝ
boulevard	b u l ə v ɑ ɹ d
boulevard	b ʊ l ə v ɑ d
boundaries	b aʊ n d ɝ i z
boundary	b aʊ n d ɝ i
bourgeois	b u ɹ ʒ w ɑ
bourne	b ɑ n
bovis	b oʊ v i s
bowie	b oʊ ɪ
bowie's	b oʊ i s
bowl	b ɔ l
box	b ɔ k s
boys	b oʊ i z
boys	b ɔɪ s
brabant	b ɹ eɪ b ə n t
bracelets	b ɹ æ s l ə t s
bracewell	b ɹ eɪ z w ɛ l
brachial	b ɹ æ k i ə l
bradford	b ɹ ɛ d f ɝ d
braff	b ɹ æ f
brahms's	b ɹ ɑ m z ɪ z
braking	b ɹ eɪ k ɪ n
braley	b ɹ eɪ l i
branding	b ɹ æ n d i n
branding	b ɹ æ n d ɪ n
brands	b ɹ ɛ n d z
brandt	b ɹ æ n t
brannen	b ɹ eɪ n ə n
brannigan	b ɹ ɛ n ɪ ɡ ə n
brashear	b ɹ ɛ ʃ ɪ ɹ
braun	b ɹ oʊ n
brawl	b ɹ oʊ l
brazier	b ɹ eɪ z ɪ ɹ
brazil	b ɹ ə s ɪ l
brazzaville	b ɹ ɛ z ə v ɪ l
break	b ɹ ɛ k
breakfast	b ɹ eɪ k f ɔ s t
breeders'	b ɹ i d ɝ z
brendan	b ɹ æ n d ə n
brenton	b ɹ æ n t ə n
brewing	b ɹ u ɪ n
bridge	b ɹ i dʒ
brinsley	b ɹ ɪ n z l i
british	b ɹ ɪ t ɪ z
britney's	b ɹ ɪ t n i z
broadcasters	b ɹ ɔ d k æ s t ɝ z
broadly	b ɹ ɑ d l i
broadview	b ɹ oʊ d f j u
brod	b ɹ ɔ d
brodhead	b ɹ ɔ d h ɛ d
brodsky	b ɹ ɑ d s k i
brokerage	b ɹ oʊ k ɹ ɪ dʒ
bromley	b ɹ ʌ m l i
bronchial	b ɹ ɑ ŋ k i ə l
brooks	b ɹ u k s
bror	b ɹ ɔ ɹ
broth	b ɹ oʊ θ
brother	b ɹ ɑ ð ɝ
brothers	b ɹ ɑ ð ɝ z
brothers'	b ɹ ʌ ð ɝ z
brought	b ɹ oʊ t
brubeck	b ɹ u b ɛ k
bruford	b ɹ u f ɝ d
brushes	b ɹ ʌ ʃ ɪ s
bubbles	b ʌ b ə l s
bubby	b ɑ b i
bubka	b ɑ b k ʌ
buccaneer	b ʌ k ə n ɪ ɹ
buccaneers	b ʌ k ə n ɪ ɹ z
bucknell	b ʌ k n ɛ l
bud	b ɑ d
buddhist	b ʊ d ə s t
buddy	b ɑ d i
buell	b j ʊ l
buffet	b ʌ f eɪ
bugs	b ʌ ɡ s
bukkake	b u k ə k i
bulawayo	b ʊ l ə w eɪ oʊ
bulk	b ɔ l k
bullard	b ʊ l ɑ ɹ d
bullinger	b u l ɪ ŋ ɝ
bullitt	b ʊ l ɪ t
bullseye	b ʊ l z aɪ
bullying	b ʊ l ɪ ŋ
bulwark	b ʊ l w ɔ k
bundestag	b u n d ə ʃ t ɑ ɡ
bungs	b ɑ n z
bureaucracies	b j ʊ ɹ ə k ɹ ə s i z
bureaucracy	b j ʊ ɹ ə k ɹ ə s i
buren	b j ʊ ɹ ə n
burgos	b ɝ ɡ oʊ s
burgundians	b ɝ ɡ ʌ n d i ə n z
burke	b ɔ ɹ k
burton	b ɑ ɹ t ə n
bus	b oʊ s
bus	b oʊ ʃ
bus	b ɑ ʃ
bus	b ɔ ʃ
buses	b ʌ s ɪ s
bush	b u ʃ
bush's	b ʊ ʃ i z
business	b ɪ s n ɪ s
businesses	b ɪ z n ɪ s ɪ s
businesses	b ɪ z n ɪ z ɪ z
busy	b ɪ z ɪ
butcher	b u tʃ ɝ
butte	b ɑ t
buzz	b ʌ s
c	s ɪ
cabello	k ə b ɛ l oʊ
cache	k æ s
cairns	k ɛ n z
caldera	k ɑ l d ɛ ɹ ə
calderon	k oʊ l d ɝ ə n
caldwell	k oʊ l d w ɛ l
calf	k ɔ f
call	k oʊ l
callable	k ɑ l ə b ə l
callas	k æ l ə s
called	k oʊ l d
calling	k ɑ l ɪ ŋ
calls	k oʊ l z
cambria	k eɪ m b ɹ i ə
cambrian	k eɪ m b ɹ i ə n
cambridge	k æ m b ɹ ɪ dʒ
cambridge	k ɛ m b ɹ ɪ dʒ
camera	k ɛ m ɝ ə
cameraman	k æ m ɹ ə m ə n
cameras	k æ m ɹ ə s
cameron	k æ m ɹ ə n
cameron's	k æ m ɹ ə n z
campanis	k æ m p ə n ɪ s
camping	k æ m p ɪ n
campos	k æ m p oʊ s
campuses	k æ m p ə s ɪ s
canada	k æ n ɑ d ə
canada	k æ n ə d ɔ
canada's	k æ n ɑ d ə z
canberra	k æ n b ɝ ə
candela	k æ n d eɪ l ə
candido	k æ n d ɪ d oʊ
candy	k ɛ n d i
canisius	k ə n ɪ s i ə s
canova	k ə n oʊ v ə
cantatas	k æ n t ə t ə s
canterbury	k æ n t ə b ɝ i
canterbury	k æ n t ə b ɹ i
canton	k æ n t ɑ n
canute	k ə n u t
capablanca	k æ p ə b l æ ŋ k ə
capel	k æ p ə l
capped	k ɛ p t
cappello	k ə p ɛ l oʊ
cappetta	k ə p æ t ə
capri	k æ p ɝ i
capsule	k æ p ʃ ə l
capua	k ə p u ə
caracas	k ɑ ɹ ə k ə s
caravaggio	k ɑ ɹ ə v ɑ dʒ i oʊ
caravaggio	k ɑ ɹ ə v ə dʒ i oʊ
caravelle	k ɛ ɹ ə v ɛ l
cardiac	k ɑ d i æ k
care	k eɪ
care	k æ
care	k ɛ
career	k ɝ i ɝ
career	k ɝ i ɹ
carew	k ɛ ɹ u
carillon	k ɛ ɹ ə l ə n
carlos	k ɑ ɹ l oʊ z
carlotta's	k ɑ ɹ l ɑ t ə z
carmel	k ɑ ɹ m ə l
carnarvon	k ɑ ɹ n ɑ ɹ v ə n
carnegie	k ɑ n i ɡ i
carole	k æ ɹ ə l
caroline	k ɛ ɹ ə l ɪ n
carrack	k ɛ ɹ ə k
carrie	k æ ɹ i
carrier	k æ ɹ i ə
carrier	k æ ɹ i ɝ
carrier	k ɛ ɹ i ə
carrington	k ɛ ɹ ɪ ŋ t ə n
carroll	k ɛ ɹ ə l
carrollton	k ɛ ɹ ə l t ə n
carry	k ɛ ɹ i
cars	k ɑ s
cars	k ɑ ɹ s
cars	k ɔ s
casablanca	k æ z ə b l æ ŋ k ə
case	k eɪ z
case	k ɛ s
casinos	k ə s i n oʊ z
cast	k ɔ s t
cast	k ʌ s t
casting	k ɔ s t ɪ ŋ
catastrophic	k æ t ə s t ɹ ə f ɪ k
catawba	k ə t oʊ b ə
categorically	k æ t ə ɡ ɔ ɹ ɪ k l i
catholic	k æ θ ɑ l ɪ k
caucasian	k oʊ k eɪ ʃ ə n
caucasian	k oʊ k eɪ ʒ ə n
caucasian	k ə k eɪ ʒ ə n
caucasus	k oʊ k ə s ə s
caucus	k oʊ k ə s
caudal	k oʊ d ə l
caul	k oʊ l
caulfield	k oʊ l f i l d
cause	k ɔ s
causes	k ɔ s ə s
causes	k ɔ s ɪ s
causing	k ɔ z ɪ n
causse	k ɔ z
caveat	k æ v i æ t
caveats	k æ v i æ t s
cavilla	k ə v i l ə
cecropia	s ɪ k ɹ oʊ p i ə
cell	s eɪ l
cellulose	s ɛ l j ə l oʊ z
censured	s ɛ n s ɝ d
centenary	s æ n t ə n ɛ ɹ i
centenary	s ɛ n t ɛ n ɝ i
centennial	s ɛ n t eɪ n i ə l
centers	s æ n ɝ z
centerville	s æ n t ɝ v ɪ l
centrale	s ɛ n t ɹ ə l
centre	s æ n t ɝ
centrist	s ɛ n t ɹ ɪ s t
cerise	s ɝ i z
chaco	tʃ æ k oʊ
chad	tʃ ɛ d
chaffee	tʃ ɛ f i
chal	tʃ ɑ l
chance	tʃ ɔ n s
chancellor	tʃ æ n s l ɝ
character	k ɛ ɹ ə k t ə
characters	k æ ɹ ə k t ɝ z
charity	tʃ æ ɹ ɪ t i
charlestown	tʃ ɑ ɹ ə l z t aʊ n
charlotte	ʃ ɑ l ɑ t
charlotte	ʃ ə l ə t
chart	tʃ ɔ ɹ t
chassis	tʃ ɛ s i
chassis	ʃ ɛ s i
chassis	ʃ ɛ s i z
chatham	tʃ ɛ t ə m
chaulk	tʃ ɔ k
chekhov	tʃ ɛ k ɔ v
chelmsford	tʃ æ l m s f ɝ d
chemist	k æ m ɪ s t
chemung	tʃ ɛ m ə n
chengdu	tʃ ɛ n d u
chessel	tʃ æ s ə l
chester	tʃ æ s t ɝ
chestnuts	tʃ ɛ s n ʌ t s
chiffon	ʃ ɪ f ə n
chile	tʃ ɪ l eɪ
chillicothe	tʃ ɪ l ɪ k oʊ θ
chinquapin	tʃ ɪ ŋ k ə p ɪ n
chinsurah	tʃ ɪ n s ɝ ə
chips	tʃ ɪ p z
chisum	tʃ i s ə m
chittagong	tʃ ɪ t ə ɡ ə ŋ
chlorine	k l ɔ ɹ ɪ ŋ
chocolate	tʃ ɑ k l ə t
choctaw	tʃ ɔ k t oʊ
choir	k w aɪ ɹ
choirs	k w aɪ ɝ z
cholesterol	k ə l ɛ s t ɹ ə l
chong	tʃ ə ŋ
choral	k ɑ ɹ ə l
christa	k ɹ ɪ s t ə
christi	k ɹ i s t i
christoph	k ɹ ɪ s t ɑ v
chromosome	k ɹ oʊ m ə z oʊ m
chuff	tʃ ɑ f
chump	tʃ ɑ m p
chun	tʃ ə n
cinema	s ɪ n ə m ɑ
cinemas	s ɪ n ə m ə s
cineplex	s ɪ n ə p l æ k s
circadian	s ɝ k eɪ d i ə n
circadian	s ɝ k ɑ d i ə n
cities	s ɪ t ɪ z
citizen	s ɪ t ə s ə n
citizens	s ɪ t ə s ə n s
citizens	s ɪ t ɪ s ə n z
city	s i t i
city	ʃ ɪ t i
city's	s ɪ t ɪ z
claiborne	k l eɪ b ɔ ɹ n
claiborne's	k l eɪ b ɔ ɹ n z
claire	k l æ ɹ
claremont	k l ɛ ɹ m ə n t
clarence	k l ɛ ɹ ə n z
clarens	k l æ ɹ ə n z
clarification	k l æ ɹ ə f ə k eɪ ʃ ə n
clarified	k l æ ɹ ə f aɪ d
clarify	k l æ ɹ ə f aɪ
clarinet	k l æ ɹ ə n ɛ t
claros	k l ɑ ɹ oʊ s
class	k l ɔ s
class	k l ʌ s
classes	k l ɔ s ɪ z
claude	k l oʊ d
clause	k l oʊ z
claws	k l oʊ z
clef	k l æ f
clemens	k l ɛ m ə n s
clerk	k l ɑ ɹ k
clerk	k l ʌ k
clerk's	k l ɑ ɹ k s
clichy	k l ɪ ʃ i
clock	k l oʊ k
clockwise	k l ɑ k w aɪ z
clogged	k l ɑ ɡ d
close	k l oʊ s
closer	k l oʊ z ɝ
closest	k l oʊ z ə s t
closure	k l oʊ ʃ ɝ
clothing	k l oʊ θ ɪ ŋ
clotting	k l ɔ t ɪ ŋ
clovis	k l oʊ v i s
club	k l ɑ b
clubs	k l ɑ b z
clubs	k l ʌ b s
clucking	k l ɑ k ɪ ŋ
cluny	k l u n ɪ
coamo	k oʊ ə m oʊ
cobalt	k oʊ b oʊ l t
cobb	k ɔ b
cochin	k oʊ tʃ ɪ ŋ
cocking	k ɔ k ɪ ŋ
cockpit	k ɔ k p ɪ t
cockrum	k ɑ k ɹ ə m
cod	k ɔ d
codrington	k ɑ d ɹ ɪ ŋ t ə n
coffey	k ɔ f i
cofton	k ɔ f t ə n
cohere	k oʊ h i ɹ
colchester	k oʊ l tʃ ɛ s t ɝ
colcord	k ɔ l k ɔ ɹ d
coleraine	k oʊ l ɝ eɪ n
collaborative	k ə l æ b ɝ ə t ɪ v
collaborative	k ə l æ b ɹ ə t ɪ v
collage	k ɔ l ɑ ʒ
collar	k ʌ l ɝ
collared	k ʌ l ɝ d
colleagues	k ə l i ɡ z
collector's	k ə l ɛ k t ɝ s
college	k ɔ l ɪ dʒ
college	k ə l i dʒ
colleton	k ɑ l ɪ t ə n
collier	k ɑ l i ɝ
collingwood	k ɑ l ɪ n w ʊ d
collot	k ɑ l oʊ
colophon	k ɑ l ə f ə n
color	k oʊ l ɝ
color	k ɑ l ɝ
coloration	k ɑ l ɝ eɪ ʃ ə n
colors	k ɑ l ɝ z
colostrum	k ɑ l oʊ s t ɹ ə m
colour	k ɑ l ɝ
colquitt	k ɔ l k w ɪ t
columbia	k ə l ə m b i ə
colville	k ɔ l v ɪ l
com	k ə m
com	k ʌ m
comatose	k oʊ m ə t oʊ z
combats	k ɑ m b æ t s
combatting	k ɑ m b æ t ɪ ŋ
combine	k ɑ m b aɪ n
combing	k oʊ m ɪ n
comcast	k ʌ m k æ s t
comeback	k ɑ m b æ k
comfort	k ə m f ɔ t
comforts	k ə m f ɝ t s
comfrey	k ɑ m f ɹ i
coming	k ʌ m ɪ n
commandant	k ɑ m ə n d ə n t
commemorative	k ə m ɛ m ɝ ə t ɪ v
comment	k ə m ɛ n t
commentaries	k ɑ m ə n t ɛ ɹ i z
commenting	k ə m ɛ n t ɪ ŋ
comments	k ə m ɛ n t s
common	k ʌ m ə n
communities	k ə m j u n ə t i s
commuting	k ə m j u t i n
comp	k ə m p
companies	k ʌ m p ə n i s
comparable	k ə m p ɑ ɹ ə b ə l
comparable	k ə m p ɛ ɹ ə b ə l
comparable	k ə m p ɝ ə b ə l
comparative	k ə m p ɝ ə t ɪ v
compass	k ɑ m p ə s
compass	k ə m p ə s
complaining	k ʌ m p l eɪ n ɪ ŋ
complementary	k ɑ m p l ə m ɛ n t ɝ i
complementary	k ɑ m p l ə m ɛ n t ɹ i
complexity	k ɑ m p l ɛ k s ə t i
composite	k ɑ m p ə z ə t
composite	k ɑ m p ə z ɪ t
compound	k ɑ m p aʊ n d
compounds	k ʌ m p aʊ n d z
comprehensive	k ɑ m p ɹ ɪ h ɛ n s ɪ v
comptroller	k ə m t ɹ oʊ l ɝ
concept	k ə n s ɛ p t
concepts	k ə n s ɛ p t s
concoctions	k ə n k ʌ k ʃ ə n z
concord	k ɑ n k ɔ ɹ d
concord	k ɑ ŋ k ɔ ɹ d
concourse	k ɑ ŋ k ɔ ɹ s
concrete	k ɑ ŋ k ɹ i t
concretely	k ə n k ɹ i t l i
concubines	k ɑ ŋ k j ə b aɪ n z
conductivity	k ə n d ə k t ɪ v ə t i
confidant	k ɑ n f ə d ə n t
configure	k ə n f ɪ ɡ j ɝ
conflagrations	k ə n f l ə ɡ ɹ eɪ ʃ ə n z
conformation	k ɑ n f ɔ ɹ m eɪ ʃ ə n
confrontation	k ə n f ɹ ə n t eɪ ʃ ə n
confronts	k ə n f ɹ ə n t s
congolese	k ɑ ŋ ɡ ə l i z
congress	k ɑ n ɡ ɹ ə s
congressional	k ɑ n ɡ ɹ ɛ ʃ ə n ə l
congruent	k ə ŋ ɡ ɹ u ə n t
conjoined	k ə n dʒ ɔɪ n d
conley	k ʌ n l i
conn's	k ɑ n z
connaught	k ɑ n oʊ t
connie	k oʊ n i
connie	k ɑ n i
connolly	k ɑ n ə l i
conquered	k ɑ n k ɝ d
conquest	k ə ŋ k w ɛ s t
conquests	k ə ŋ k w ɛ s t s
conrad	k ɑ n ɹ ɛ d
consequences	k ɑ n s ə k w ə n s i z
conservation	k ə n s ɝ v eɪ ʃ ə n
considered	k ə n s i d ɝ d
consist	k ɑ n s ɪ s t
console	k ɑ n s oʊ l
conspiring	k ə n s p aɪ ɹ ɪ ŋ
constable	k ə n s t ə b ə l
construal	k ɑ n s t ɹ u ə l
consul	k ə n s ə l
consultation	k ə n s ə l t eɪ ʃ ə n
consumer	k ɑ n ʃ u m ə
consummating	k ə n s ə m eɪ t ɪ ŋ
contagiously	k ə n t ɛ dʒ ə s l i
conte's	k ɑ n t i s
contemplative	k ə n t ə m p l eɪ t ɪ v
conterminous	k ɑ n t ɝ m ə n ə s
context	k ə n t ɛ k s t
contingents	k ɑ n t ɪ n dʒ ə n t s
contour	k ə n t ʊ ɹ
contours	k ə n t ʊ ɹ z
contrabass	k ɑ n t ɹ ə b eɪ s
contracting	k ɑ n t ɹ æ k t ɪ ŋ
contractor	k ə n t ɹ æ k t ɝ
contractors	k ə n t ɹ æ k t ɝ z
contralto	k ə n t ɹ ɛ l t oʊ
contrast	k ə n t ɹ æ s t
contrasts	k ə n t ɹ æ s t s
contribution	k ə n t ɹ ə b j u ʃ ə n
controversial	k ɑ n t ɹ ə v ɝ s ə l
controversy	k ə n t ɹ ə v ɝ s i
convective	k ə n v æ k t ɪ v
conversion	k ə n v ɝ ʃ ə n
convoy	k ə n f ɔɪ
cooke	k u k
cooperstown	k u p ɝ s t aʊ n
copper	k ɑ p ə
copy	k ɔ p i
coral	k ɑ ɹ ə l
coralie	k ɑ ɹ ə l i
cordelia	k ɔ d i l i ə
cordell	k ɔ ɹ d ɛ l
cordoned	k ɔ ɹ d ə n d
core	k oʊ
core	k ɑ
cork	k oʊ k
corolla	k ɔ ɹ ə l ə
corporate	k ɑ p ɝ ə t
corporate	k ɔ p ɝ ə t
corps	k oʊ
corps	k oʊ ɹ
corps	k ɑ
corps	k ɔ ɹ z
corpus	k oʊ p ə s
corrections	k ɝ æ k ʃ ə n z
corridor	k ɑ ɹ ə d ɔ ɹ
corridors	k ɔ ɹ ə d ɔ ɹ z
cosmetics	k ɑ z m æ t ɪ k s
cosmology	k ɑ z m ɑ l ə dʒ i
cosmonaut	k ɑ z m ə n ɑ t
cosmonaut	k ɑ z m ə n ɔ t
cossus	k ɔ s ə s
costa	k oʊ s t ə
costa	k ʌ s t ə
costal	k ɑ s t ə l
costello	k oʊ s t ɛ l oʊ
costello	k ɑ s t ɛ l oʊ
costello's	k ɑ s t ɛ l oʊ z
cosway	k ɑ z w eɪ
cotswold	k ɑ t s w ɔ l d
cottonwood	k ʌ t ə n w ʊ d
coughing	k ɔ f ɪ ŋ
could	k u d
coulomb	k u l ə m
coumarin	k u m ɑ ɹ ɪ n
counting	k aʊ n t ɪ n
countries	k ɑ n t ɹ i s
countries	k ʌ n t ɹ i s
countries'	k ʌ n t ɹ i z
couple's	k ə p ə l z
coupons	k u p ɑ n z
courier	k ʊ ɹ i ɝ
course	k oʊ s
course	k ɔ z
courses	k ɔ z ɪ z
court	k oʊ t
courtesan	k ɔ ɹ t ə z ə n
coverage	k ʌ v ɝ ɪ dʒ
covers	k ɑ v ə s
covers	k ɔ f ɝ z
covers	k ʌ v ə s
covington	k ɑ v ɪ ŋ t ə n
cowlishaw	k aʊ l ɪ ʃ ə
cozens	k ɔ s ə n z
crafted	k ɹ æ f t ɪ d
crafts	k ɹ æ f s
craig	k ɹ æ ɡ
cramps	k ɹ æ m p z
crandell	k ɹ æ n d ə l
crankshaft	k ɹ æ ŋ k ʃ æ f t
crash	k ɹ æ s
cratty	k ɹ æ t i
craxi	k ɹ æ k s i
crazy	k ɹ eɪ z ɪ
credentials	k ɹ ə d ɛ n ʃ ə l z
credibility	k ɹ æ d ə b ɪ l ɪ t i
credibility	k ɹ ɛ d ə b ɪ l ɪ t i
creese	k ɹ i s
cremated	k ɹ ɪ m eɪ t ɪ d
cremation	k ɹ ɪ m eɪ ʃ ə n
crematorium	k ɹ ɛ m ə t ɔ ɹ i ə m
crescents	k ɹ ɛ z ə n t s
crestfallen	k ɹ ɛ s t f ɑ l ə n
creswell	k ɹ æ s w ɛ l
cricketer	k ɹ ɪ k ɪ t ɝ
crippling	k ɹ ɪ p l ɪ ŋ
criticism	k ɹ ɪ t ɪ z ɪ z ə m
critics	k ɹ ɪ t i k s
critics'	k ɹ ɪ t ɪ k s
crofton	k ɹ ɔ f t ə n
crookston	k ɹ ʊ k s t ə n
crops	k ɹ ʌ p s
crosby	k ɹ ɔ s b i
cross	k ɹ oʊ s
crossborder	k ɹ ɔ s b ɔ ɹ d ɝ
crosse	k ɹ ɔ s
crossley	k ɹ ɔ s l i
crosswalk	k ɹ ɔ s w ɔ k
crossword	k ɹ ɔ s w ɝ d
crotchet	k ɹ ʌ tʃ ɪ t
croyle	k ɹ oʊ ɪ l
cruising	k ɹ u z i n
crustaceans	k ɹ ʌ s t eɪ ʃ ə n z
cryin	k ɹ aɪ ɪ ŋ
cucumber	k j u k ʌ m b ɝ
cucumbers	k j u k ʌ m b ɝ z
cudahy	k ə d ɑ h i
cudworth	k ɑ d w ɝ θ
culled	k ɔ l d
culver's	k ɑ l v ɝ z
cummings	k ʌ m ɪ n z
cup	k ɑ p
curatorial	k j ʊ ɹ ə t ɔ ɹ i ə l
curragh	k ɔ ɹ ə
curricles	k ɑ ɹ ə k ə l z
curry	k ɑ ɹ i
curzon	k ɝ z ə n
cushing	k ʊ ʃ ɪ n
custodian	k ɑ s t oʊ d i ə n
customers	k ʌ s t ə m ə s
cut	k ɑ t
cuts	k ɑ t s
cuz	k ɑ z
cyclops	s aɪ k l ɑ p s
dace	d eɪ z
dacha	d ʌ tʃ ə
dada	d ɑ d ə
dafoe	d eɪ f oʊ
daily	d eɪ l ɪ
dairy	d eɪ ɹ i
dale	d ɛ l
dalton	d oʊ l t ə n
dalton	d ɑ l t ə n
damages	d ɛ m ɪ dʒ ɪ z
damietta	d eɪ m i ɛ t ə
damsel	d æ m s ə l
dan	d ɛ n
dana	d eɪ n ə
dance	d æ n z
dance	d ɛ n z
dandenong	d æ n d ə n ə ŋ
danish	d æ n ɪ ʃ
darden's	d ɑ ɹ d ə n z
darius	d ɛ ɹ i ə s
darrell	d æ ɹ ə l
darren	d ɑ ɹ ə n
darren	d ɛ ɹ ə n
darryl	d æ ɹ ə l
darryl	d ɛ ɹ ə l
data	d ɛ t ə
date	d ɛ t
dating	d eɪ t i n
datum	d eɪ t ə m
daube	d oʊ b
daughter	d oʊ t ɝ
daughters	d ɔ t ɝ s
davenport	d eɪ v ə n p ɔ ɹ t
david	d æ v ɪ d
davies	d eɪ v ɪ s
davis	d eɪ v i z
davis	d eɪ v ɪ z
dawes	d oʊ z
dawn	d ɑ n
dawson	d oʊ s ə n
day	d æ
day's	d eɪ s
days	d eɪ s
days	d ɛ z
de	d æ
de	d ɪ
dead	d æ d
deal	d ɪ l
dearie	d i ɹ i
debbie	d æ b i
debriefed	d ɪ b ɹ i f t
debris	d eɪ b ɹ i
debunked	d i b ʌ ŋ k t
decapitated	d ɪ k æ p ə t eɪ t ɪ d
december	d ɪ s æ m b ɝ
december	d ɪ z ɛ m b ɝ
decentralized	d i s ɛ n t ɹ ə l aɪ z d
decides	d ɪ s aɪ d s
decisions	d ɪ s ɪ ʃ ə n z
decoding	d i k oʊ d ɪ ŋ
decomposition	d i k ɑ m p ə z ɪ ʃ ə n
decompositions	d i k ɑ m p ə z ɪ ʃ ə n z
decorative	d ɛ k ɝ ə t ɪ v
decrease	d ɪ k ɹ i s
decreased	d ɪ k ɹ i s t
decryption	d i k ɹ ɪ p ʃ ə n
dees	d ɪ s
default	d i f ɔ l t
defaults	d i f ɔ l t s
defense	d i f ɛ n z
deforestation	d i f ɔ ɹ ə s t eɪ ʃ ə n
deformed	d i f ɔ ɹ m d
defund	d i f ɑ n d
del	d eɪ l
deland	d eɪ l ə n d
delhi	d æ l i
delivery	d ɪ l ɪ v ɹ i
dell	d æ l
della	d eɪ l ə
delmont	d ɛ l m ə n t
delphinium	d æ l f ɪ n i ə m
demand	d ɪ m ə n d
demetrius	d ɪ m eɪ t ɹ i ə s
demetrius	d ɪ m i t ɹ i ə s
demo	d æ m oʊ
democracy	d ɪ m ə k ɹ ə s i
demonstrations	d ɛ m ə n s t ɹ eɪ s ə n z
demos	d æ m oʊ z
dennis	d ɛ n ɪ z
dennys	d ɛ n i z
denomination	d ɪ n ɑ m ə n eɪ ʃ ə n
denominational	d ɪ n ɑ m ə n eɪ ʃ ə n ə l
denominations	d ɪ n ɑ m ə n eɪ ʃ ə n z
denote	d i n oʊ t
densities	d ɛ n s ə t ɪ z
denudation	d i n u d eɪ ʃ ə n
depopulated	d i p ɑ p j ə l eɪ t ɪ d
deportees	d i p ɔ ɹ t i z
deposits	d ɪ p ɑ s ɪ t s
derail	d i ɹ eɪ l
derby	d ɑ ɹ b i
derbyshire	d ɝ b ɪ ʃ ɝ
des	d ɪ z
descent	d ɪ s æ n t
desecrated	d ɛ s ə k ɹ eɪ t ɪ d
deseret	d ɛ s ɝ eɪ t
desert	d eɪ s ə t
deserted	d ɪ s ɝ t ɪ d
desertion	d ɪ s ɝ ʃ ə n
deserve	d ɪ s ɝ v
designed	d ɪ s aɪ n d
desire	d ɪ s aɪ ɝ
desmond	d ɛ s m ə n d
detail	d i t æ l
detailed	d i t eɪ l d
detailing	d i t eɪ l ɪ ŋ
deter	d i t ɝ
detractors	d i t ɹ æ k t ɝ z
detroit	d ɪ t ɹ ɔɪ t
dev	d æ v
deva	d eɪ v ə
developers	d ɪ v ɛ l ə p ɝ s
developing	d ɪ v ɛ l ə p ɪ n
device	d ɪ v aɪ z
devon	d eɪ v ə n
devon	d æ v ə n
devonport	d æ v ə n p ɔ ɹ t
devote	d i v oʊ t
dewsbury	d u s b ɛ ɹ i
dexterity	d ɛ k s t ɛ ɹ ə t i
dhaka	d ɑ k ɑ
dhaka	d ʌ k ə
diagnose	d aɪ ə ɡ n oʊ z
diagnoses	d aɪ ə ɡ n oʊ s ɪ z
diagnosing	d aɪ ə ɡ n oʊ z ɪ ŋ
diaspora	d aɪ æ s p ɹ ə
dictys	d ɪ k t ɪ s
dies	d aɪ s
dietrich	d ɪ t ɹ ɪ k
different	d ɪ f ɝ ə ŋ t
differently	d ɪ f ɝ ə n t l i
diffract	d ɪ f ɹ æ k t
dill	d i l
diocese	d aɪ ə s i s
diocese	d aɪ ə s ɪ s
dion	d i ə n
dior	d i ɔ ɹ
dioxide	d aɪ ə k s aɪ d
direct	d ɪ ɹ ɛ k t
directives	d ɪ ɹ ɛ k t ɪ v z
director	d ɝ æ k t ɝ
director	d ɪ ɹ ɛ k t ɝ
directorial	d ɝ ɛ k t ɔ ɹ i ə l
directors	d ɪ ɹ ɛ k t ɝ z
directory	d ɝ ɛ k t ɹ i
discipline	d ɪ s ə p l i n
discoloration	d ɪ s k ə l ɝ eɪ ʃ ə n
discoveries	d ɪ s k ʌ v ɹ i z
disease	d ɪ s i z
diseases	d ɪ s i z ɪ z
dislodged	d ɪ s l ʌ dʒ d
disney	d ɪ s n i
dispersion	d ɪ s p ɝ ʃ ə n
displace	d ɪ s p l eɪ z
disrepair	d ɪ s ɹ i p ɛ ɹ
dissolution	d ɪ s ə l u ʒ ə n
dissolve	d ɪ s ɑ l v
dissolved	d ɪ s ɑ l v d
distances	d ɪ s t ə n s i z
distributive	d ɪ s t ɹ ɪ b j u t ɪ v
ditto	d i t oʊ
diverse	d ɪ v ɝ z
diversionary	d ɪ v ɝ ʃ ə n ɛ ɹ i
diving	d aɪ v ɪ n
division	d ɪ f ɪ ʃ ə n
division	d ɪ v ɪ ʃ ə n
divisor	d ɪ v aɪ s ɝ
divorce	d ɪ f ɔ s
dizziness	d ɪ s i n ə s
doc	d ɔ k
dock	d ɔ k
dock	d ʌ k
docking	d ɔ k ɪ ŋ
docking	d ʌ k ɪ ŋ
doctor	d oʊ k t ɝ
doctor	d ɑ k t ə
doctoral	d ɑ k t ɔ ɹ ə l
doctoral	d ɑ k t ɹ ə l
doctorate	d ɑ k t ɹ ə t
doctrine	d ɑ k t ɹ i n
documentaries	d ɑ k j ə m ɛ n t ɹ i z
dodd	d ɔ d
dodd's	d ʌ d z
does	d ɔ z
does	d ʌ s
dogmatic	d ɔ ɡ m æ t ɪ k
dogon	d oʊ ɡ ə n
doing	d u ɪ n
doldrums	d ʌ l d ɹ ə m z
doll	d oʊ l
doll	d ʌ l
dollar	d oʊ l ə
dollar	d ɑ l ə
dolliver	d ɑ l ɪ f ɝ
dolls	d ɔ l z
dolls	d ʌ l z
domains	d oʊ m æ n z
domenico	d oʊ m ɛ n ɪ k oʊ
domestic	d ə m æ s t ɪ k
dominicans	d ə m ɪ n ɪ k ə n s
don	d ɑ ŋ
don	d ʌ n
donatus	d ə n ɑ t ə s
donbas	d ɑ n b ə s
doncaster	d ɑ ŋ k æ s t ɝ
donegal	d ɑ n i ɡ ə l
dong	d oʊ ŋ
donovan's	d ʌ n ə v ə n z
dont	d ə n t
door	d oʊ
doppler	d ʌ p l ɝ
doraville	d ɔ ɹ ə v ɪ l
doric	d ɑ ɹ ɪ k
doris	d ɔ ɹ ə s
dormant	d oʊ m ə n t
dortmund	d ɔ ɹ t m ə n d
dose	d oʊ z
dostoyevsky	d ɑ s t ɔɪ ɛ v s k i
dot	d oʊ t
doughnut	d oʊ n ə t
downs	d aʊ n s
downwards	d aʊ n w ɝ d s
dowry	d aʊ ɝ i
drachma	d ɝ æ k m ə
drachmas	d ɹ æ k m ə s
dram	d ɹ ʌ m
dramas	d ɹ ɑ m ə s
dramatically	d ɹ ə m æ t ɪ k ə l i
drawer	d ɹ oʊ ɝ
drawn	d ɹ oʊ n
dreadfuls	d ɹ ɛ d f ɔ l z
dreadnought	d ɹ ɛ d n ɑ t
dress	d ɹ æ z
dreyfus	d ɹ eɪ f ə z
dribbling	d ɹ ɪ b ə l ɪ ŋ
driving	d ɹ aɪ v ɪ n
drizzling	d ɹ ɪ z l ɪ ŋ
drowning	d ɹ aʊ n ɪ n
drury	d ɹ ʊ ɹ i
drydock	d ɹ aɪ d ɑ k
dubbed	d ɑ b d
duck	d ɑ k
dumas	d u m ə
dumas	d u m ə s
dumfries	d ʌ m f ɹ i s
dumfries	d ʌ m f ɹ i z
duncan	d ʌ n k ə n
dundas	d ʌ n d ə s
dundee's	d ʌ n d i z
dungarees	d ɑ ŋ ɡ ɝ i z
dunlop	d ʌ n l ə p
dupont	d u p ə n t
during	d u ɹ ɪ ŋ
during	d ɹ ɪ n
during	d ʊ ɹ ɪ n
dyeing	d aɪ ɪ n
dying	d aɪ ɪ n
dyskinesia	d ɪ s k ə n i z i ə
e	ɪ
each	ɪ tʃ
eagleswood	i ɡ ə l z w ʊ d
earhart	ɛ ɹ h ɑ ɹ t
earlier	ɹ l i ɝ
earned	ɹ n d
earnhardt	ɝ n h ɑ ɹ t
ease	ɪ z
easing	i z i n
east	ɪ s t
easton	ɪ s t ə n
ebenezer	ɛ b ə n i z ɝ
ebert	eɪ b ɝ t
ebon	i b ə n
economic	æ k ə n ɑ m ɪ k
economic	ɪ k ɑ n ə m ɪ k
economic	ɪ k ə n ɑ m ɪ k
economics	æ k ə n ɑ m ɪ k s
economies	i k ə n ɑ m ɪ s
economies	ɪ k ə n ɑ m i z
economy	ɪ k ə n ə m i
ecstatic	ɛ k s t ɛ t ɪ k
ecuador	ɛ k w ə d oʊ ɹ
ecuadorian	ɛ k w ə d ɔ ɹ i ə n
eddie	æ d i
eddleman	æ d ə l m ə n
edge	eɪ dʒ
edge	æ dʒ
edit	æ d ɪ t
editor	æ d ɪ t ɝ
editors	ɛ d ɪ t ɔ z
edwardian	ɛ d w ɔ ɹ d i ə n
eerie	i ɹ i
effluent	æ f l u ə n t
effort	ɛ f ɔ t
eggs	ɛ ɡ s
eglinton	ɛ ɡ l ɪ ŋ t ə n
egmont	ɛ ɡ m ə n t
egypt	ɪ dʒ ɪ p t
eh	eɪ
eh	æ
einstein	aɪ n ʃ t aɪ n
eisenhower	aɪ s ə n h aʊ ɝ
eisner	aɪ z n ɝ
either	aɪ θ ɝ
elaborately	ɪ l æ b ɝ ə t l i
elasticity	ɪ l æ s t ɪ s ə t i
elba	æ l b ə
elbe	æ l b
elbe	æ l b ə
elders	ɛ l d ə s
election	i l ɛ k ʃ ə n
electrons	ɪ l ɛ k t ɹ ɑ n z
elementary	ɛ l ə m ɛ n t ɝ i
elementary	ɛ l ə m ɛ n t ɹ i
elen	æ l ə n
elena	ɛ l i n ə
elena	ɛ l ə n ə
elgon	ɛ l ɡ ə n
eli	eɪ l i
elis	æ l i z
elites	i l i t s
ella	eɪ l ə
ellice	ɛ l i s
ellie	æ l i
elling	æ l ɪ ŋ
ellis	ɛ l i s
elmira	æ l m aɪ ɹ ə
elon	ɪ l ə n
elongate	i l ɔ ŋ ɡ eɪ t
elongation	ɪ l ɔ ŋ ɡ eɪ ʃ ə n
eltham	æ l t ə m
elves	ɛ l f s
elvin	æ l v ɪ n
elvis	æ l v ɪ s
elytra	i l ɪ t ɹ ə
elytra	æ l i t ɹ ə
email	ɪ m eɪ l
ember	æ m b ə
emberton	æ m b ɝ t ə n
emerald	ɛ m ɝ ə l d
emerging	ɪ m ɝ dʒ ɪ n
emerson	æ m ɝ s ə n
emil	ɛ m ɪ l
emmy	eɪ m i
emmy	æ m i
emperor	ɛ m p ɝ ə
emperor	ɛ m p ɹ ɝ
emphysema	æ m f ə s i m ə
empire	æ m p aɪ ɝ
empties	æ m t i z
emsley	ɛ m s l i
en	æ n
enclave	æ n k l eɪ v
enclitic	æ n k l ɪ t ɪ k
encrypted	ɪ n k ɹ ɪ p t ɪ d
end	æ n d
ended	æ n d ɪ d
endemic	æ n d ɛ m ɪ k
ending	æ n d ɪ n
eng	æ ŋ
engel	æ n ɡ ə l
engels	æ ŋ ɡ ə l z
engineer's	ɛ n dʒ ə n ɪ ɹ z
engines	æ n dʒ ə n z
englewood	æ ŋ ɡ ə l w ʊ d
english	ɪ n l ɪ ʃ
enoch	ɪ n ɑ k
enquiry	ɪ n k w aɪ ɝ i
enrique	æ n ɹ i k
enriquez	æ n ɹ i k eɪ z
ensemble	ɑ n s ə m b ə l
ensemble	ɔ n s ɑ m b ə l
enstrom	ɛ n s t ɹ ə m
ensues	ɪ n ʃ u z
ensured	ɪ n ʃ ʊ ɹ d
entered	æ n t ɝ d
entering	ɛ n t ɝ ɪ n
enters	æ n t ɝ z
enters	ɛ n t ə s
entomology	æ n t ə m ɑ l ə dʒ i
entrance	æ n t ɹ ə n s
entrance	ɛ n t ɹ ə n z
entries	æ n t ɹ i z
entry	æ n t ɹ i
envelope	æ n v ə l oʊ p
enzyme	ɛ n s aɪ m
ephemeral	i f ɛ m ɝ ə l
epiphany	i p ɪ f ə n i
equals	i k w ɔ l z
equations	ɪ k w eɪ ʃ ə n z
equilibria	i k w ə l ɪ b ɹ i ə
equilibrium	ɛ k w ɪ l ɪ b ɹ i ə m
equity	æ k w ə t i
era	ɪ ɹ ə
erhard	ɛ ɹ h ɑ ɹ d
eric	æ ɹ ɪ k
errata	ɹ ɑ t ə
error	ɛ ɹ
erupted	ɪ ɹ ʌ p t ɪ d
eruptions	ɪ ɹ ʌ p ʃ ə n z
escovedo	ɛ s k ə v ɛ d oʊ
esmolol	ɛ s m ə l oʊ l
esperance	ɛ s p ɝ ə n s
estill	æ s t ə l
estrogen	æ s t ɹ ə dʒ ə n
estrogen	ɪ s t ɹ ə dʒ ə n
et	æ t
etc	æ t s ɛ t ɹ ə
ethanol	ɛ θ ə n ə l
ethics	æ θ ɪ k s
etymology	eɪ t ə m ɑ l ə dʒ i
eucharist	j u k ɝ ɪ s t
eunice	j u n i s
eurasia	j ʊ ɹ eɪ ʃ ə
euro	j ʊ ɹ oʊ
evaluating	ɪ v æ l j u eɪ t ɪ ŋ
evaluation	i v æ l j u eɪ ʃ ə n
evaluations	i v æ l j u eɪ ʃ ə n z
evangelism	ɪ v æ n dʒ ə l ɪ z ə m
evangelizing	ɪ v æ n dʒ ə l aɪ z ɪ ŋ
evaporate	i v æ p ɝ eɪ t
evaporated	i v æ p ɝ eɪ t ɪ d
evaporation	i v æ p ɝ eɪ ʃ ə n
evasion	ɪ v eɪ ʒ ə n
evasive	ɪ v eɪ s ɪ v
evening	i v ə n ɪ n
events	ɪ v æ n t s
eventual	ɪ v ɛ n tʃ u ə l
eventually	i v ɛ n tʃ u l i
ever	æ f ə
eversley	ɛ v ɝ z l i
everton	æ v ɝ t ə n
every	æ v ɹ i
everywhere	ɛ v ɹ i w ɛ ɹ
exact	ɪ ɡ s æ k t
excess	æ k s ɛ s
exchequer	ɛ k s tʃ ɛ k ɝ
exe	æ k s
exemplar	ɪ ɡ z ɛ m p l ɝ
existed	ɪ ɡ s ɪ s t ɪ d
existential	ɛ ɡ s ɪ s t ɛ n tʃ ə l
exit	ɛ k z ɪ t
exit	ɛ ɡ s ɪ t
exorcist	ɛ k s ə s ɪ s t
expendable	ɪ k s p æ n d ə b ə l
expenditure	ɪ k s p ɛ n d ɪ tʃ ɝ
expenditures	ɪ k s p ɛ n d ɪ tʃ ɝ z
expensive	ɪ k s p æ n s ɪ v
experiencing	ɪ k s p ɪ ɹ i ə n s ɪ n
expiry	ɪ k s p aɪ ɝ i
exports	ɛ k s p ɔ ɹ t s
expressionism	ɪ k s p ɹ ɛ ʃ ə n ɪ z ə m
expressionistic	ɪ k s p ɹ ɛ s ə n ɪ s t ɪ k
expulsion	ɪ k s p ʌ l ʒ ə n
extends	ɪ k s t ɛ n d s
extract	ɪ k s t ɹ æ k t
extramarital	ɛ k s t ɹ ə m ɛ ɹ ə t ə l
exulted	ɪ ɡ z ɔ l t ɪ d
f	æ f
fabianism	f æ b i ə n ɪ z ə m
fabius	f eɪ b i ə s
face	f eɪ z
fact	f ɛ k t
factional	f ɛ k ʃ ə n ə l
factor	f æ k t ʌ
factory	f ɛ k t ɝ i
fair	f æ
fairies	f ɛ ɹ ɪ z
fairy	f æ ɹ i
fallen	f oʊ l ə n
falling	f ɔ l ɪ n
falls	f oʊ l z
falls	f ɔ l s
false	f oʊ l s
falsetto	f ɑ l s ɛ t oʊ
falsification	f ɑ l s ə f ə k eɪ ʃ ə n
falsified	f ɑ l s ə f aɪ d
fanning	f æ n ɪ n
fantasy	f æ n ə z i
farmers'	f ɑ ɹ m ɝ z
farming	f ɑ ɹ m ɪ n
farnan	f ɑ ɹ n ə n
faroe	f ɛ ɹ oʊ
farquhar	f ɑ ɹ k w ɑ ɹ
farrah	f æ ɹ ə
farron	f æ ɹ ə n
fashion	f ɛ ʃ ə n
fast	f ɔ s t
fatality	f ə t æ l ə t i
faulkner	f oʊ k n ɝ
fault	f oʊ l t
faulted	f oʊ l t ɪ d
faulty	f oʊ l t i
faulty	f ɔ l t ɪ
favorite	f eɪ v ɝ ə t
feature	f ɪ tʃ ɝ
federally	f ɛ d ɹ ə l i
fell	v ɛ l
feltre	f ɛ l t ɹ
feminized	f æ m ə n aɪ z d
femoral	f ɛ m ɹ ə l
fen	f æ n
fender	f æ n d ɝ
feng	f æ ŋ
fernald	f ɝ n ə l d
fernandina	f ɝ n ɑ n d i n ə
ferrie	f ɛ ɹ i
fest	f æ s t
festive	f ɛ s t i v
fete	f eɪ t
fetish	f æ t ɪ ʃ
fewer	f j u ɹ
field	f ɪ l d
fife	f aɪ v
figure	f ɪ ɡ ɝ
figurine	f ɪ ɡ j ɝ ɪ n
fijians	f ɪ dʒ i ə n z
files	v aɪ l z
filling	f i l ɪ ŋ
financial	f ɪ n æ n s ə l
financier	f ɪ n æ n s i ɝ
fingering	f ɪ ŋ ɡ ɝ i n
fingerings	f ɪ ŋ ɡ ɹ ɪ ŋ z
finsbury	f ɪ n z b ɛ ɹ i
fire	f aɪ ɹ
fireball	f aɪ ɝ b ɔ l
firemen	f aɪ ɝ m ə n
fires	f aɪ ɝ s
firewall	f aɪ ɝ w ɔ l
firewood	f aɪ ɝ w ʊ d
fireworks	f aɪ ɝ w ɝ k s
firing	f aɪ ɝ ɪ ŋ
first	f ɔ ɹ s t
first	f ɝ ʃ t
fitted	f i t ɪ d
flags	f l æ ɡ s
flamenco	f l ɔ m ɛ ŋ k oʊ
flan	f l æ ŋ
flaps	f l ɛ p s
flashing	f l æ ʃ ɪ n
flavoring	f l eɪ v ɝ ɪ n
flawed	f l oʊ d
fleming	f l æ m ɪ ŋ
flesh	f l æ ʃ
flo's	f l ɔ s
flodden	f l ɔ d ə n
flodden	f l ʌ d ə n
flooding	f l ɔ d ɪ ŋ
florida	f l ɔ ɹ d ə
florida	f l ɔ ɹ i d ə
florida's	f l ɔ ɹ ɪ d ə z
flour	f l ɔ ɹ
flowering	f l aʊ ɝ i n
fluorescent	f l ɔ ɹ ɛ s ə n t
foghorn	f ɑ ɡ h ɔ ɹ n
fogs	f ɑ ɡ z
folding	f oʊ l d ɪ n
follow	f ɔ l oʊ
followed	f ɔ l oʊ d
following	f ɑ l oʊ ɪ n
fonda	f ʌ n d ə
fondren	f ɑ n d ɹ ə n
fontana	f ɑ n t æ n ə
food	f ʊ d
foot	f u t
footage	f u t ɪ dʒ
football	f ʊ t b ə l
footballer	f u t b ɔ l ɝ
foote's	f u t s
for	f ɑ
for	f ɔ
for	f ɚ ɹ
for	f ɹ
for	f ʌ
for	v ɔ
for	v ə
forage	f ɔ ɹ ɪ dʒ
foran	f ɔ ɹ ə n
forbade	f ɔ ɹ b æ d
forbidden	f ɔ b ɪ d ə n
force	f oʊ s
forcing	f ɔ ɹ s i n
forcing	f ɔ ɹ s ɪ n
forecasts	f ɔ ɹ k æ s
foregone	f ɔ ɹ ɡ oʊ n
foreigner	f ɔ ɹ ə n ɝ
foreigners	f ɔ ɹ ə n ɝ z
foremost	f ɑ ɹ m oʊ s t
forensic	f ɝ ɛ n z ɪ k
forensic	f ɹ ɛ n z ɪ k
forensics	f ɝ ɛ n z ɪ k s
forewing	f ɔ ɹ w ɪ ŋ
forewings	f ɔ ɹ w ɪ ŋ z
forgave	f ɔ ɹ ɡ eɪ v
forgiving	f ɔ ɹ ɡ ɪ v ɪ ŋ
form	f oʊ m
form	f ɑ ɹ m
form	f ʌ m
former	f ɑ m ə
former	f ɑ ɹ m ɝ
forming	f oʊ m ɪ ŋ
forms	f oʊ m z
forms	f ɑ m z
forrest	f ɔ ɹ ə s t
forrester	f ɔ ɹ ə s t ɝ
fortas	f ɔ ɹ t ɑ s
forte	f ɔ ɹ t
forward	f ɔ d
fossil	f ɔ s ə l
foster	f ɔ s t ɝ
fostered	f ɔ s t ɝ d
foundry	f aʊ n d ɝ i
fountain	f aʊ n t ə ŋ
foxy	f ɔ k s i
fragrance	f ɹ æ ɡ ɹ ə n s
framing	f ɹ eɪ m ɪ n
france	f ɹ æ n z
france	f ɹ ə n s
france	f ɹ ɛ n s
frances	f ɹ æ n s ɪ s
francis	f ɹ æ n s ɪ z
franklinville	f ɹ æ ŋ k l ɪ n v ɪ l
franz	f ɹ æ n s
frederik	f ɹ ɛ d ɹ ɪ k
frederiksen	f ɹ ɛ d ɹ ɪ k s ə n
freeborn	f ɹ i b ɔ ɹ n
freefall	f ɹ i f ɔ l
freelance	f ɹ i l ɑ n z
freelance	f ɹ i l ə n s
freelove	f ɹ i l ɔ v
freer	f ɹ i ɹ
freestanding	f ɹ i s t æ n d ɪ ŋ
freeware	f ɹ i w ɛ ɹ
fremantle	f ɹ i m æ n t ə l
fremont	f ɹ i m ə n t
french	f ɹ ɛ n s
frenulum	f ɹ ɛ n j ə l ə m
frequenting	f ɹ i k w ə n t ɪ ŋ
frequents	f ɹ i k w ɛ n t s
fresno	f ɹ ɛ s n oʊ
fretty	f ɹ æ t i
freyre	f ɹ eɪ ɹ
friel	f ɹ i l
friendlier	f ɹ ɛ n d l i ɝ
friesland	f ɹ i s l ə n d
friess	f ɹ i z
fris	f ɹ i z
frisby's	f ɹ ɪ z b i z
frisco	f ɹ ɪ s k oʊ
frisia	f ɹ ɪ z i ə
frisians	f ɹ ɪ z i ə n z
frog	f ɹ oʊ ɡ
frogs	f ɹ ɑ ɡ s
frogs	f ɹ ɔ ɡ z
from	f ɹ ɔ m
frons	f ɹ ʌ n z
fronte	f ɹ ɑ n t
frustration	f ɹ ʌ s t ɹ eɪ ʃ ə n
fully	f u l i
fundamentalist	f ʌ n d ə m ɛ n ə l ɪ s t
fundamentalists	f ʌ n d ə m ɛ n ə l ɪ s
gaelic	ɡ æ l ɪ k
gaffe	ɡ ɛ f
galen	ɡ æ l ə n
galt	ɡ oʊ l t
galvanometer	ɡ æ l v ə n ɑ m ə t ɝ
galway	ɡ ɔ l w eɪ
games	ɡ eɪ m s
games	ɡ æ m z
garcia	ɡ ə s i ə
garrison	ɡ ɛ ɹ ɪ s ə n
garry	ɡ æ ɹ i
gary	ɡ æ ɹ i
gastropod	ɡ æ s t ɹ ə p ə d
gatacre	ɡ æ t ə k ɹ
gateshead	ɡ eɪ t s h ɛ d
gaul	ɡ oʊ l
gaulish	ɡ oʊ l ɪ ʃ
gaunt	ɡ ɑ n t
gauss	ɡ aʊ z
gaz	ɡ æ s
gees	dʒ i z
geld	ɡ æ l d
gelled	dʒ eɪ l d
gender	dʒ æ n d ɝ
general's	dʒ ɛ n ɝ ə l z
generalization	dʒ ɛ n ɝ ə l ɪ z eɪ ʃ ə n
generalizations	dʒ ɛ n ɝ ə l ɪ z eɪ ʃ ə n z
generally	dʒ ɛ n ɝ l i
gens	ɡ ɛ n z
gentleman's	dʒ ɛ n ə l m ə n z
geodesic	dʒ i ə d i z ɪ k
geometry	dʒ i ə m ə t ɹ i
gesellschaft	ɡ eɪ z ə l ʃ æ f t
getaway	ɡ æ t ə w eɪ
gibbs	ɡ ɪ b s
gig	ɡ i ɡ
ginsberg	ɡ ɪ n z b ɝ ɡ
ginseng	dʒ ɪ n s æ ŋ
give	ɡ i v
glabrous	ɡ l eɪ b ɝ ə s
glaciation	ɡ l eɪ s i eɪ ʃ ə n
glacier	ɡ l eɪ s ɝ
glaciers	ɡ l eɪ s ɝ z
glacis	ɡ l æ s ɪ
gleeson	ɡ l i s ə n
glenartney	ɡ l ɛ n ɑ ɹ t n i
gleyre	ɡ l eɪ ɹ
glittering	ɡ l ɪ t ɝ i n
glossary	ɡ l ɑ s ɝ i
glosses	ɡ l ɑ s ɪ z
gloucester	ɡ l ɑ s t ɝ
gloucester	ɡ l ʌ s t ɝ
glucose	ɡ l u k oʊ z
goes	ɡ oʊ s
going	ɡ oʊ ɪ n
golf	ɡ oʊ l f
golf	ɡ ʌ l f
golfer	ɡ ʌ l f ɝ
golfing	ɡ ʌ l f ɪ ŋ
goll	ɡ ɔ l
gondi	ɡ ʌ n d i
gone	ɡ oʊ n
gone	ɡ ɑ n
gong	ɡ oʊ ŋ
gonna	ɡ oʊ n ə
gonzales	ɡ ɑ n z ɑ l ə z
goody	ɡ u d i
gooseberry	ɡ u z b ɛ ɹ i
gordon	ɡ ɑ ɹ d ə n
gosford	ɡ ɔ s f ɔ ɹ d
gost	ɡ ɑ s t
got	ɡ ɔ t
got	ɡ ʌ t
government	ɡ ʌ v ɝ n m ə n t
governments	ɡ ʌ v ɝ n m ə n t s
governors	ɡ ʌ v ɝ n ɝ s
graham	ɡ ɹ eɪ m
graham	ɡ ɹ eɪ ə m
graham	ɡ ɹ æ ə m
grainger	ɡ ɹ eɪ n dʒ ɝ
grammar	ɡ ɹ æ m ɔ ɹ
grandma	ɡ ɹ æ m ə
grandma's	ɡ ɹ æ m ə z
grandson	ɡ ɹ æ n s ə n
grandsons	ɡ ɹ æ n s ə n z
graph	ɡ ɹ ɔ f
grass	ɡ ɹ ɔ s
grasses	ɡ ɹ æ s i z
green	ɡ ɹ ɪ n
greenbaum	ɡ ɹ ɪ n b aʊ m
greenhouse	ɡ ɹ ɪ n h aʊ z
greensburg	ɡ ɹ ɪ n s b ɝ ɡ
greer	ɡ ɹ i ɝ
greg	ɡ ɹ eɪ ɡ
greg	ɡ ɹ æ ɡ
gregory	ɡ ɹ ɛ ɡ ɔ ɹ i
gregory's	ɡ ɹ ɛ ɡ ɔ ɹ i z
grieving	ɡ ɹ i v ɪ n
grimaldis	ɡ ɹ ɪ m ɑ l d i z
griselda	ɡ ɹ ɪ z ɛ l d ə
groveland	ɡ ɹ oʊ v l ə n d
grudge	ɡ ɹ ɑ dʒ
guan	ɡ w ə n
guaymas	ɡ w aɪ m ə s
guest	ɡ æ s t
guildhall	ɡ ɪ l d h oʊ l
guildhall	ɡ ɪ l d h ə l
guinness	ɡ ɪ n ɪ ʃ
guion	ɡ w i ə n
gulf	ɡ ɑ l f
gulistan	ɡ u l ɪ s t ə n
gullah	ɡ ɑ l ə
gun	ɡ ə n
gunfire	ɡ ʌ n f aɪ ɝ
gunton	ɡ ɑ n t ə n
gustaf	ɡ u s t ə f
gustav	ɡ u s t ɑ v
gustavus	ɡ ɑ s t ɑ v ə s
gutted	ɡ ɑ t ɪ d
hacking	h æ k i n
had	h eɪ d
had	h ɛ d
hagar	h æ ɡ ɑ ɹ
hagen's	h æ ɡ ə n z
haha	h ə h ə
hailes	h ɛ l z
hair	h æ
half	h ɔ f
halifax	h æ l i f æ k s
hall	h oʊ l
hall's	h ə l z
halle	h eɪ l
hallmark	h oʊ l m ɑ k
halls	h oʊ l z
halls	h ə l z
halsey	h oʊ l z i
halt	h oʊ l t
halting	h oʊ l t ɪ ŋ
halts	h oʊ l t s
halve	h eɪ v
halves	h æ f s
hamersley	h æ m ɝ z l i
hamish	h eɪ m ɪ ʃ
hanan	h æ n ə n
hancock	h æ n k ɔ k
hancock	h æ ŋ k ɑ k
handcrafted	h æ n d k ɹ æ f t ɪ d
handcrafts	h æ n d k ɹ æ f t s
handling	h æ n d ə l ɪ n
hanged	h æ n d
hank's	h æ ŋ k s
hansard	h æ n s ɑ ɹ d
haram	h ɑ ɹ ə m
harbour	h ɑ b ɔ
harmonic	h ɑ ɹ m ə n ɪ k
harnden	h ɑ ɹ n d ə n
harrah	h æ ɹ ə
harrell	h æ ɹ ə l
harrisburg	h æ ɹ ɪ s b ɝ ɡ
harrison's	h æ ɹ ɪ s ə n z
harrop	h æ ɹ ə p
harrow	h ɛ ɹ oʊ
hartford	h ɑ t f ɔ d
harvested	h ɑ ɹ v ə s t ɪ d
has	h eɪ z
has	h æ s
has	h ə s
hasan	h æ s ə n
hase	h eɪ s
haskalah	h æ ʃ k ə l ə
hassan's	h æ s ə n z
hasty	h æ s t i
hath	h eɪ θ
hauled	h oʊ l d
haute	h ɔ t
have	h ɛ v
havelock	h æ v l ə k
haven	h æ v ə n
haven't	h eɪ v ə n t
haverhill	h eɪ v ɝ h ɪ l
havering	h eɪ v ɝ ɪ ŋ
having	h eɪ v ɪ ŋ
having	h æ v ɪ n
haw	h ə
hawke	h oʊ k
haworth	h eɪ w ɝ θ
hayes	h eɪ s
hays	h eɪ s
he	ɪ
he's	h ɪ s
he's	h ɪ z
head	h æ d
headed	h æ d ɪ d
headers	h æ d ə z
heading	h ɛ d ɪ n
headquartered	h ɛ d k w ɔ ɹ t ɝ d
heads	h æ d s
heal	h ɪ l
healing	h i l ɪ n
healthcare	h ɛ l θ k ɛ ɹ
hear	h ɪ ɹ
heartland	h ɑ ɹ t l æ n d
heather	h ɛ θ ə
heats	h ɪ t s
heavy	h æ v i
hebron	h ɛ b ɹ ɑ n
hedgehogs	h ɛ dʒ h ɔ ɡ z
hedges	h eɪ dʒ ɪ z
hefty	h æ f t i
hegel	h eɪ ɡ ə l
heights	h aɪ t z
hel	h eɪ l
hela	h eɪ l ə
hele	h ɪ l
helena	h ɛ l i n ə
helicopters	h æ l ɪ k ɑ p t ɝ z
helios	h i l i ə s
heliport	h ɛ l i p ɔ ɹ t
hell	h eɪ l
hello	h æ l oʊ
helsinki	h æ l s ɪ ŋ k i
hempstead	h æ m p s t ɛ d
henderson	h æ n d ɝ s ə n
henderson's	h æ n d ɝ s ə n z
hendricks	h æ n d ɹ ɪ k s
hendrix	h æ n d ɹ ɪ k s
heney	h eɪ n i
henk	h æ ŋ k
henkin	h ɛ n k ɪ n
henri	ɑ n ɹ i
henrik	h æ n ɹ ɪ k
hens	h æ n z
henson	h æ n s ə n
her	h ɑ ɹ
her	ɔ ɹ
herbarium	ɝ b ɛ ɹ i ə m
here	h i
hereford	h æ ɹ ə f ɝ d
hermetically	h ɝ m æ t ɪ k l i
hermitage	h ɝ m ə t ɑ dʒ
hero	h ɪ ɹ oʊ
hero's	h i ɹ oʊ z
herriot	h ɛ ɹ i ə t
hers	ɝ z
herself	ɝ s ɛ l f
heterodox	h ɛ t ɹ ə d ɑ k s
hexham	h æ k s ə m
hiatus	h aɪ eɪ t ə z
hierarchy	h aɪ ɝ ɑ ɹ k i
hiking	h aɪ k ɪ n
hinsdale	h ɪ n z d eɪ l
hippocrates	h ɪ p ə k ɹ ə t i z
hire	h aɪ ɝ
his	h i s
his	h i z
hiscock	h ɪ s k ɑ k
historic	h ɪ s t ɑ ɹ ɪ k
historically	h ɪ s t ɔ ɹ ɪ k ə l i
history	h ɪ s t ɔ ɹ i
hit	h i t
hock	h ɔ k
hockey	h ɑ k ɪ
hockey	h ɔ k i
hockey	h ə k i
hodgson	h ʌ dʒ s ə n
hoffman	h oʊ f m ə n
hoffman	h ɑ f m ə n
hofmann	h ɔ f m ə n
hofmann's	h ɔ f m ə n z
hofstra	h ɔ f s t ɹ ə
hogg	h oʊ ɡ
hogg	h ʌ ɡ
hogs	h ɔ ɡ z
hoh	h ɔ
hollis	h ɔ l ɪ s
holocaust	h oʊ l ə k ɔ s t
holsworthy	h oʊ l z w ɝ ð i
holt	h ɔ l t
homogeneous	h ɑ m ə dʒ ə n ə s
homogeneous	h ə m ə dʒ ə n ə s
homologous	h ɑ m ə l ə ɡ ə s
hon	h ɔ n
honduras	h ə n d ʊ ɹ ə s
honest	ɔ n ə s t
hong	h ɑ ŋ
honk	h ʌ ŋ k
honking	h ɑ ŋ k ɪ ŋ
honor	ɔ n ɝ
honors	ɑ n ɝ s
honors	ə n ɝ z
hood	h u d
hooded	h u d ɪ d
hook	h u k
horace	h ɑ ɹ ə s
horace	h ɔ ɹ ɪ s
horde	h oʊ d
horizontally	h ɔ ɹ ɪ z ɑ n t ə l i
horizontally	h ɔ ɹ ɪ z ɑ n ə l i
horovitz	h ɔ ɹ ə f ɪ t s
horror	h ɑ ɝ
horror	h ɔ ɹ
horrors	h ɑ ɹ ɝ z
horse	h oʊ s
horse	h ɔ ɹ z
horsemen	h ɔ ɹ s m ə n
horticulture	h ɔ ɹ t i k ʌ l tʃ ɝ
host	h ɔ s t
hot	h ɔ t
hotham	h ɔ θ ə m
hounslow	h aʊ n z l oʊ
hour	aʊ ɝ
hour's	aʊ ɹ z
hours	aʊ ɝ s
hours	aʊ ɝ z
house	h aʊ z
houses	h aʊ z ɪ z
housing	h aʊ s ɪ ŋ
hovercraft	h ɑ v ə k ɹ æ f t
hovering	h ɑ v ɝ ɪ ŋ
however	h aʊ æ v ɝ
howse	h aʊ s
hoxton	h ɔ k s t ə n
hub	h ɑ b
hubble	h ɑ b ə l
hudson	h ɑ d s ə n
huffington	h ʌ v ɪ ŋ t ə n
hull	h ɔ l
hull	h ə l
humanitarian	h j u m æ n ɪ t ɛ ɹ i ə n
humanitarian	j u m æ n ə t ɛ ɹ i ə n
humor	j u m ɝ
humour	j u m ɝ
humphries	h ʌ m f ɹ i z
hunan	h u n ə n
hungary	h ʌ ŋ ɡ ɔ ɹ i
hungary	h ʌ ŋ ɡ ɹ i
hunkins	h ɑ ŋ k ɪ n z
hunt	h ɑ n t
hunt	h ɔ n t
hunter	h ɑ n t ɝ
hurtful	h ɑ ɹ t f ə l
huss	h ɑ s
hussain	h u s eɪ n
hussar	h ə z ɑ ɹ
huston	h ɑ s t ə n
hydraulic	h aɪ d ɹ ɑ l ɪ k
hydraulic	h aɪ d ɹ ə l ɪ k
hydrochloric	h aɪ d ɹ ə k l ɔ ɹ ɪ k
hydroxide	h aɪ d ɹ ə k s aɪ d
hypocrisy	h ɪ p ə k ɹ ə s i
i	i
iain	i ɛ n
icon	aɪ k ə n
iconoclastic	aɪ k ɑ n ə k l æ s t ɪ k
icons	aɪ k ɑ n z
idiosyncratic	ɪ d i oʊ s ɪ ŋ k ɹ æ t ɪ k
idolatrous	aɪ d ə l ə t ɹ ə s
ignoring	ɪ ɡ n ɔ ɹ ɪ ŋ
ill	i l
imagery	ɪ m ɪ dʒ ɝ i
imam	ɪ m ə m
imari	ɪ m ɑ ɹ i
immersion	ɪ m ɝ ʃ ə n
impeccable	ɪ m p æ k ə b ə l
imperial's	ɪ m p ɪ ɹ i ə l z
impostors	ɪ m p ɑ s t ɝ z
impoverished	ɪ m p ɑ v ɝ ɪ ʃ t
impresario	ɪ m p ɹ ɪ z ɑ ɹ i oʊ
imprisoned	ɪ m p ɹ ɪ ʒ ə n d
improv	ɪ m p ɹ ɔ f
improvisation	ɪ m p ɹ ə v ɪ z eɪ ʃ ə n
in	i n
in	ɑ n
in	ɔ n
in	ɪ ŋ
in	ʌ n
inaugural	ɪ n ɔ ɡ ɝ ə l
incisors	ɪ n s aɪ s ɝ z
inclusion	ɪ n k l u ʃ ə n
incognito	ɪ n k ɑ ɡ n i t oʊ
incomprehensible	ɪ n k ɑ m p ɹ i h ɛ n s ə b ə l
increased	ɪ ŋ k ɹ i s t
incubus	ɪ ŋ k j ə b ə s
incumbent	ɪ n k ə m b ə n t
indices	ɪ n d ə s i z
indira	ɪ n d ɪ ɹ ə
indore	ɪ n d ɔ ɹ
inductee	ɪ n d ə k t i
inductees	ɪ n d ə k t i z
industrial	ɪ n d ə s t ɹ i ə l
industries	ɪ n d ə s t ɹ i s
infante	ɪ n f ə n t i
influences	ɪ n f l u ə n s i z
influences	ɪ n f l u ə n s ɪ s
influenza	ɪ n f l u ɛ n s ʌ
information	ɪ n f ɔ ɹ m eɪ ʃ ə n
ingalls	ɪ ŋ ɡ ə l z
inglesby	ɪ ŋ ɡ ə l z b i
ingot	ɪ ŋ ɡ ɑ t
injun	ɪ n dʒ ə n
injuring	ɪ n dʒ ɝ ɪ n
innings	ɪ n ɪ n z
innovative	ɪ n ɑ v ə t ɪ v
innovative	ɪ n ɔ v ə t ɪ v
inquiry	ɪ n k w aɪ ɝ i
insectivorous	ɪ n s ɛ k t ɪ f ɔ ɹ ə s
installed	ɪ n s t oʊ l d
installed	ɪ n s t ɑ l d
instantaneous	ɪ n s t ə n t eɪ n i ə s
instantaneously	ɪ n s t ə n t eɪ n i ə s l i
instrumentals	ɪ n s t ɹ ə m ɛ n ə l z
intel	ɪ n t eɪ l
intel's	ɪ n t eɪ l z
interaction	ɪ n t ɝ ɛ k ʃ ə n
interconnect	ɪ n t ɝ k ə n æ k t
intercostal	ɪ n t ɝ k ɑ s t ə l
intercourse	ɪ n ɝ k ɔ ɹ s
interfere	ɪ n t ɝ f ɪ ɹ
interim	ɪ n t ɹ ə m
international	ɪ n t ɝ n æ ʃ ə n ə l
internationally	ɪ n ɝ n æ ʃ ə n ə l i
interrogative	ɪ n t ɛ ɹ ə ɡ ə t ɪ v
interrupt	ɪ n t ɚ ʌ p t
interrupts	ɪ n t ɝ ə p t s
intersex	ɪ n t ɝ s ɛ k s
intervention	ɪ n t ɝ v eɪ n ʃ ə n
invariant	ɪ n v ɛ ɹ i ə n t
invasive	ɪ n v eɪ z ɪ v
inventory	ɪ n v ɛ n t ɔ ɹ i
invertebrates	ɪ n v ɝ t ə b ɹ ə t s
investment	ɪ n v eɪ s m ə n t
ions	aɪ ɑ n z
iowa	aɪ ə w ɑ
ipswich	ɪ p ʃ w ɪ tʃ
iran	ɪ ɹ ə n
iranian	ɪ ɹ ə n i ə n
iraq	i ɹ æ k
iraq	ɪ ɹ ə k
irascible	ɪ ɹ ɛ s ə b ə l
ireland	ɑ ɹ l ə n d
iris	aɪ ɹ ə ʃ
ironically	aɪ ɹ ə n ɪ k l i
irradiations	i ɹ eɪ d i eɪ ʃ ə n z
is	i z
is	ɪ s
is	ɪ ʃ
is'	ɪ z
isabella	ɪ s ə b ɛ l ə
islamic	ɪ s l æ m ɪ k
islamic	ɪ z l ɛ m ɪ k
ismail	ɪ s m ɛ l
isolde	ɪ z oʊ l d
israel	ɪ s ɹ i ə l
israeli	ɪ s ɹ eɪ l i
issue	ɪ s u
issues	ɪ s u z
issuing	ɪ ʃ u ɪ n
it	i t
it	ɔ t
it	ʌ t
it's	i t s
it's	ɪ t z
ivory	aɪ v ɹ i
jack	dʒ ɛ k
jackson	dʒ ɛ k s ə n
jacques	ʃ ɑ k
jadwiga	dʒ ɛ d w i ɡ ə
jain	dʒ æ n
jakob	dʒ eɪ k ə b
jamal	dʒ ə m ə l
james	dʒ ɛ m z
japanese	dʒ æ p ə n i s
jarrett	dʒ ɛ ɹ ɪ t
jarrold	dʒ ɛ ɹ ə l d
jason	dʒ eɪ z ə n
jaws	dʒ oʊ z
jazz	dʒ æ s
jazz	dʒ ɛ s
jazzy	dʒ ɛ s i
jeffery	dʒ ɛ f ɹ i
jellicoe	dʒ æ l ə k oʊ
jenkin	dʒ ɛ n k ɪ n
jenkins	dʒ ɛ n k ɪ n z
jenkins	dʒ ɛ n k ɪ ŋ z
jennifer	dʒ ɛ n ɪ f ɝ
jersey	dʒ ɝ s i
jess's	dʒ ɛ s i z
jesu	dʒ eɪ z u
jesuits	dʒ ɛ z u ɪ t s
jewelry	dʒ u l ɹ i
jewry	dʒ u ɝ i
jogger	dʒ ɑ ɡ ɝ
jogging	dʒ ʌ ɡ ɪ ŋ
john	dʒ ɑ ŋ
john	dʒ ʌ n
jolly	dʒ ɔ l i
jos	dʒ ɔ s
joseph's	dʒ oʊ s ə f s
josiah	dʒ oʊ z aɪ ə
josie	dʒ oʊ s i
joss	dʒ ʌ s
juan	w ʌ n
judgement	dʒ ʌ dʒ m ə n t
juggling	dʒ ʌ ɡ l ɪ n
juicer	dʒ u s ɝ
juniper	dʒ u n ɪ p ɝ
kabul	k ə b ə l
kahan	k ɑ h ə n
kahn	k ʌ n
kahr	k ɑ ɹ
kallas	k æ l ə s
kalmbach	k æ l m b ə k
kamran	k æ m ɝ ə n
kannada	k æ n ɑ d ə
kansas	k æ n s ə s
kansas	k æ n s ə z
kappa	k eɪ p ə
karel	k æ ɹ ə l
karol	k ɛ ɹ ə l
karpov	k ɑ ɹ p ə v
karras	k ɛ ɹ ə s
karsh	k ɑ ɹ s
kasher	k æ ʃ ɝ
kashmir	k æ ʃ m ɪ ɹ
kashmiri	k æ ʃ m ɪ ɹ i
kasparov	k æ s p ɝ ɔ v
kasteel	k æ s t i l
kathy	k eɪ t i
kauffmann	k oʊ f m ə n
kazan	k æ z ə n
kellogg	k æ l ə ɡ
kelly	k æ l i
kelly's	k ɛ l ɪ z
kelvin	k æ l v ə n
kelvin	k æ l v ɪ n
kemel	k æ m ə l
ken	k æ n
kenilworth	k æ n ə l w ɝ θ
kennebec	k æ n ə b ɛ k
kennedy	k ɛ n ɑ d i
kennesaw	k ɛ n ə ʃ ə
kenney	k æ n i
kenny	k æ n i
kent	k æ n t
kenya	k eɪ n j ə
kenya	k æ n j ə
kerama	k ɛ ɹ ə m ə
keratin	k ɛ ɹ ə t ɪ n
kettle	k æ t ə l
kevin	k æ v ə n
kevlar	k ɛ v l ə
key	k ɪ
keynes	k ɪ n z
khan	k ə n
khosla	k oʊ z l ə
kilometer	k ɪ l ə m ɪ t ə
kilometre	k ɪ l ɑ m ə t ɝ
kilometres	k ɪ l ɑ m ə t ɝ z
kin	k ɪ ŋ
king	k ɪ n
king's	k ɪ n z
kingdom	k ɪ n d ə m
kingfishers	k ɪ n f ɪ ʃ ɝ z
kings	k ɪ n z
kings	k ɪ ŋ s
kingstown	k ɪ ŋ s t aʊ n
kinsella	k ɪ n s ɛ l ə
kinshasa	k ɪ n ʃ ɛ s ə
kiosks	k i oʊ s k s
kiosks	k i ɑ s k s
kira	k ɪ ɹ ə
kismet	k ɪ z m æ t
kittrell	k ɪ t ɹ ə l
kivas	k i v ə s
klang	k l æ n
klebs	k l æ b z
klingon	k l ɪ ŋ ə n
kloshe	k l ʌ ʃ
knollwood	n ɔ l w ʊ d
knot	n ɔ t
knots	n ɔ t s
ko	k ɔ
kochi	k oʊ tʃ i
kohr	k ɔ ɹ
kong	k oʊ ŋ
kong	k ɑ ŋ
kong	k ə ŋ
kong's	k ə ŋ z
konkani	k ɑ ŋ k ə n i
kook	k ʊ k
korean	k ɔ ɹ i ə n
korean	k ɝ i ə n
koreans	k ɝ i ə n z
kostroma	k ɑ s t ɹ oʊ m ə
kravitz	k ɹ æ v ɪ t s
krishna	k ɹ ɪ s n ə
kristen	k ɹ ɪ s t ə n
kristina	k ɹ ɪ s t i n ə
kropotkin	k ɹ ə p ɑ t k ɪ n
krum	k ɹ ʌ m
krystal	k ɹ ɪ s t ə l
kubrick	k j u b ɹ ɪ k
kush	k u ʃ
kushan	k u ʃ ə n
l	æ l
labeled	l ɛ b ə l d
labonte	l ə b ə n t
labourers	l eɪ b ɹ ɝ z
labs'	l æ b s
lacked	l ɛ k t
lacking	l æ k ɪ n
ladi	l æ d i
ladle	l ɛ d ə l
ladoga	l ə d oʊ ɡ ə
ladysmith	l eɪ d i s m ɪ θ
lagos	l eɪ ɡ oʊ s
laid	l ɛ d
laird	l æ d
lake	l ɛ k
lamont	l ə m ə n t
lamonte	l ə m ə n t
lanchester	l æ ŋ tʃ ɛ s t ɝ
land	l ɛ n d
landed	l ɛ n d ɪ d
lander	l ɛ n d ɝ
landfall	l æ n d f oʊ l
lane	l æ n
lanes	l eɪ ŋ s
langeron	l æ ŋ ɡ ɝ ə n
langley	l æ ŋ l ɪ
lansbury	l æ n z b ɛ ɹ i
laplace	l ə p l æ s
lapland	l ɛ p l ə n d
laptop	l æ p t ʌ p
laredo	l ɔ ɹ ɛ d oʊ
large	l ɔ dʒ
las	l ɔ s
laser	l eɪ s ɝ
lashing	l æ s ɪ ŋ
last	l ɔ s t
latham	l eɪ θ ə m
latino	l ə t i n oʊ
latter	l ɛ t ɝ
lattice	l ɛ t ə s
lattices	l æ t ə s i z
latvia	l æ t f i ə
laud	l oʊ d
lauderdale	l ɑ d ɝ d eɪ l
laugh	l ʌ f
laura	l ɔ ɹ ʌ
laurens	l ɔ ɹ ə n s
laurie's	l ɔ ɹ i z
laval	l ɑ v ə l
laval	l ə v ə l
law	l oʊ
lawn	l oʊ n
laxalt	l æ k s ɔ l t
layers	l ɛ ɹ z
lazily	l eɪ z ə l i
leaders	l i d ə s
leading	l i d ɪ n
league's	l i ɡ s
leagues	l i ɡ s
leaked	l ɪ k t
lean	l ɪ n
lear	l i ə
lear	l i ɝ
learning	l ɝ n ɪ n
leary's	l ɪ ɹ ɪ z
leather	l æ θ ɝ
leaving	l ɪ v ɪ ŋ
lebanon's	l ɛ b ə n ɑ n z
left	l æ f t
legs	l eɪ ɡ z
lehman	l eɪ m ə n
leibniz	l i b n ɪ s
leipzig	l aɪ p z ɪ ɡ
lem	l æ m
lemnos	l ɛ m n ə s
lenders	l æ n d ɝ z
lending	l æ n d ɪ ŋ
length	l ɛ n θ
lengthy	l ɛ n θ i
lenz	l æ n z
leominster	l æ m s t ə
leonidas	l i ə n i d ə s
leonora	l i ə n ɑ ɹ ə
leos	l i oʊ s
leprechaun	l ɛ p ɹ ə k ə n
les	l eɪ z
lesbian	l æ z b i ə n
lesbian	l ɛ s b i ə n
lesbos	l æ z b ɔ s
leslie	l eɪ s l i
lessees	l æ s i z
leticia	l ə t i ʃ ə
letter	l æ t ɝ
letter	l ɛ t ə
letters	l æ t ɝ z
levant	l ə v ə n t
leveled	l eɪ v ə l d
leventhal	l ɛ v ə n θ ə l
lewis	l u ɪ z
lexus	l ɛ k s ə z
liaison	l i eɪ z ə n
licata	l ɪ k ɑ t ə
licensing	l aɪ s ə n s ɪ n
limerick	l ɪ m ɹ ɪ k
lindsay	l ɪ ŋ z i
lindsey	l ɪ n s i
line	l aɪ ŋ
linearly	l ɪ n i ɹ l i
linguistic	l ɪ n ɡ w ɪ s t ɪ k
linton	l ɪ ŋ t ə n
lisbon	l ɪ s b ə n
list	l i s t
listenership	l ɪ s n ɝ ʃ ɪ p
listening	l ɪ s n i n
listing	l ɪ s t ɪ n
lita	l ɪ t ə
litchfield	l i tʃ f i l d
literature	l ɪ t ɹ ə tʃ ɝ
live	l i v
liver	l ɪ f ɝ
liveries	l ɪ v ɝ i z
livres	l i v z
loan	l ɔ ŋ
loath	l oʊ ð
lobscouse	l ʌ b s k aʊ s
localise	l oʊ k ə l aɪ z
locked	l ʌ k t
locomotive	l oʊ k ə m oʊ t i v
log	l oʊ ɡ
logging	l ɑ ɡ ɪ ŋ
long's	l oʊ ŋ z
longer	l ɔ ŋ ɡ ɝ
longevity	l ɔ ŋ dʒ ɛ v ə t i
longevity	l ʌ ŋ dʒ ɛ v ə t i
longley	l ɔ ŋ ɡ l i
longus	l ɑ ŋ ɡ ə s
lonsdale	l ɔ n s d eɪ l
look	l u k
loong	l u ŋ
loose	l u z
looses	l u z ɪ z
lorenz	l ɔ ɹ ɛ n s
lorraine	l ɔ ɹ eɪ n
lorry	l ɑ ɹ i
los	l ɑ s
losch	l ʌ ʃ
loss	l ɔ z
louis	l u i s
louis	l u ɪ
love	l ʊ f
lovely	l ɔ f l i
lover	l ɑ f ə
lover	l ɑ v ə
lovering	l ɑ v ɝ ɪ ŋ
low	l ɔ
lubar	l u b ɑ ɹ
lucian	l u s i ə n
lucius	l u s i ə s
luis	l u i z
luis	l u ɪ s
lukas	l u k ə s
luke	l ʊ k
lust	l ɑ s t
lutherans	l u θ ɹ ə n z
luzon	l u z ə n
lynch's	l ɪ n tʃ i z
lyres	l aɪ ɝ z
m	eɪ m
mabel	m eɪ b ə l
mabie	m eɪ b i
macabre	m ə k ɑ b ɹ
macewen	m ə k j u ə n
macon	m æ k ə n
madan	m æ d ə n
made	m æ d
madero	m ɔ d ɛ ɹ oʊ
mafic	m eɪ f ɪ k
magas	m æ ɡ ə s
maghreb	m ɑ ɡ ɹ ə b
magog	m ə ɡ ɔ ɡ
maguire	m ə ɡ w aɪ ɝ
maguire's	m ə ɡ w aɪ ɝ z
mahal	m ə h ə l
maharaj	m ɑ h ɑ ɹ ə ʃ
maharaj	m ə h ɑ ɹ ə ʃ
mahjong	m ɑ dʒ ə ŋ
mahmud	m ə m u d
main	m ɛ n
mainstays	m ɛ n s t eɪ z
maize	m eɪ s
major	m ɛ dʒ ɝ
makara	m ə k ɑ ɹ ə
malagasy	m æ l ə ɡ æ s ɪ
malaise	m ə l eɪ z
malaysian	m ə l eɪ ʃ ə n
maldives	m ə l d i v z
male	m ɛ l
malik	m ɛ l ɪ k
mall	m oʊ l
mall	m ə l
malls	m oʊ l z
malt	m oʊ l t
malta	m oʊ l t ə
maltese	m oʊ l t i z
maltese	m ʌ l t i z
malting	m oʊ l t ɪ ŋ
malts	m oʊ l t s
manama	m ə n ə m ə
mandate	m ɛ n d eɪ t
mandolin	m ɛ n d ə l i n
mangrove	m æ ŋ ɡ ɹ oʊ v
mangroves	m æ ŋ ɡ ɹ oʊ v z
manic	m ɛ n ɪ k
manitoba	m æ n i t oʊ b ə
mankato	m æ ŋ k ɑ t oʊ
mannix	m ɛ n ɪ k s
manoeuvre	m ə n u v ɝ
manor	m ɛ n ə
manrique	m ə n ɹ ɪ k
mansfield	m æ n s f i l d
manuela	m æ n w ɛ l ə
many	m æ n i
many	m ɛ n ɪ
many	m ɪ n ɪ
maranatha	m ɛ ɹ ə n eɪ θ ə
marathon	m ɛ ɹ ə θ ə n
marauders	m ɝ oʊ d ɝ z
march	m ʌ tʃ
marching	m ɑ ɹ tʃ i n
margaret's	m ɑ ɹ ɡ ɝ ɪ t s
marie	m ɑ ɹ i
marijuana	m ɛ ɹ ə w ɑ n ə
maris	m ɑ ɹ ɪ s
marjory	m ɑ ɹ dʒ ɝ i
marketeer	m ɑ ɹ k ə t ɪ ɹ
markets	m ɑ ɹ k ə t s
markings	m ɑ ɹ k ɪ ŋ s
markov	m ɑ ɹ k oʊ v
markov	m ɑ ɹ k ɑ v
marlborough	m ɑ l b ɝ ə
marlborough	m ɑ ɹ l b ɝ ə
marlene	m ɑ ɹ l i n
marmara	m ɑ m ɑ ɹ ə
marotte	m ɝ ɑ t
marriages	m ɛ ɹ ɪ dʒ ɪ s
married	m eɪ ɹ i d
married	m ɛ ɹ ɪ d
marriott	m ɛ ɹ ɪ ə t
mars	m ɑ ʃ
marschall	m ɑ ɹ ʃ ə l
marsh	m ɑ ɹ s
marsh	m ɑ ɹ z
marshalls	m ɑ ɹ ʃ ə l z
marshes	m ɑ ɹ ʃ ɪ z
martel	m ɑ ɹ t ɛ l
martin's	m ɑ ɹ t ə n z
martinez	m ɑ ɹ t ɪ n ɛ z
martyrdom	m ɑ ɹ t ə ɝ d ə m
mary	m eɪ ɹ i
maryland	m ɛ ɹ i l ə n d
maryville	m ɛ ɹ i v ɪ l
masada	m ə s ɑ d ə
maslin	m æ s l ɪ n
masonic	m ə s ə n ɪ k
masri	m ɑ z ɝ i
mass	m ɑ z
mass	m ɛ s
mass	m ʌ s
masses	m æ s i z
massif	m æ s ɪ v
matapan	m ɑ t ə p ə n
mateo	m ə t eɪ oʊ
matins	m æ t ə n s
matter	m ɛ t ɝ
maureen	m ɔ ɹ ɪ n
maurice	m ɔ ɹ ɪ s
mauro	m ɑ ɹ oʊ
mauser	m aʊ z ɝ
mausoleum	m ɑ z ə l i ə m
mauve	m oʊ v
mauve	m ʌ f
maverick	m ɛ v ɝ ɪ k
maxime	m æ k z i m
may	m æ
mayer	m eɪ ɹ
mayfield	m eɪ f ɪ l d
maynard	m eɪ n ɑ ɹ d
mayor	m eɪ ə
mayor	m eɪ ɹ
mayor	m ɛ ɹ
mayoral	m eɪ ɔ ɹ ə l
mayoral	m ɛ ɹ ə l
mays	m eɪ s
mazama	m ə z ɑ m ə
maze	m eɪ s
mcardle	m ə k ɑ ɹ d ə l
mcarthur	m ə k ɑ ɹ θ ɝ
mcateer	m æ k ə t ɪ ɹ
mccall	m ə k ə l
mccarthy's	m ə k ɑ ɹ θ i z
mccartney	m ə k ɑ ɹ t n i
mccarty	m ə k ɑ ɹ t i
mccaul	m ə k oʊ l
mccauley	m ə k oʊ l i
mccollum	m ə k ɑ l ə m
mccormick	m ə k ɔ ɹ m ɪ k
mccreary	m ə k ɹ ɪ ɹ i
mcculley	m ə k ɑ l i
mcculloch	m ə k ɔ l ə k
mccully	m ə k ɑ l i
mcdonagh	m ə k d ɔ n ə
mcfarlan	m ə k f ɑ ɹ l ə n
mckenzie	m ə k ɛ n s i
mclaren	m ə k l æ ɹ ə n
mcmahon	m ə k m eɪ n
mcnair	m ə k n ɛ ɹ
mcnairy	m ə k n ɛ ɹ i
mcparland	m ə k p ɑ ɹ l ə n d
mcpartlin	m ə k p ɑ ɹ t l ə n
me	m ɪ
meanwhile	m ɪ n w aɪ l
measure	m ɛ ʃ ə
measures	m ɛ ʃ ɝ z
medal	m æ d ə l
medalists	m æ d ə l ɪ s t s
media	m eɪ d i ə
medical	m æ d ɪ k ə l
medicines	m ɛ d ə s ə n s
medieval	m ɪ d i v ə l
meeting	m i t ɪ n
meg	m æ ɡ
megan	m eɪ ɡ ə n
mehaffey	m ə h eɪ f i
meiji	m eɪ i dʒ i
mek	m æ k
mekong	m i k ɑ ŋ
mekong	m i k ə ŋ
mel	m eɪ l
melbourne	m eɪ l b ɔ n
melbourne	m ɛ l b oʊ n
melbourne's	m ɛ l b ə n z
melissa	m ə l i s ə
mellstock	m eɪ l s t ɑ k
melva	m æ l v ə
member	m æ m b ɝ
members	m æ m b ʌ z
memel	m æ m ə l
memorabilia	m ɛ m ɹ ə b i l j ə
men	m æ n
men's	m æ n z
mendoza	m æ n d oʊ z ə
meng	m eɪ ŋ
meng	m ɛ n
menke	m æ ŋ k
mennonite	m æ n ə n aɪ t
menorah	m ə n ɔ ɹ ə
mentions	m æ n ʃ ə n z
mentor	m eɪ n t ɝ
mentor	m æ n t oʊ
mentor	m æ n t ə
mentor	m æ n t ɝ
mentor	m ɛ n t oʊ
mentor	m ɛ n t ə
menu	m æ n j u
menzies	m æ n s i z
mephisto	m ɛ f ɪ s t oʊ
merchandise	m ɝ tʃ ə n d aɪ s
merciless	m ɝ s i l ə s
merrimack	m ɛ ɹ i m æ k
mersea	m ɝ z i
merseburg	m ɝ ʃ b ɝ ɡ
mersey	m ɑ z i
mersey	m ɝ z i
meryl	m ɛ ɹ ə l
merz	m ɝ s
mesa	m eɪ z ə
mesa	m ɛ s ə
mesh	m æ ʃ
meshed	m æ ʃ t
mesmer's	m ɛ s m ɝ z
mesmerism	m ɛ z m ɝ ɪ z ə m
mess	m æ s
mestre	m ɛ s t ɹ
met	m æ t
metal	m æ t ə l
metals	m æ t ə l z
meteor	m i t i oʊ
methods	m ɛ θ ə d s
metra	m ɛ t ɹ ə
metrics	m eɪ t ɹ ɪ k s
metro	m æ t ɹ oʊ
mets	m æ t s
mezzanine	m ɛ s ə n i n
miasma	m i æ s m ə
mick	m i k
microscopist	m aɪ k ɹ ə s k ə p ɪ s t
middens	m i d ə n z
midocean	m ɪ d oʊ ʃ ə n
mignon	m ɪ n j ə n
mikan	m ɪ k ə n
miki	m i k i
mila	m i l ə
milan	m ə l ə n
milan	m ɪ l ə n
mildred	m ɪ l d ɹ ɪ d
milewski	m ɪ l ɛ v s k i
militaristic	m ɪ l ə t ɹ ɪ s t ɪ k
millennium	m ə l æ n i ə m
millennium	m ɪ l ɛ n i ə m
milwaukee	m ɪ l w ɑ k i
mimi	m ɪ m i
minister	m ɪ n ə s t ɹ
ministerial	m ɪ n ɪ s t ɪ ɹ i ə l
ministerialists	m ɪ n ɪ s t ɪ ɹ i ə l ɪ s t s
minna	m i n ə
mirabal	m ɪ ɹ ə b ə l
mire	m aɪ ɝ
missed	m i s t
missouri	m ɪ s ʊ ɹ i
mitchell	m i tʃ ə l
mixing	m ɪ k s i n
mixing	m ɪ k s ɪ n
mobile	m oʊ b ɑ l
modality	m ɔ d æ l ə t i
model	m ɔ d ə l
model	m ʌ d ə l
modeled	m ʌ d ə l d
modeling	m ʌ d ə l ɪ ŋ
models	m ʌ d ə l z
modern	m ɔ d ɝ n
modernity	m ə d ɝ n ə t i
mods	m ʌ d z
moffat	m ʌ f ə t
moffett	m ʌ f ɪ t
mohan	m oʊ h ə n
molasses	m ə l æ s ə s
mollis	m ʌ l ɪ s
mom	m ʌ m
mom's	m ʌ m z
mommy	m ʌ m i
monaghan	m ɑ n ə h ə n
monarch	m ə n ɑ ɹ k
moncreiff	m ɑ ŋ k ɹ i f
moncrief	m ɑ ŋ k ɹ i f
money	m ɑ n i
mongolia	m ʌ ŋ ɡ oʊ l j ə
mongoose	m ʌ n ɡ u s
monitor	m ɑ n ɪ t ɝ
monitoring	m ɑ n ə t ɹ ɪ ŋ
monk's	m ɑ ŋ k s
monoecious	m ə n ɪ ʃ ə s
monongahela	m ɑ n ə n ɡ ə h ɛ l ə
monro's	m ə n ɹ oʊ z
monroe	m ʌ n ɹ oʊ
mons	m ɑ n z
monsoon	m ʌ n s u n
montenegro	m ɑ n t ə n ɛ ɡ ɹ oʊ
montenegro's	m ɑ n t ə n ɛ ɡ ɹ oʊ z
month	m ɑ n t
months'	m ʌ n θ s
montreal	m ɑ n t ɹ i ə l
montreal	m ə n t ɹ i ɔ l
montreal	m ə n t ɹ i ə l
moondog	m u n d ɔ ɡ
moore	m oʊ
moore	m ɔ ɹ
moore's	m ɔ ɹ z
mooring	m ʊ ɹ ɪ ŋ
moorings	m ʊ ɹ ɪ ŋ z
moose	m u z
morale	m ɔ ɹ ə l
moran	m ɔ ɹ ə n
moratoriums	m ɔ ɹ ə t ɔ ɹ i ə m z
moray	m ɔ ɹ i
more	m oʊ
more	m ʌ
moreau	m ɔ ɹ oʊ
morgue	m oʊ ɡ
morial	m ɔ ɹ i ə l
moriarty	m ɑ ɹ i ɑ ɹ t i
mormon	m oʊ m ə n
mornings	m ɔ ɹ n ɪ n z
morris	m ɔ ɹ ə s
mortensen	m ɔ ɹ t ɪ n s ə n
mortimer	m ɑ t ɪ m ə
mosby	m ʌ z b i
moscow	m ʌ s k oʊ
moses	m oʊ z ɪ s
mosier	m oʊ z ɝ
mosquitos	m ə s k i t oʊ z
mossman	m ɑ s m ə n
motets	m ɔ t ɛ t s
mother	m ɑ ð ɝ
motif	m oʊ t ɪ v
motifs	m oʊ t i v z
motifs	m oʊ t ɪ v z
mottled	m ʌ t ə l d
motto	m ɔ t oʊ
mouths	m aʊ θ s
mouton	m u t ə n
moyse	m ɔɪ z
mozambique	m oʊ s æ m b ɪ k
ms	m ʌ s
much	m ɑ tʃ
muddy	m ɑ d i
mudge	m ɑ dʒ
muehl	m j ʊ l
mullan	m ə l ə n
multilateralism	m ʌ l t i l æ t ɝ ə l ɪ z ə m
multimedia	m ɑ l t i m i d i ə
multinational	m ʌ l t i n æ ʃ ə n ə l
multipart	m ʌ l t i p ɑ ɹ t
mumbo	m ɑ m b oʊ
mundane	m ə n d eɪ n
munroe	m ə n ɹ oʊ
munsters	m ɑ n s t ɝ z
murdoch	m ɝ d ə k
murray	m ɔ ɹ i
murray's	m ɔ ɹ i z
musgraves	m ʌ z ɡ ɹ eɪ v z
musik	m j u z ɪ k
muskrats	m ʌ s k ɹ æ t s
muslim	m ʌ s l ə m
muslims	m ʌ s l ə m z
mustache	m ə s t æ ʃ
mutt	m ɑ t
myrie	m aɪ ɝ i
mysteries	m ɪ s t ɹ i z
mysteriously	m ɪ s t ɪ ɹ i ə s l i
n	æ n
nacional	n æ s i ə n ə l
nadine	n ɑ d i n
nailed	n ɛ l d
nakano	n ə k ɑ n oʊ
nakula	n ə k u l ə
naming	n eɪ m ɪ n
namur	n ə m ɝ
nanjing	n ɛ n dʒ ɪ ŋ
nankin	n æ n k ɪ n
naperville	n æ p ɝ v ɪ l
naples	n æ p ə l z
nasmyth	n ɛ z m ɪ θ
nason	n eɪ s ə n
nassau	n æ s ə
nasty	n ɔ s t i
nat	n ɛ t
natal	n ə t ə l
nation	n eɪ ʃ ə n
nations	n eɪ ʃ ə n z
naturalistic	n æ tʃ ɝ ə l ɪ s t ɪ k
naturalization	n æ tʃ ɝ ə l ɪ z eɪ ʃ ə n
naturalize	n æ tʃ ɝ ə l aɪ z
naturalized	n æ tʃ ɝ ə l aɪ z d
naval	n æ v ə l
navicular	n ə v ɪ k j ə l ɝ
navy	n eɪ v ɪ
naxos	n æ k s oʊ s
naxos	n æ k s ɔ s
neary	n ɪ ɹ i
neck	n æ k
necropolis	n ɛ k ɹ ə p ə l ə s
negri	n ɛ ɡ ɝ i
neighborhood	n eɪ b ɔ ɹ h ʊ d
neighborhoods	n eɪ b ɔ ɹ h ʊ d z
neologisms	n i ə l ə dʒ ɪ z ə m z
neon	n i ə n
nepal	n ə p oʊ l
nepal	n ə p ə l
nepali	n ə p oʊ l i
nepos	n ɛ p ə s
nesbit	n ɛ z b ɪ t
nesbitt	n ɛ s b ɪ t
nets	n æ t s
neurons	n ʊ ɹ ə n z
neuropathy	n ʊ ɹ ə p ə θ i
neutron	n u t ɹ ə n
neutrons	n u t ɹ ɑ n s
newark	n u ɔ ɹ k
newcomers	n u k ʌ m ɝ z
newhart	n u h ɑ ɹ t
newlin	n u l ɪ ŋ
newmarket	n u m ɑ ɹ k ə t
newspaper	n u s p eɪ p ɝ
next	n æ k s
nicholas	n ɪ k l ʌ s
nico	n ɪ k oʊ
nihil	n ɪ h ɪ l
nikolic	n ɪ k ə l ɪ k
nilsen	n i l s ə n
nilson	n i l s ə n
nilsson	n i l s ə n
nissan	n ɪ s ə n
no	n ɔ
nobody's	n oʊ b ə d i z
nong	n ɑ ŋ
nonprofit	n ɑ n p ɹ ɑ f ə t
nonsectarian	n ɑ n s ɛ k t ɛ ɹ i ə n
norby	n ɔ ɹ b i
normally	n oʊ ɹ m ə l i
norman	n oʊ m ə n
norreys	n ɔ ɹ ɪ s
north	n oʊ θ
northcott	n ɔ ɹ θ k ɑ t
norwell	n ɔ ɹ w ɛ l
nose	n ɔ z
nostalgic	n ə s t æ l dʒ ɪ k
not	n ɔ t
notarial	n oʊ t ɔ ɹ i ə l
noteworthy	n oʊ t w ɝ θ i
nothing	n ɔ θ ɪ n
notoriously	n ə t ɔ ɹ i ə s l i
nougat	n u ɡ ə
nozzle	n ʌ z ə l
number	n ʌ m ɝ
numbers	n ʌ m b ɝ s
numeric	n u m ɛ ɹ ɪ k
numerically	n u m ɛ ɹ ɪ k l i
nuneaton	n ʌ n i t ə n
nut	n ɑ t
nutritionist	n u t ɹ ɪ ʃ ə n ɪ s t
nuts	n ɑ t s
nutty	n ɔ t i
nylon	n aɪ l ə n
nynorsk	n i n ɔ ʃ k
o	ɔ
oakham	ɔ k ə m
oases	oʊ eɪ s i z
oberon	oʊ b ɝ ə n
object's	ə b dʒ ɛ k t s
objectivity	ə b dʒ ɛ k t ɪ v ɪ t i
obsidian	ɑ b s ɪ d i ə n
obstetric	ɑ b s t ɛ t ɹ ɪ k
obstetric	ə b s t æ t ɹ ɪ k
obstetrics	ɑ b s t ɛ t ɹ ɪ k s
obtuseness	ə b t u s n ə s
occasions	ə k eɪ ʃ ə n z
occupy	ɔ k j ə p aɪ
occurred	ɔ k ɝ d
occurrences	ə k ɝ ə n s i z
oclock	oʊ k l ɑ k
octagon	ɑ k t ə ɡ ə n
odd	ɔ d
odon	oʊ d ə n
of	oʊ v
of	ɑ v
of	ɔ f
of	ə f
of'	ʌ v
off	ɔ v
off	ʌ f
off	ʌ v
offered	oʊ f ɝ d
office	ɑ v ə z
office	ɔ v ə s
officer	ə f ɪ ʃ ɝ
officers	ɔ f ə s ɝ s
often	oʊ f ə n
oglesby	oʊ ɡ ə l z b i
olaf	oʊ l ə f
olav	oʊ l ə f
olive	ɑ l ʌ v
olive	ɔ l ɪ v
olive	ə l ɪ v
olof	oʊ l ə f
olyphant	oʊ l i f ə n t
omaha	oʊ m ə h ə
on	oʊ n
on	ɔ ŋ
on	ə n
on	ʌ n
once	w ɑ n s
once	w ɔ n s
once	w ʌ n z
one	w ɑ n
one	w ɔ n
ongoing	ɔ n ɡ oʊ ɪ n
ongoing	ə n ɡ oʊ ɪ ŋ
onion	ɑ n j ə n
online	ɑ n l aɪ n
online	ə n l aɪ n
onrushing	ɔ n ɹ ʌ ʃ ɪ ŋ
onscreen	ɔ n s k ɹ i n
onslaught	ɑ n s l ɔ t
onslow	ɔ n s l oʊ
ontology	ɔ n t ɑ l ə dʒ i
opening	oʊ p ə n ɪ n
opera's	ɑ p ɝ ə z
operas	ɑ p ɝ ə z
operas	ʌ p ɝ ə s
operate	ə p ɝ eɪ t
operate	ʌ p ɹ eɪ t
operated	ʌ p ɝ eɪ t ɪ d
operates	ʌ p ɝ eɪ t s
operating	ə p ɹ eɪ t ɪ ŋ
operation	ɔ p ɝ eɪ ʃ ə n
operettas	ɑ p ɝ eɪ t ə z
ophelia	ə f i l i ə
opposition	ə p ə s ɪ ʃ ə n
opt	ɔ p t
opted	ɔ p t ɪ d
opting	ɑ p t i n
option	oʊ p ʃ ə n
optional	oʊ p ʃ ə n ə l
optional	ʌ p ʃ ə n ə l
optometry	ɑ p t ɑ m ə t ɹ i
or	ɑ
or	ɑ ɹ
or	ɔ
or	ɹ
or	ʌ
oral	oʊ ɹ ə l
oran	ɑ ɹ ə n
ordeal	oʊ ɹ d i l
order	oʊ d ə
order	oʊ ɹ d ɝ
ore	oʊ
ore	ɑ ɹ
ore	ə
oregon	ɔ ɹ ə ɡ ə n
organic	ɑ ɹ ɡ æ n ɪ k
original	ɔ ɹ ɪ dʒ ə n ə l
orkin	ɔ ɹ k ɪ n
orpington	oʊ p ɪ ŋ t ə n
orren	ɔ ɹ ə n
orthodontic	ɔ ɹ θ ə d ɑ n t ɪ k
orthography	ɔ ɹ θ ə ɡ ɹ ə f i
osborn	ɑ z b ɔ ɹ n
osborne	ɑ z b ɔ ɹ n
osbourne	ɑ z b ɔ ɹ n
osbourne	ɔ s b ɝ n
osbourne	ɔ z b ɔ ɹ n
oscar	ɑ s k ɝ
oscar's	ɑ s k ɝ z
oshawa	ɑ ʃ ɑ w ə
oslo	ɔ z l oʊ
osmosis	ɑ z m oʊ s ɪ s
oss	oʊ s
ossa	ɔ s ə
ossuary	ɔ s u ɛ ɹ i
ostensibly	ɔ s t ɛ n s ə b l i
ostia	ɔ s t i ə
ostracized	ɔ s t ɹ ə s aɪ z d
ostrovsky	ɑ s t ɹ ɑ v s k i
oswald	ɑ z w ɔ l d
oswego	ɑ z w i ɡ oʊ
other	ɑ θ ɝ
other	ɔ ð ɝ
other	ə ð ɝ
others	ɑ ð ʌ s
others	ɔ θ ɝ z
others	ʌ ð ʌ z
ott	ɔ t
ottawa	ɔ t ə w ə
otter	ɑ t ə
otter	ɔ t ɝ
otters	ʌ t ɝ z
ottley	ɔ t l i
otto	ɔ t oʊ
ottoman	ɔ t ə m ə n
ottomans	ɔ t ə m ə n z
ounce	aʊ n z
our	aʊ ɝ
ours	aʊ ɹ z
over	oʊ f ɔ ɹ
overall	oʊ f ɝ oʊ l
overall	oʊ v ɝ oʊ l
overall	oʊ v ɝ ə l
overalls	oʊ v ɝ ə l z
overdose	oʊ v ɝ d oʊ z
overhaul	oʊ v ɝ h ə l
overhauled	oʊ v ɝ h oʊ l d
overseers	oʊ v ɝ s i ɹ z
overthrowing	oʊ v ɝ θ ɹ oʊ ɪ n
owner	ɔ n ɝ
owyhee	oʊ i h i
ox	ɔ k s
oxford	ɑ k s f ɔ d
oz	ɔ z
ozzy	ʌ z i
packaging	p æ k ɪ dʒ ɪ n
painter	p ɛ n t ɝ
paisley	p eɪ s l i
pakistan	p æ k i s t ə n
pakistan	p æ k ɪ s t ə n
pakistan	p ɛ k ɪ s t ə n
palfrey	p ɛ l f ɹ i
palin	p eɪ l ɪ n
pan	p ɛ n
panagia	p ʌ n ə ɡ i ə
pancreatic	p æ ŋ k ɹ i æ t ɪ k
panel	p ɛ n ə l
pans	p ɛ n s
pansy	p æ n s i
pantheon	p æ n θ i ə n
papists	p æ p ɪ s t s
pappas	p ɛ p ə z
parachuting	p ɛ ɹ ə ʃ u t ɪ ŋ
parade	p ɹ eɪ d
parametric	p ɛ ɹ ə m ɛ t ɹ ɪ k
paramilitary	p ɛ ɹ ə m ɪ l ə t ɛ ɹ i
paranormal	p ɛ ɹ ə n ɔ ɹ m ə l
parcel	p ɑ ɹ ʃ ə l
pardini	p ɑ ɹ d i n i
parents	p eɪ ɹ ə n t s
parents'	p ɛ ɹ ə n t s
paris	p æ ɹ ɪ ʃ
paris	p ɛ ɹ i z
paris	p ɛ ɹ ə s
paris'	p ɛ ɹ ɪ s
parish	p æ ɹ ɪ s
parish	p ɛ ɹ ɪ s
parking	p ɑ k i n
parking	p ɑ ɹ k ɪ n
parkland	p ɑ ɹ k l æ n d
parliamentary	p ɑ ɹ l ə m ɛ n t ɝ i
parliamentary	p ɑ ɹ l ə m ɛ n t ɹ i
parodied	p ɛ ɹ ə d ɪ d
parodies	p ɛ ɹ ə d ɪ z
part	p ɔ t
part	p ʌ t
partially	p ɑ ɹ ʃ l i
particularly	p ɑ t ɪ k j ə l ɝ l i
partisans	p ɑ ɹ t ə z ɑ n z
parts	p ɑ t z
party	p ɑ t ɪ
pass	p ɔ s
pass	p ʌ s
passau	p æ s ə
passing	p æ s ɪ n
pastoral	p æ s t ɹ ə l
pastorals	p æ s t ɔ ɹ ə l z
patent	p eɪ t ə n t
patented	p eɪ t ə n t ɪ d
patents	p eɪ t ə n t s
paterson	p eɪ t ɝ s ə n
paton	p eɪ t ə n
patricia	p ə t ɹ ɪ s ə
patricks	p æ t ɹ ɪ k s
patterson	p æ t ɝ ʃ ə n
patties	p æ t ɪ z
paul	p oʊ l
paul	p ə l
paula	p oʊ l ə
paulding	p oʊ l d ɪ ŋ
pauli	p oʊ l i
paulin	p oʊ l ɪ n
paulin	p ɔ l i n
paulina	p oʊ l i n ə
paulus	p oʊ l ə s
pausanias	p ɑ s ɑ n i ə z
pavia	p æ v i ə
pavia	p ɑ v i ə
payson	p eɪ s ə n
peaceful	p ɪ s f ɔ l
peaks	p ɪ k s
peanuts	p i n ɑ t s
pearce	p ɪ ɹ s
pearson	p ɪ ɝ s ə n
pecans	p i k ɔ n z
pecans	p i k ə n z
pechora	p ə k ɔ ɹ ə
pectin	p æ k t ə n
peduncles	p ə d ə ŋ k ə l z
peel	p ɪ l
peering	p ɪ ɹ ɪ ŋ
peers	p ɪ ɹ s
peirce	p ɪ ɹ s
peloton	p ɛ l ə t ə n
pemmican	p æ m ɪ k ə n
penalised	p ɪ n ə l aɪ z d
penang	p ə n ə n
penguin	p ɛ n ɡ w ə n
percussive	p ɝ k ʌ s ɪ v
peregrines	p ɛ ɹ ə ɡ ɹ ɪ n z
performatives	p ɝ f ɔ ɹ m ə t ɪ v z
periodically	p ɪ ɹ i ə d ɪ k l i
periodically	p ɪ ɹ i ə d ɪ k ə l i
peris	p ɛ ɹ ɪ s
persian	p ɝ ʃ ə n
persians	p ɝ ʃ ə n z
pesch	p æ ʃ
pest	p æ s t
pet	p æ t
pete	p ɪ t
peter	p ɪ t ɝ
petersfield	p i t ɝ z v i l d
peterson	p i t ɝ z ə n
petiole	p æ t i ə l
petrie	p ɛ t ɹ i
phall	f ɔ l
pharmacies	f ɑ ɹ m ə s ɪ z
pharmacy	f ɑ ɹ m ə s ɪ
phase	f eɪ s
phases	f eɪ s i z
phases	f eɪ s ɪ z
phenomenon	f ə n ɑ m ə n ɑ
philip's	f ɪ l i p s
philosophical	f ɪ l ə s ə f ɪ k ə l
philosophical	f ɪ l ə z ɑ f ɪ k ə l
phonation	f ɔ n eɪ ʃ ə n
phone	f ɔ n
phonology	f ɑ n ə l ə dʒ i
phosphor	f ɑ s f ɝ
phosphoric	f ɑ s f ɔ ɹ ɪ k
photography	f ɔ t ə ɡ ɹ ə f i
photon	f oʊ t ɑ n
photons	f oʊ t ə n z
photos	f oʊ t oʊ s
phylogenetic	f aɪ l ə dʒ ə n ɛ t ɪ k
physiological	f ɪ s i ə l ɑ dʒ ɪ k ə l
pickaninnies	p ɪ k ə n i n i z
picture	p ɪ tʃ ɝ
piece	p ɪ s
pieces	p ɪ s ɪ z
piedmont	p ɪ d m ə n t
piers	p ɪ ɹ s
pigs	p ɪ ɡ s
pilbara	p ɪ l b ɑ ɹ ə
piloting	p aɪ l ə t i n
pindar	p i n d ɝ
pineda	p ɪ n eɪ d ə
pion	p aɪ ə n
pioneer	p aɪ ə n i ɹ
pioneering	p aɪ ə n ɪ ɹ ɪ n
pipestone	p aɪ p s t ɔ ŋ
pirating	p aɪ ɹ ə t ɪ n
pisa	p i z ə
pisa	p ɪ s ə
pisani	p ɪ s ɑ n i
pisano	p ɪ s ɑ n oʊ
piso	p i z oʊ
pitch	p i tʃ
pitofsky	p ə t ɑ v s k i
placards	p l æ k ɑ ɹ d z
place	p l eɪ z
placentation	p l æ s ə n t eɪ ʃ ə n
plack	p l eɪ k
plagiarizing	p l ɛ dʒ ɝ aɪ z ɪ ŋ
plan	p l eɪ n
plane	p l æ n
planetarium	p l æ n ɪ t ɛ ɹ i ə m
planing	p l eɪ n ɪ ŋ
planners	p l æ n ɝ s
plant	p l ʌ n t
plaque	p l eɪ k
plaque	p l ʌ k
plasma	p l æ s m ə
plating	p l eɪ t i n
platte	p l ɛ t
plaut	p l ɑ t
play	p l æ
player	p l eɪ ɹ
player	p l ɛ ɹ
plays	p l eɪ s
plays	p l æ z
plenipotentiary	p l ɛ n i p ə t ɛ n tʃ ɝ i
pol	p oʊ l
pole	p ɔ l
police	p ə l ɪ s
polices	p ɑ l ɪ s ɪ s
policies	p ɑ l ə s ɪ z
polis	p ɑ l i z
politics	p ə l ɪ t ɪ k s
polka	p oʊ l k ə
polling	p ɔ l ɪ ŋ
pollution	p ə l u ʒ ə n
polybius	p ɑ l ɪ b i ə s
polyesters	p ɑ l i æ s t ɝ z
polygon	p ɑ l ɪ ɡ ə n
polygons	p ɑ l ɪ ɡ ɑ n z
polygons	p ɑ l ɪ ɡ ə n z
polygyny	p ɑ l ɪ dʒ ə n i
polymer	p ɑ l ɪ m ɝ
polyphonic	p ɑ l i f ɑ n ɪ k
polyphonic	p ɑ l ɪ f ə n ɪ k
polyphony	p ɑ l ɪ f ə n i
polytheism	p ɑ l ɪ θ i ɪ z ə m
pomme	p ɔ m
pon	p ɔ n
pont	p ə n t
pool	p ʊ l
pooling	p ʊ l ɪ ŋ
pools	p ʊ l z
poor	p oʊ
poor	p ɔ
poorly	p oʊ l i
poplars	p ɑ p l ɝ z
popples	p ʌ p ə l z
port	p oʊ t
port	p ɑ t
port	p ɑ ɹ t
portrush	p ɔ ɹ t ɹ ə ʃ
ports	p oʊ t s
posh	p ɔ ʃ
position	p ə s ɪ ʃ ə n
positions	p ə z ɪ ʃ ə n s
positron	p ɑ z ə t ɹ ɑ n
possessed	p ə s ɛ s t
possession	p ə s ɛ ʃ ə n
post	p ɔ s t
posterior	p ɑ s t ɪ ɹ i ɝ
poston	p ɔ s t ə n
power	p aʊ ɹ
powers	p aʊ ɹ z
practice	p ɹ æ k t ə z
practicing	p ɹ æ k t ə z ɪ ŋ
practising	p ɹ æ k t ə s ɪ ŋ
pradesh	p ɹ ə d ɛ ʃ
precambrian	p ɹ i k æ m b ɹ i ə n
precarious	p ɹ i k ɛ ɹ i ə s
preceded	p ɹ i s i d ə d
preceded	p ɹ ɪ s i d ə d
precedes	p ɹ i s i d z
precinct	p ɹ i s ɪ ŋ k
precursor	p ɹ ɪ k ɝ s ɝ
predecessor	p ɹ i d ə s ɛ s ɝ
predetermined	p ɹ i d ɪ t ɝ m ə n d
predictably	p ɹ ɪ d ɪ k t ə b l i
predictions	p ɹ ɪ d ɪ k ʃ ə n z
predicts	p ɹ ɪ d ɪ k s
predominately	p ɹ ɪ d ɑ m ə n ə n t l i
preferably	p ɹ ɛ f ɝ ə b l i
preferences	p ɹ ɛ f ɹ ə n s ɪ z
preliminary	p ɹ i l ɪ m ə n ɛ ɹ i
prelude	p ɹ ɛ l u d
premier	p ɹ i m i ɝ
premier	p ɹ i m i ɹ
premier	p ɹ i m ɪ ɹ
premises	p ɹ ɛ m ə s ə s
preparatory	p ɹ ɛ p ɝ ə t ɔ ɹ i
preschool	p ɹ i s k u l
prescott	p ɹ ɛ s k ə t
prescriptive	p ɹ i s k ɹ ɪ p t ɪ v
preseason	p ɹ i s i z ə n
presence	p ɹ ɛ s ə n s
presence	p ɹ ɛ ʃ ə n z
presented	p ɹ i z ɛ n ə d
presented	p ɹ ɪ z ɛ n t ə d
presenter	p ɹ i z ɛ n t ɝ
presenters	p ɹ i z ɛ n t ɝ z
presenters	p ɹ ɪ z ɛ n t ɝ z
preserved	p ɹ i s ɝ v d
preserved	p ɹ ɪ z ɝ v d
preside	p ɹ ɪ z aɪ d
presided	p ɹ ɪ z aɪ d ɪ d
president	p ɹ ɛ s ɪ d ə n t
presides	p ɹ ɪ s aɪ d z
presidium	p ɹ ɪ z ɪ d i ə m
presnell	p ɹ ɛ s n ə l
press's	p ɹ ɛ s ɪ z
prestwood	p ɹ ɛ s t w ʊ d
preteen	p ɹ i t i n
preteens	p ɹ i t i n z
preterm	p ɹ i t ɝ m
pretoria	p ɹ ɪ t ɔ ɹ i ə
previews	p ɹ i v j u z
previous	p ɹ ɪ v i ə s
price	p ɹ aɪ z
primaries	p ɹ aɪ m ɹ i s
primavera	p ɹ i m ə v ɛ ɹ ə
primitive	p ɹ ɪ m ə t ɪ v
prins	p ɹ ɪ n s
prisms	p ɹ ɪ s ə m z
prison	p ɹ ɪ s ə n
privett	p ɹ ɪ v ɪ t
prize	p ɹ aɪ s
prizes	p ɹ aɪ s ɪ z
probability	p ɹ ɑ b ə b ɪ l ə t i
probing	p ɹ oʊ b i n
problems	p ɹ ɑ b l ə m s
proceeding	p ɹ ə s i d ɪ n
processes	p ɹ ɑ s ɛ s i z
processor	p ɹ ɑ s ɛ s ɝ
product	p ɹ ə d ə k t
productions'	p ɹ ə d ʌ k ʃ ə n z
productivity	p ɹ ə d ə k t ɪ v ɪ t i
products	p ɹ ɑ d ə k s
products	p ɹ ə d ə k t s
professor	p ɹ ə f ɛ s ə ɝ
progeny	p ɹ ə dʒ ə n i
prolog	p ɹ oʊ l ɔ ɡ
prologue	p ɹ oʊ l ɔ ɡ
prologues	p ɹ oʊ l ɔ ɡ z
promising	p ɹ ɑ m ə s ɪ ŋ
promptly	p ɹ ɑ m p l i
prompts	p ɹ ɑ m p t s
proper	p ɹ ɑ p ə
prorogation	p ɹ oʊ ɹ ə ɡ eɪ ʃ ə n
prose	p ɹ ɔ z
prosecute	p ɹ ɑ s ə k j u t
prosecutors'	p ɹ ɑ s ə k j u t ɝ z
prospecting	p ɹ ɑ s p ɛ k t ɪ ŋ
prospered	p ɹ ɔ s p ɝ d
prosperity	p ɹ ɑ s p ɛ ɹ ə t i
protectionist	p ɹ ə t ɛ k ʃ ə n ɪ s t
protections	p ɹ ə t ɛ k ʃ ə n z
protest	p ɹ ə t ə s t
protests	p ɹ ə t ɛ s
protocol	p ɹ oʊ t ə k oʊ l
protocol	p ɹ oʊ t ə k ə l
protocols	p ɹ oʊ t ə k ə l z
provence	p ɹ ɑ v ə n s
province	p ɹ ə v ɪ n s
province's	p ɹ ɑ v ə n s ɪ z
provinces	p ɹ ə v ə n s ə z
provincial	p ɹ ə v ɪ n s ə l
ptolemy's	t ɑ l ə m ɪ z
pub	p ɑ b
public	p ɑ b l ɪ k
publication	p ɑ b l ɪ k eɪ ʃ ə n
publishing	p ʌ b l ɪ ʃ i n
pubs	p ɑ b z
puck	p ɑ k
pucks	p ɑ k s
puerto	p ɔ ɹ t ə
puerto	p ɔ ɹ t ɝ
puff	p ɑ f
pugsley	p ʌ ɡ z l i
pula	p u l ə
pullo	p ʊ l oʊ
pulsating	p ə l s eɪ t ɪ ŋ
pumpelly	p ɑ m p ɛ l i
punjabi	p ɑ n dʒ ɑ b i
puppet	p ɑ p ə t
puppetry	p ʌ p ə t ɹ i
puppies	p ʌ p ɪ s
purana	p ɹ ɑ n ə
purchas	p ɝ tʃ ə s
purchasing	p ɝ tʃ ə s ɪ n
puri	p u ɹ i
pusan	p u s ə n
putti	p u t i
puzzles	p ʌ s ə l z
puzzling	p ʌ z l ɪ n
python	p aɪ t ə n
python	p aɪ θ ə n
quadriceps	k w ɑ d ɹ ə s ɛ p s
quahog	k w ɑ h oʊ ɡ
quantico	k w ɑ n t i k oʊ
quarterbacks	k w ɔ ɹ t ɝ b æ k s
querns	k w ɝ n s
quickly	k w ɪ k l ɪ
quintessential	k w ɪ n t i s ɛ n tʃ ə l
quizzing	k w ɪ z i n
qur'an	k ɝ ə n
r	ɔ
race	ɹ eɪ z
raced	ɹ eɪ z t
races	ɹ eɪ s i z
racine	ɹ æ s i n
racing	ɹ eɪ z ɪ ŋ
rack	ɹ ɛ k
racks	ɹ ɛ k s
raconteur	ɹ æ k ə n t ɝ
radburn	ɹ æ d b ɝ n
radiation	ɹ æ d i eɪ ʃ ə n
raffi	ɹ æ f i
rafi	ɹ æ f i
rage	ɹ ɛ dʒ
raid	ɹ ɛ d
raided	ɝ eɪ d ɪ d
rail's	ɹ ɛ l z
railway	ɹ æ l w eɪ
rainier	ɹ ɛ n i ɝ
rainy	ɹ eɪ n ɪ
raise	ɹ eɪ s
raising	ɹ eɪ s ɪ ŋ
rallies	ɹ eɪ l i z
ramadan	ɹ ɑ m ə d ə n
raman	ɹ æ m ə n
ramin	ɹ ɑ m ə n
ramos	ɹ æ m oʊ s
ramsay	ɹ æ m z i
ramsey	ɹ æ m s i
ramstad	ɹ æ m s t ɑ d
ramus	ɹ æ m ə s
randell	ɹ ɛ n d eɪ l
randleman	ɹ æ n d ə l m ə n
range	ɹ ɛ n dʒ
ranjit	ɹ æ n dʒ i t
rankin	ɹ æ ŋ k ɪ ŋ
rankin	ɹ ɛ n k ɪ n
ranking	ɹ æ ŋ k ɪ n
rankings	ɹ æ ŋ k ɪ ŋ z
raptors	ɹ æ p t ɝ z
rarely	ɹ æ l i
ras	ɹ æ z
raskin	ɹ æ s k ɪ n
raspberry	ɹ æ s b ɛ ɹ i
raspy	ɹ ʌ s p ɪ
rather	ɹ ɑ ð ɝ
ratification	ɹ ɛ t ə f ə k eɪ ʃ ə n
ratings	ɹ eɪ t i n z
rationale	ɹ æ ʃ ə n ə l
rattling	ɹ æ t l ɪ ŋ
raucous	ɹ ɑ k ə s
ravenna	ɹ ə v ɛ n ə
ravine	ɹ eɪ v i n
raw	ɹ oʊ
rawling	ɹ ɔ l ɪ ŋ
rawlinson's	ɹ ɑ l ɪ n s ə n z
rayon	ɹ eɪ ə n
reaching	ɹ i tʃ ɪ n
reactivity	ɹ i æ k t ɪ v ə t i
readable	ɹ i d ʌ b ə l
readings	ɹ i d ɪ ŋ z
readings	ɹ ɪ d ɪ ŋ z
reads	ɹ i d s
reasons	ɹ i s ə n z
reassess	ɹ i ə s ɛ s
rebel	ɹ æ b ə l
rebel	ɹ ɪ b ɛ l
rebroadcast	ɹ i b ɹ ɔ d k æ s t
rebuffed	ɹ ɪ b ʌ f t
recalls	ɹ ɪ k ɔ l z
recanted	ɹ ɪ k æ n t ɪ d
recanting	ɹ ɪ k æ n t ɪ ŋ
recedes	ɹ i s i d z
receding	ɹ ɪ s i d ɪ ŋ
receivers	ɹ ɪ s i v ɝ s
recent	ɹ ɪ s ə n t
reck	ɹ eɪ k
recoiling	ɹ ɪ k ɔɪ l ɪ ŋ
recompense	ɹ i k ə m p æ n s
reconditioned	ɹ i k ə n d ɪ ʃ ə n d
reconfirmed	ɹ i k ə n f ɝ m d
reconnaissance	ɹ ɪ k ɑ n ə s ə n s
reconnect	ɹ i k ə n ɛ k t
reconnecting	ɹ i k ə n ɛ k t ɪ ŋ
record	ɹ æ k ɔ d
records	ɹ ɛ k ɔ d s
records	ɹ ɛ k ɝ d z
recounted	ɹ ɪ k aʊ n t ɪ d
recounts	ɹ ɪ k aʊ n t s
recovery	ɹ ɪ k ʌ v ɝ i
recur	ɹ ɪ k ɝ
recurring	ɹ ɪ k ɝ ɪ n
recurved	ɹ ɪ k ɝ v d
red	ɹ æ d
redeemed	ɹ i d i m d
redeems	ɹ i d i m z
redevelopment	ɹ i d ɪ v ɛ l ə p m ə n t
rediffusion	ɹ i d ɪ f j u ʒ ə n
redirecting	ɹ i d ɝ ɛ k t ɪ ŋ
redistricting	ɹ i d ɪ s t ɹ ɪ k t ɪ ŋ
redraft	ɹ i d ɹ æ f t
redraw	ɹ i d ɹ ɔ
reductions	ɹ ɪ d ʌ k ʃ ə n z
redundancy	ɹ i d ʌ n d ə n s i
reenactment	ɹ i ɪ n æ k t m ə n t
rees	ɹ i s
reestablished	ɹ i s t æ b l ɪ ʃ t
reestablishment	ɹ i s t æ b l ɪ ʃ m ə n t
refectory	ɹ ɪ f ɛ k t ɝ i
reference	ɹ ɛ f ɝ ə n s
referenced	ɹ ɛ f ɝ ə n s t
references	ɹ ɛ f ɹ ə n s ɪ z
referencing	ɹ ɛ f ɹ ə n s ɪ ŋ
referendums	ɹ ɛ f ɝ ɛ n d ə m z
reffner	ɹ ɛ f n ɝ
refit	ɹ i f i t
reformation	ɹ i f ɔ ɹ m eɪ ʃ ə n
reformers'	ɹ ɪ f ɔ ɹ m ɝ z
reforms	ɹ i f ɔ m z
reforms	ɹ i f ɔ ɹ m z
refreshed	ɹ i f ɹ ɛ ʃ t
refueling	ɹ i f j u l ɪ ŋ
refueling	ɹ ɪ f j u l ɪ ŋ
refund	ɹ i f ʌ n d
refurbishment	ɹ i f ɝ b ɪ ʃ m ə n t
refurbishment	ɹ ɪ f ɝ b ɪ ʃ m ə n t
refuse	ɹ ɛ f j u z
regain	ɹ ɪ ɡ eɪ n
regains	ɹ ɪ ɡ eɪ n z
regenerating	ɹ ɪ dʒ ɛ n ɝ eɪ t ɪ ŋ
regional	ɝ ɪ dʒ ə n ə l
regional	ɹ ɪ dʒ ə n ə l
regionally	ɝ ɪ dʒ ə n ə l i
regis	ɹ æ dʒ ɪ s
rehearsal	ɹ ɪ h ɝ s ə l
rehearsals	ɹ ɪ h ɝ s ə l z
rehearsed	ɹ ɪ h ɝ s t
rehn	ɹ ɛ n
rehnquist	ɹ ɛ n k w ɪ s t
rehnquist	ɹ ɛ ŋ k w ɪ s t
reims	ɹ i m z
reinstituted	ɹ i ɪ n s t ɪ t u t ɪ d
reinventing	ɹ i ɪ n v ɛ n t ɪ ŋ
reinvention	ɹ i ɪ n v ɛ n ʃ ə n
reinvests	ɹ i ɪ n v ɛ s
relapses	ɹ i l æ p s ɪ z
relations	ɹ i l eɪ ʃ ə n ʃ
relatives	ɹ ɛ l ə t ɪ v s
relativistic	ɹ ɛ l ə t ɪ v ɪ s t ɪ k
relays	ɹ i l eɪ s
release	ɹ i l i z
releases	ɹ i l i s ɪ s
releases	ɹ ɪ l i z ɪ s
releases	ɹ ɪ l ɪ z ɪ z
relent	ɹ i l ɛ n t
reliably	ɹ ɪ l aɪ ə b l i
reliance	ɹ ɪ l aɪ ə n s
relied	ɹ i l aɪ d
reliefs	ɹ ɪ l i f s
relies	ɹ i l aɪ z
relinquished	ɹ ɪ l ɪ ŋ k w ɪ ʃ t
reliquary	ɹ ɪ l ɪ k w ɛ ɹ i
remember	m ɛ m b ɝ
reminder	ɹ ɪ m aɪ n d ɝ
remittance	ɹ ɪ m ɪ t ə n s
remorse	ɹ i m ɔ ɹ s
remorseful	ɹ i m ɔ ɹ s f ə l
removable	ɹ i m u v ə b ə l
removal	ɹ i m u v ə l
renaissance	ɹ ɛ n ə s ə n s
rendel	ɹ æ n d ə l
rendition	ɹ æ n d ɪ ʃ ə n
renew	ɹ i n u
renewable	ɹ i n u ə b ə l
renews	ɹ i n u z
reno's	ɹ i n oʊ s
rental	ɹ æ n t ə l
reorient	ɹ i ɔ ɹ i ɛ n t
repair	ɹ i p ɛ ɹ
repairing	ɹ i p ɛ ɹ ɪ ŋ
repatriated	ɹ ɪ p eɪ t ɹ i eɪ t ɪ d
repeatable	ɹ ɪ p i t ə b ə l
repertoire	ɹ æ p ə t w ɑ
replaced	ɹ i p l eɪ s t
repository	ɹ ɪ p ɑ z ə t ɔ ɹ i
represent	ɹ i p ɹ i z ɛ n t
represented	ɹ ɛ p ɹ ə z ɛ n ə d
repression	ɹ ɪ p ɹ ɛ ʃ ə n
repressive	ɹ ɪ p ɹ ɛ s ɪ v
reprise	ɹ ɪ p ɹ aɪ s
reprise	ɹ ɪ p ɹ i s
repudiate	ɹ ɪ p j u d i eɪ t
requests	ɹ ɪ k w ɛ s
require	ɹ i k w aɪ ɝ
requirement	ɹ i k w aɪ ɝ m ə n t
requiring	ɹ i k w aɪ ɹ ɪ ŋ
rerouted	ɹ i ɹ u t ɪ d
reruns	ɹ i ɹ ʌ n z
rescinded	ɹ i s ɪ n d ə d
rescissions	ɹ ɪ s ɪ ʃ ə n z
resents	ɹ ɪ z ɛ n t s
reserve	ɹ i s ɝ f
reserved	ɹ i s ɝ v d
reshuffle	ɹ i ʃ ʌ f ə l
reside	ɹ i z aɪ d
resided	ɹ ɪ s aɪ d ɪ d
residential	ɹ ɛ z ɪ d ɛ n ʃ ə l
resides	ɹ ɪ s aɪ d z
resign	ɹ i s aɪ n
resigned	ɹ i s aɪ n d
resigned	ɹ i z aɪ n d
resin	ɹ ɛ z ə n
resins	ɹ ɛ z ə n z
resistance	ɹ ɪ s ɪ s t ə n s
resistor	ɹ ɪ s ɪ s t ɝ
resistors	ɹ ɪ z ɪ s t ɝ z
resists	ɹ ɪ z ɪ s
resnick's	ɹ ɛ z n ɪ k s
resort	ɝ i s ɔ ɹ t
resort	ɹ i z ɔ ɹ t
resorting	ɹ i z ɔ ɹ t ɪ ŋ
resorts	ɹ i z ɔ ɹ t s
resound	ɹ i z aʊ n d
resounding	ɹ i z aʊ n d ɪ ŋ
resource	ɹ i z oʊ s
resource	ɹ i z ɔ s
resource	ɹ i z ɔ ɹ s
resources	ɹ i z ɔ ɹ s ɪ z
responders	ɹ ɪ s p ɑ n d ɝ z
response	ɹ ɪ s p ɑ n z
restaurant	ɹ ɛ s t ɝ ə n t
restaurant	ɹ ɛ s t ɹ ɑ n t
restaurant	ɹ ɛ ʃ t ɝ ɑ n t
restored	ɹ i s t ɔ ɹ d
restraint	ɹ ɪ s t ɹ eɪ n t
restricted	ɹ i s t ɹ ɪ k t ɪ d
result	ɹ i s ʌ l t
resume	ɹ i s u m
resurface	ɹ i s ɝ f ə s
resurfaced	ɹ i s ɝ f ə s t
retailers	ɹ i t ɛ l ɝ z
retaliate	ɹ i t æ l i eɪ t
retaliated	ɹ i t æ l i eɪ t ɪ d
retaliates	ɹ i t æ l i eɪ t s
retaliatory	ɹ i t æ l i ə t ɔ ɹ i
retardant	ɹ i t ɑ ɹ d ə n t
rethinking	ɹ i θ ɪ ŋ k ɪ ŋ
retire	ɹ i t aɪ ɝ
retirement	ɹ i t aɪ ɝ m ə n t
retirements	ɹ i t aɪ ɝ m ə n t s
retires	ɹ i t aɪ ɝ z
retiring	ɹ i t aɪ ɝ ɪ ŋ
retransmission	ɹ i t ɹ æ n z m ɪ ʃ ə n
revenue	ɹ æ v ə n u
reverb	ɹ i v ɝ b
revered	ɹ i v ɪ ɹ d
reversed	ɹ i v ɝ s t
reversionary	ɹ ɪ v ɝ ʃ ə n ɛ ɹ i
reviews	ɹ i v j u s
reviews	ɹ ɪ f j u z
revised	ɹ ɪ v aɪ z d
revision	ɹ ɪ v ɪ ʒ ə n
revisionist	ɹ i v ɪ ʒ ə n ɪ s t
revisions	ɹ ɪ v ɪ ʒ ə n z
revue	ɹ i v j u
rework	ɹ i w ɝ k
reworked	ɹ i w ɝ k t
rex	ɹ æ k s
reynolds	ɹ eɪ n ə l d z
reza	ɹ eɪ z ə
rhetoric	ɹ ɛ t ɝ ɪ k
rhett	ɹ ɛ t
rhys	ɹ i s
rhythmic	ɹ ɪ θ m ɪ k
riccardo	ɹ ɪ k ɑ ɹ d oʊ
rick	ɹ i k
rico	ɝ i k oʊ
rico	ɝ ɪ k oʊ
riddick	ɹ ɪ d ɪ k
ridges	ɹ i dʒ ɪ z
riding	ɹ aɪ d ɪ n
riffed	ɹ ɪ f t
riffs	ɹ ɪ f s
riga	ɹ ɪ ɡ ə
riggs	ɹ ɪ ɡ s
rimbaud	ɹ ɪ m b ɔ
ring	ɹ i n
ring	ɹ i ŋ
ringling	ɹ ɪ ŋ l ɪ ŋ
rings	ɹ ɪ n z
riopel	ɹ i ə p ɛ l
ripon	ɹ ɪ p ə n
rise	ɝ aɪ z
rishi	ɹ ɪ ʃ i
ritchie's	ɹ ɪ tʃ ɪ z
river	ɹ i v ə
river	ɹ i v ɝ
rivers	ɹ ɪ v ɝ s
rivkin	ɹ ɪ v k ɪ n
riyadh	ɹ i ɑ d
riyadh	ɹ i ə d
rizal	ɹ ɪ z ə l
roark	ɹ ɔ ɹ k
robby's	ɹ ɑ b i z
roberta	ɹ ə b ɝ t ə
roberts'	ɹ ɑ b ɝ t s
roberval	ɹ ə b ɑ ɹ v ə l
robin	ɹ ɑ b ə n
robin	ɹ ɑ b ɪ ŋ
roblin	ɹ ʌ b l ɪ n
robot	ɹ oʊ b ɑ t
robot	ɹ oʊ b ɔ t
robotic	ɹ oʊ b ə t ɪ k
robotics	ɹ oʊ b ə t ɪ k s
robust	ɹ oʊ b ʌ s t
roche	ɹ ɔ ʃ
rock	ɹ ʌ k
rockin'	ɹ ɑ k ɪ ŋ
rockman	ɹ ɑ k m ə n
rod	ɹ oʊ d
roddenberry	ɹ ɑ d ə n b ɛ ɹ i
rolling	ɹ oʊ l i n
rollins	ɹ ɔ l ɪ n z
roma	ɝ oʊ m ə
romford	ɹ ʌ m f ɝ d
romy	ɹ ɑ m i
rondon	ɹ ʌ n d ə n
ronnie	ɹ ʌ n i
rooker	ɹ ʊ k ɝ
rookie	ɹ u k i
roosevelt	ɹ u s ə v ɛ l t
rooted	ɹ u t ə d
rory	ɹ oʊ ɝ i
ros	ɹ ɑ s
rosalyn	ɹ ɑ z ə l ɪ n
rosanna	ɹ oʊ s æ n ə
roscoe	ɹ ʌ s k oʊ
rosebud	ɹ oʊ z b ʌ d
rosen	ɹ oʊ s ə n
ross	ɹ oʊ s
rosseter	ɹ ɑ s ɪ t ɝ
rossi	ɹ ʌ s i
rost	ɹ ɔ s t
rothenstein	ɹ ɑ θ ə n s t aɪ n
rotherfield	ɹ ɑ θ ɝ f i l d
rothschild	ɹ ɑ θ tʃ aɪ l d
rotisserie	ɹ ə t ɪ s ɝ i
rotor	ɹ ɔ t ɝ
round	ɝ aʊ n d
roundhead	ɹ aʊ n d h æ d
router	ɹ u t ɝ
routing	ɹ u t i n
rovings	ɹ oʊ v i n z
rowing	ɹ oʊ ɪ n
roxanna	ɹ ɑ k s æ n ə
roy	ɝ ɔɪ
rubber	ɹ ɑ b ɝ
rube	ɝ u b
rubik's	ɹ u b ɪ k s
rucksack	ɹ ɑ k s æ k
ruda	ɹ u d ə
rudimentary	ɹ u d ə m ɛ n t ɹ i
rudolf	ɹ u d ɑ l f
rudolph	ɹ u d ɑ l f
rui	ɝ u i
ruins	ɹ u ə n z
rumba	ɹ u m b ə
rural	ɹ u ɹ ə l
rustling	ɹ ʌ s l ɪ ŋ
rutherford	ɹ ʌ ð ɝ f ɝ d
rutland	ɹ ɑ t l ə n d
s	æ s
sack	s ɛ k
sacks	s ɛ k s
saco	s æ k oʊ
sadie	s eɪ d i
safe	s eɪ v
safra	s æ f ɹ ə
saguaro	s ə ɡ w ɑ ɹ oʊ
sahib	s ə h i b
said	s eɪ i d
said	s æ d
saigon	s aɪ ɡ ə n
saint	s ɑ n t
salem	s æ l ə m
salem	ʃ eɪ l ə m
sales	s ɛ l s
sales	s ɛ l z
salford	s ɛ l f ɝ d
salim	s eɪ l ɪ m
salk	s oʊ k
salmasius	s æ l m eɪ s i ə s
salome	s ə l oʊ m
salomon	s ɛ l ə m ə n
salta	s oʊ l t ə
salter	ʃ oʊ l t ɝ
salts	s oʊ l t s
salvadoran	s æ l v ə d ɔ ɹ ə n
samian	s æ m i ə n
sampras	s æ m p ɹ ə z
san	s eɪ n
san	ʃ æ n
sanada	s ə n ɑ d ə
sanctorum	s æ ŋ k t ɔ ɹ ə m
sand	s eɪ n d
sandakan	s æ n d ə k ə n
sangreal	s æ ŋ ɡ ɹ i ə l
sani	s ɛ n i
santa	s eɪ n t ə
saracen	s ɛ ɹ ə s ə n
sardinian	s ɑ ɹ d ɪ n i ə n
sasebo	s æ s i b oʊ
saskatchewan	s ɛ s k æ tʃ ə w ə n
sassari	s ə s ɑ ɹ i
satellite	s ɛ t ə l aɪ t
satire	s æ t aɪ ɹ
satirising	s æ t ɹ aɪ z ɪ ŋ
satisfactorily	s æ t ə s f æ k t ɝ ə l i
satriani	s æ t ɹ i ɑ n i
satyr	s æ t ɝ
sauder	s oʊ d ɝ
saudi	s oʊ d i
saudi	s ɑ d i
sault	s oʊ l t
saunders	s oʊ n d ɝ z
sauron	s ɑ ɹ ə n
sauvignon	s oʊ v ɪ ŋ j ə ŋ
savernake	s æ v ɝ n æ k
saving	s eɪ v ɪ n
saw	s oʊ
saxophonist	s æ k s ə f ə n ɪ s t
say	s eɪ ɪ
says	s eɪ z
scarecrow	s k ɛ ɹ k ɹ oʊ
scarecrows	s k ɛ ɹ k ɹ oʊ z
scarves	s k ɑ ɹ f s
schaffer	ʃ æ f ɝ
schemata	s k ɪ m ɑ t ə
schemes	s k ɪ m z
schnabel	ʃ n eɪ b ə l
schumacher	ʃ u m ə k ɝ
schwartzman	ʃ w ɔ ɹ t s m ə n
science	s aɪ ə n z
scoffed	s k ɑ f t
scopolamine	s k ə p ə l ə m i n
scores	s k ɔ ɹ s
scoring	s k ɑ ɹ ɪ ŋ
scott	ʃ k ɑ t
scottish	s k ɔ t ɪ ʃ
scrambling	s k ɹ æ m b ə l ɪ ŋ
scrapings	s k ɹ eɪ p ɪ n z
screaming	s k ɹ i m ɪ n
screenings	s k ɹ i n ɪ n z
scripted	s k ɹ ɪ p t ɪ d
scripting	s k ɹ ɪ p t i n
scripts	s k ɹ ɪ p s
scroll	s k ɹ ɔ l
scully	s k ɑ l i
sea	s ɪ
seagull	s i ɡ ə l
sean	ʃ oʊ n
sean	ʃ ə n
sears	s ɪ ɹ s
season	s i s ə n
season	s ɪ s ə n
season	s ɪ ʃ ə n
seasons	s ɪ s ə n z
seating	s ɪ t ɪ ŋ
seats	s ɪ t s
second	s eɪ k ə n
seconds	s ɛ k ə n s
secrete	s ɪ k ɹ ɪ t
secretion	s ɪ k ɹ i ʃ ə n
section	s æ k ʃ ə n
sector	s ɛ k t ɹ
sectors	s ɛ k t ɝ s
see	s ɪ
see	z i
seed	s ɪ d
seeking	s ɪ k ɪ ŋ
selenium	s ɪ l ɪ n i ə m
seleucia	s ə l u s i ə
selling	s æ l ɪ ŋ
seminole	s ɛ m i n oʊ l
sena	s æ n ə
senator	s æ n ə t ɝ
senator	s ɛ n ə t ɔ
senators	s æ n ə t ɝ z
senegal	s æ n ə ɡ ə l
senegal	s ɛ n ɪ ɡ ə l
seng	s æ ŋ
seniority	s ɪ n j ɔ ɹ ɪ t i
sensual	s ɛ n s u ə l
sensuality	s ɛ n s u æ l ə t i
seoul	s ɔ l
separate	s ɛ p ɝ ə t
separatism	s ɛ p ɹ ə t ɪ z ə m
separatists	s ɛ p ɹ ə t ɪ s t s
sepulchre	s ɛ p ə l k ɝ
sequani	s ɪ k w ɑ n i
series	s i ɝ i z
series	s ɪ ɹ i s
series'	s ɪ ɹ i z
serve	s ɝ f
served	s ɝ f d
serves	s ɝ v s
service	s ɝ f ə s
service	s ɝ v i s
services	s ɝ f ə s ə s
services	s ɝ f ə s ə z
services	s ɝ v ə s ə s
sessions	s eɪ ʃ ə n z
set	s eɪ t
set	s æ t
sets	ʃ ɛ t s
setting	s ɛ t ɪ n
settled	s æ t ə l d
settler	s æ t l ɝ
settlers	s æ t l ə s
seven	s æ v ə n
severe	s ɪ v i ə
severn	s eɪ v ɝ n
severn	s ɛ v ə n
sex	s æ k s
shah	ʃ ə
shakespeare	ʃ eɪ k s p ɪ ɹ
shakespeare's	ʃ eɪ k s p ɪ ɹ z
shale	ʃ ɛ l
shales	ʃ ɛ l z
shankar	ʃ æ ŋ k ɑ ɹ
shape	s eɪ p
sharecropper	ʃ ɛ ɹ k ɹ ɑ p ɝ
shared	ʃ æ d
shareware	ʃ ɛ ɹ w ɛ ɹ
sharif	ʃ ɑ ɹ ɪ f
sharma	ʃ ɑ ɹ m ə
sharpton	ʃ ɑ ɹ p t ə n
shaun	ʃ oʊ n
shaw	s oʊ
shaw	ʃ oʊ
shawcross	ʃ oʊ k ɹ ɔ s
shawn	ʃ oʊ n
shawnee	ʃ oʊ n i
she	s i
she	s ɪ
she	ʃ ɪ
sheaths	ʃ i θ s
shed	ʃ æ d
sheets	s i t s
sheikhs	ʃ i k s
sheng	ʃ æ ŋ
shimon	ʃ ɪ m ə n
shinano	ʃ ɪ n ə n oʊ
shipping	ʃ ɪ p ɪ n
ships	ʃ i p s
shiraz	ʃ ɝ ə z
shire	ʃ aɪ ɝ
shires	ʃ aɪ ɝ z
shock	ʃ oʊ k
shonda	ʃ ɑ n d ə
shopping	ʃ ɑ p ɪ n
shore	ʃ oʊ
shorebird	ʃ ɔ ɹ b ɝ d
shores	ʃ oʊ z
shortcuts	ʃ ɔ ɹ t k ɑ t s
shortener	ʃ ɔ ɹ t ə n ɝ
shortfall	ʃ ɔ ɹ t f ɔ l
shot	ʃ ɔ t
shot	ʃ ʌ t
shotgun	ʃ ɑ t ɡ ə n
show	s oʊ
show	ʃ ɔ
shown	s oʊ n
shrek	ʃ ɹ æ k
shrine	s ɹ aɪ n
shrinking	s ɹ ɪ ŋ k ɪ ŋ
shropshire	ʃ ɹ ɑ p ʃ aɪ ɝ
shull	ʃ ə l
shut	ʃ ɑ t
siegmund	s ɪ ɡ m ə n d
sigismund	s ɪ ɡ i s m ə n d
signs	s aɪ n s
sikorski	s ɪ k ɔ ɹ s k i
silang	s ɪ l ə n
siloam	s ɪ l oʊ m
silos	s aɪ l oʊ s
silver	s ɪ l f ə
silvestri	s ɪ l v ɛ s t ɹ i
simi	s ɪ m i
sinaloa	s ɪ ŋ ə l ɔ ə
singapore	s ɪ n ə p ɔ
singapore	s ɪ ŋ ə p ɔ ɹ
singer	s ɪ n ə
singers	s ɪ ŋ ə s
singh	s ɪ n
sire	ʃ aɪ ɝ
sitcom	s ɪ t k ə m
sitting	s ɪ t i n
skiddaw	s k ɪ d oʊ
slaton	s l eɪ t ə n
sleeping	s l i p ɪ n
slessor	ʃ l ɛ s ɝ
slog	s l ʌ ɡ
slot	s l ɔ t
slovak	s l oʊ v ə k
slows	ʃ l oʊ z
smith	s m i t
smog	s m ʌ ɡ
smokin'	s m oʊ k ɪ ŋ
smoking	s m oʊ k ɪ n
snares	s n æ z
snowfall	s n oʊ f ɔ l
snowfalls	s n oʊ f ɔ l z
snuff	s n ɑ f
snyder	ʃ n aɪ d ɝ
so	s ɔ
so	ʃ oʊ
socalled	s oʊ k ɔ l d
soccer	s ʌ k ɝ
socinianism	s oʊ s ɪ n i ə n ɪ z ə m
sociologist	s oʊ ʃ i ɑ l ə dʒ ɪ s t
sociology	s oʊ ʃ i ɑ l ə dʒ i
sod	s ʌ d
software	s ɔ f t w ɛ
soh	s ɔ
solace	s ɔ l ə s
sombrero	s ʌ m b ɹ ɛ ɹ oʊ
some	s ɑ m
some	s ə m
some	ʃ ʌ m
somerville	s ʌ m ɝ f ɪ l
somethin'	s ʌ m θ ɪ ŋ
somme	s oʊ m
son	s ɔ n
sonatas	s ə n ɑ t ə z
song	s oʊ ŋ
song	s ɔ n
song	s ʌ n
song	s ʌ ŋ
song	ʃ oʊ ŋ
song	ʃ ɔ ŋ
songs	s oʊ n z
songs	s ɔ ŋ s
songs	s ʌ n z
sons	s ɔ ŋ z
sons	s ə n z
sons	s ʌ n s
sons'	s ʌ n z
soong	s u n
sophomoric	s ʌ f ə m ɔ ɹ ɪ k
sore	s oʊ
source	s ɔ z
sources	s ɔ s ɪ s
sources	s ɔ ʃ i z
southern	s ɑ ð ə n
southwold	s aʊ θ w ɔ l d
soviet	s oʊ v i eɪ t
soviets	s oʊ v i eɪ t s
spalls	s p oʊ l z
sparrows	s p æ ɹ oʊ z
spatial	s p ɛ ʃ ə l
spawning	s p oʊ n ɪ ŋ
speakeasy	s p i k i z i
spearheaded	s p ɪ ɹ h ɛ d ɪ d
special	s p eɪ ʃ ə l
species	s p i s ɪ z
species	s p i ʃ ɪ z
spectrometer	s p ɛ k t ɹ ɑ m ə t ɝ
spectroscopy	s p ɛ k t ɹ ə s k ə p i
specular	s p ɛ k j ə l ɝ
speedup	s p i d ʌ p
speedy	z p i d i
spherical	s f ɪ ɹ ɪ k ə l
spielberg	s p ɪ l b ɝ ɡ
spilsby	s p ɪ l z b i
spire	s p aɪ ɝ
spires	s p aɪ ɝ z
spitzer	s p ɪ t s ɝ
spofford	s p ɔ f ɝ d
spokane	s p oʊ k æ n
sport	s p ɑ t
sportier	s p ɔ ɹ t i ɝ
spouse's	s p aʊ s ɪ z
springfield	s p ɹ ɪ ŋ f ɪ l d
springsteen	s p ɹ ɪ ŋ s t i n
sprinkling	s p ɹ ɪ ŋ k ə l ɪ ŋ
spruill	s p ɹ u l
spurs	s p ɑ ɹ z
squad	s k w ɔ d
squall	s k w ɑ l
sri	ʃ ɹ i
sta	s t ɑ
stadion	s t æ d i ə n
staff	s t ʌ f
staging	s t eɪ dʒ i n
stain	s t eɪ ŋ
stalingrad	s t ɑ l ɪ ŋ ɡ ɹ æ d
stalled	s t oʊ l d
staller	s t ɑ l ɝ
stamps	s t ɛ m p s
stan	s t eɪ n
standards	s t æ n d ɝ d s
standin	s t æ n d ɪ ŋ
stang	s t æ n
stanislav	s t æ n i s l ɑ v
stars	s t ɔ z
startups	s t ɑ ɹ t ə p s
states	s t æ t s
statham	s t eɪ θ ə m
statin	s t æ t ɪ n
station	s t eɪ s ə n
station's	s t eɪ ʃ ə n s
stator	s t æ t ɝ
status	s t eɪ t ə s
steel	s t ɪ l
steele	s t ɪ l
steenrod	s t i n ɹ ɑ d
stefan	s t ɛ f ə n
stefano	s t ɛ f ɑ n oʊ
stengel	s t æ ŋ ɡ ə l
steno	s t æ n oʊ
stephanopoulos	s t ɛ f ə n ə p ə l ə s
stepmother	s t ɛ p m ʌ ð ɝ
stewards	s t u ɝ d s
stings	s t ɪ ŋ s
stitching	s t ɪ tʃ ɪ n
stitzer	s t ɪ t s ɝ
stock	s t ɔ k
stockard	s t ɑ k ɑ ɹ d
stocked	s t ɔ k t
stood	s t u d
stopped	s t ʌ p t
store	s t ɑ
stores	s t oʊ z
stores	s t ɔ ɹ s
stores	s t ɔ ɹ ʃ
storm	s t oʊ m
story	s t ɑ ɹ i
strachey	s t ɹ eɪ tʃ i
straw	s t ɹ oʊ
strayhorn	s t ɹ eɪ h ɔ ɹ n
streaked	s t ɹ ɪ k t
streep	s t ɹ i p
streetsville	s t ɹ i t s f ɪ l
stress	s t ɹ æ s
stretching	s t ɹ ɛ tʃ ɪ n
stretton	s t ɹ æ t ə n
stride	ʃ t ɹ aɪ d
strikes	ʃ t ɹ aɪ k s
stringed	s t ɹ ɪ ŋ d
strip	ʃ t ɹ ɪ p
striptease	s t ɹ ɪ p t i z
stromberg	s t ɹ ə m b ɝ ɡ
strong	ʃ t ɹ ʌ ŋ
stroup	s t ɹ u p
strub	s t ɹ ʌ b
strut	s t ɹ ɑ t
strutting	s t ɹ ɑ t ɪ ŋ
strychnine	s t ɹ ɪ k n ɪ n
stubbins	s t ɑ b ɪ n z
stud	s t ɑ d
studied	s t ɑ d ɪ d
studied	s t ʌ d ɪ d
study	s t ɑ d i
subaerial	s ə b ɛ ɹ i ə l
subatomic	s ʌ b ə t ɑ m ɪ k
subcontinent	s ʌ b k ɑ n t ə n ə n t
subcontracted	s ʌ b k ə n t ɹ æ k t ɪ d
subcontractor	s ʌ b k ə n t ɹ æ k t ɝ
subdominant	s ə b d ɑ m ə n ə n t
subgroup	s ə b ɡ ɹ u p
sublieutenant	s ʌ b l u t ɛ n ə n t
subsection	s ə b s ɛ k ʃ ə n
subsequent	s ə b s ə k w ə n t
subsequent	s ʌ b s i k w ə n t
subsequently	s ə b s ə k w ə n t l i
subset	s ə b s ɛ t
subsidies	s ə b s ɪ d i z
subspecies	s ə b s p i ʃ i z
subspecies	s ʌ b s p i s i z
substances	s ʌ b s t ə n s i z
substantiate	s ə b s t æ n s i eɪ t
substantive	s ə b s t ə n t ɪ v
substitution	s ʌ b s t ɪ t u ʃ ə n
subsystem	s ə b s ɪ s t ə m
subtitles	s ə b t aɪ t ə l z
subtropical	s ʌ b t ɹ ɑ p ɪ k ə l
suburb	s ə b ɝ b
suburban	s ʌ b ɝ b ə n
succeeded	s ə k s i d i d
sudan	s u d ə n
suffixes	s ə f ɪ k s ɪ z
sullivan	s ʌ l i v ə n
summit	s ɑ m ə t
sun	s ə n
sundance	s ʌ n d æ n z
sung	s ʌ n
superfund	s u p ɝ f ə n d
superlatively	s u p ɝ l ə t ɪ v l i
supermarket	s u p ɝ m ɑ ɹ k ə t
supplement	s ʌ p l ə m ɛ n t
suppressor	s ə p ɹ ɛ s ɝ
supremacist	s u p ɹ ɛ m ə s ɪ s t
sure	ʃ oʊ
surface	s ɝ v ə s
surfactant	s ɝ f ɛ k t ə n t
surrey	s ɔ ɹ i
surrounding	s ɝ aʊ n d ɪ n
sutton	s ɑ t ə n
swamped	s w ɑ m p t
swann	ʃ w ɑ n
sweetwater	s w i t w ɔ t ɝ
swimming	s w ɪ m ɪ n
swire	s w aɪ ɝ
swiss	s w i s
swithun's	s w ɪ ð ə n z
symmetrical	s ɑ m ɛ t ɹ ɪ k ə l
symposia	s ɪ m p oʊ z i ə
synagogue	s ɪ n ə ɡ oʊ ɡ
synagogues	s ɪ n ə ɡ oʊ ɡ z
synagogues	s ɪ n ə ɡ ɑ ɡ z
synchronicity	s ɪ ŋ k ɹ ə n ɪ s ɪ t i
synge	s ɪ n
synod	s ɪ n ɑ d
syntax	s ɪ n t ɛ k s
systemic	s ɪ s t æ m ɪ k
systems	s ɪ s t ə m s
tabari	t ə b ɑ ɹ i
tabriz	t ɛ b ɹ i z
tagalog	t æ ɡ ə l ɔ ɡ
tagalog	t ə ɡ ɑ l oʊ ɡ
taiwan	t aɪ w ə n
takes	t ɛ k s
taking	t eɪ k ɪ n
talbot	t oʊ l b ə t
talking	t oʊ k ɪ ŋ
tall	t oʊ l
tall	t ə l
talladega	t æ l ə d i ɡ ə
tallula	t ə l u l ə
talmud	t ɛ l m ʊ d
talmudic	t æ l m ɑ d ɪ k
tamara	t ə m ɑ ɹ ə
tamil	t ə m i l
tammany	t ɛ m ə n i
tampering	t ɛ m p ɝ ɪ ŋ
tanaka	t ə n ɑ k ə
tang	t æ n
tangier	t æ n dʒ ɪ ɹ
tankard	t æ ŋ k ɑ ɹ d
tantallon	t æ n t ə l ə n
tanzer	t ɛ n z ɝ
taoiseach	t i ʃ ɔ k
taras	t ɑ ɹ ə s
tarragona	t ɑ ɹ ə ɡ oʊ n ə
tasks	t ʌ s k s
tasmania	t æ s m eɪ n i ə
taste	t ɛ s t
taught	t oʊ t
taught	t ɑ t
taulas	t ɔ l ə s
tavern	t æ f ə n
taverners	t ɛ v ɝ n ɝ z
tax	t ɛ k s
taxing	t æ k s ɪ n
taxis	t æ k s ɪ z
taxon	t æ k s ə n
teacher	t ɪ tʃ ə
teachers	t i tʃ ə s
teaching	t i tʃ ɪ n
team	t ɪ m
teams	t ɪ m ʃ
tear	t ɛ ɹ
tearing	t ɪ ɹ ɪ ŋ
tech	t æ k
technical	t ɛ k n i k ə l
techno	t æ k n oʊ
technologies	t ɛ k n ɑ l ə dʒ ɪ s
teen	t ɪ n
teething	t i θ ɪ ŋ
tehran	t eɪ ɹ ə n
telecom	t ɛ l ə k ə m
teleportation	t æ l ə p ɔ ɹ t eɪ ʃ ə n
telescopic	t ɛ l ə s k ɑ p ɪ k
television	t ɛ l ə v ɪ ʃ ə n
television's	t ɛ l ə f ɪ ʒ ə n z
temperamental	t ɛ m p ɹ ə m ɛ n t ə l
temperamentally	t ɛ m p ɹ ə m ɛ n ə l i
temperature	t ɛ m p ɝ ə tʃ ɝ
temporal	t ɛ m p ɹ ə l
tempore	t ɛ m p ɔ ɹ i
ten	t æ n
tend	t eɪ n d
tendencies	t ɛ n d ə n s ɪ z
tendons	t ɛ n d ə n s
tengo	t ɛ n ɡ oʊ
tennis	t ɛ n ə z
tensor	t æ n s ə
tensor	t ɛ n s ɝ
tent	t æ n t
teos	t i oʊ s
terminology	t ɝ m ə n ɑ l ə dʒ i
terral	t ɛ ɹ ə l
terre	t ɛ ɹ ə
terri	t ɛ ɹ i
terror	t ɛ ɹ
test	t æ s t
tested	t eɪ s t ɪ d
testing	t ɛ s t ɪ n
tetra	t ɛ t ɹ ə
tetrahedral	t ɛ t ɹ ə h i d ɹ ə l
teutonic	t u t ɑ n ɪ k
tex	t æ k s
text	t æ k s t
tha	θ ɑ
thasos	t eɪ s oʊ s
that	ð ɔ t
that	θ æ t
thats	ð æ t s
the	ð
the	θ i
the	θ ɑ
the	θ ə
the	θ ɪ
theatre	θ i ə t ɹ
their	ð æ ɹ
their	θ ɛ ɹ
them	θ ə m
theme	θ ɪ m
then	ð æ n
theocracy	θ i ə k ɹ ə s i
theorem	θ i ɝ ə m
theorem	θ i ɹ ə m
theorems	θ i ɝ ə m z
theory	θ i ɹ i
theory	θ ɪ ɝ i
therapeutically	θ ɛ ɹ ə p j u t ɪ k l i
therapies	θ ɛ ɹ ə p i z
therapists	θ ɛ ɹ ə p ɪ s t s
there	ð eɪ
there	ð eɪ ɹ
there	ð æ
there	ð æ ɹ
there	ð ɛ
there	ð ɛ ɝ
there's	ð ɛ ɹ s
theresa	t ɝ i z ə
thermometer	θ ɝ m ɑ m ɪ t ɝ
these	ð i s
these	ð ɪ s
these	ð ɪ z
these	θ i s
these	θ ɪ z
thessaloniki	θ ɛ s ə l ɑ n ɪ k i
they	ð æ
they	ð ɛ
they're	ð eɪ ɹ
thicke	θ i k
things	θ ɪ ŋ s
thinking	θ ɪ ŋ k ɪ n
thirteen	t ɑ ɹ t i n
this	t ɪ z
this	ð i s
this	ð i z
this	ð ɪ ʃ
this	ð ʌ s
this	θ ɪ s
thomasina	t ɑ m ə s i n ə
thoroughfares	t ɑ ɹ oʊ f ɛ ɹ z
thoth	θ ɔ θ
threading	θ ɹ ɛ d ɪ n
threat	θ ɹ æ t
threshed	θ ɹ æ ʃ t
thriving	θ ɹ aɪ v i ŋ
throwing	θ ɹ oʊ ɪ n
thunderbolt	θ ʌ n d ɝ b oʊ l t
thunderbolts	θ ʌ n d ɝ b oʊ l t s
thursley	θ ɝ z l i
thus	θ ʌ s
thwarted	θ w ɔ ɹ t ɪ d
tibet	t ɪ b ɛ t
tier	t i ə
tiers	t ɪ ɹ z
tigger	t ɪ ɡ ɝ
tigre	t i ɡ ɹ
tik	t ɪ k
tillamook	t ɪ l ə m u k
timing	t aɪ m ɪ n
timmons	t ɪ m ə n s
tinsley	t ɪ n z l i
tithe	t aɪ θ
titles	t aɪ t ə l s
tiviot	t i v i ə t
to	t i
to	t ɑ
to	t ɔ
to	t ʌ
toc	t ɔ k
toch	t ɔ k
todd	t ɔ d
toffler	t ɑ f l ɝ
toft	t ɔ f t
tofts	t ɔ f t s
tok	t ɔ k
tom	t ʌ m
toms	t ʌ m z
tongue	t ɑ ŋ
tongue	t ʌ n
tons	t ɑ n z
took	t u k
tooting	t u t i n
top	t oʊ p
top	t ʌ p
topeka	t ɑ p i k ə
topmost	t ɑ p m oʊ s t
topography	t ə p ə ɡ ɹ ə f i
topology	t ɑ p ɑ l ə dʒ i
topper	t ɑ p ə
tornatore	t ɔ ɹ n ə t ɔ ɹ i
torrance	t ɑ ɹ ə n s
torre	t ɔ ɹ
torrens	t ɔ ɹ ə n s
torrington	t ɑ ɹ ɪ ŋ t ə n
torsion	t oʊ ʃ ə n
torsion	t ɔ ʒ ə n
torus	t ɔ ɹ ə z
total	t ɔ t ə l
tottenham	t ʌ t ə n ə m
totter	t ɔ t ɝ
touch	t ɑ tʃ
tough	t ɔ f
toulon	t u l ə n
tour	t oʊ
tour	t ɔ
touring	t ɔ ɹ ɪ n
tourism	t ʊ ɝ ɪ z ə m
tourist	t ʊ ɹ ə s t
tours	t u ɹ z
tours	t ɔ ɹ z
townsley	t aʊ n z l i
toynbee	t ɔɪ ŋ b i
tracers	t ɹ eɪ s ɝ s
trachea	t ɹ æ k i ə
traer	t ɹ eɪ ɝ
trainee	t ɹ eɪ n ɪ
training	t ɹ eɪ n ɪ n
trains	t ɹ æ n s
tralee	t ɹ ɛ l i
trance	t ɹ ɑ n z
trang	t ɹ æ ŋ
transaction	t ɹ æ n s æ k ʃ ə n
transcendental	t ɹ æ n s ə n d ɛ n ə l
transducer	t ɹ æ n z d u s ɝ
transducers	t ɹ æ n z d u s ɝ z
transected	t ɹ æ n s ɛ k t ɪ d
transfer	t ɹ æ n s f ɔ ɹ
transformation	t ɹ æ n s f ɔ ɹ m eɪ ʃ ə n
transfusions	t ɹ æ n s f j u ʒ ə n z
transgender	t ɹ æ n z dʒ ɛ n d ɝ
transitioning	t ɹ æ n z ɪ ʃ ə n ɪ ŋ
translates	t ɹ æ n s l eɪ t s
translation	t ɹ æ n s l eɪ ʃ ə n
transliterated	t ɹ æ n z l ɪ t ɝ eɪ t ɪ d
transliteration	t ɹ æ n z l ɪ t ɝ eɪ ʃ ə n
transmedia	t ɹ æ n z m i d i ə
transmissible	t ɹ æ n z m ɪ s ə b ə l
transmits	t ɹ æ n s m ɪ t s
transmitter	t ɹ æ n z m ɪ t ɝ
transmitters	t ɹ æ n z m ɪ t ɝ z
transmitting	t ɹ æ n z m ɪ t ɪ n
transmitting	t ɹ æ n z m ɪ t ɪ ŋ
transnistria	t ɹ æ n s n ɪ s t ɹ i ə
transplantation	t ɹ æ n s p l æ n t eɪ ʃ ə n
transponders	t ɹ æ n s p ɑ n d ɝ z
transport	t ɹ æ n s p ɑ t
transport	t ɹ æ n s p ɔ t
transportation	t ɹ æ n s p ɔ ɹ t eɪ ʃ ə n
transrapid	t ɹ æ n z ɹ æ p ɪ d
transverse	t ɹ æ n z v ɝ z
trauma	t ɹ oʊ m ə
trauma	t ɹ ɑ m ə
traumatic	t ɹ oʊ m æ t ɪ k
traumatic	t ɹ ə m æ t ɪ k
travers	t ɹ æ v ɝ s
treanor	t ɹ ɪ n ɝ
treatise	t ɹ i t i z
treble	t ɹ æ b ə l
trek	t ɹ æ k
trekkers	t ɹ æ k ɝ z
treks	t ɹ æ k s
trelawny	t ɹ ə l oʊ n i
trend	t ɹ eɪ n d
trends	t ɹ æ n d z
trends	t ɹ ɛ n z
tresco	t ɹ æ s k oʊ
trevelyan	t ɹ ə v eɪ l j ə n
tricia	t ɹ ɪ ʃ ə
trinidad	t ɹ ɪ n i d æ d
trish	t ɹ ɪ ʃ
tritium	t ɹ ɪ t i ə m
triumphs	t ɹ aɪ ʌ m f s
trombone	t ɹ ə m b oʊ n
trombone	t ɹ ʌ m b oʊ n
troops	t ɹ u p z
trot	t ɹ ɔ t
troubling	t ɹ ʌ b l ɪ ŋ
trowbridge	t ɹ ɔ b ɹ ɪ dʒ
truck	t ɹ ɑ k
trucking	t ɹ ʌ k ɪ n
trueman	t ɹ u m ə n
trump's	t ɹ ʌ m p s
truncated	t ɹ ə ŋ k eɪ t ɪ d
tsar	s ɑ
tuan	t u ə n
tuas	t u ə s
tucker	t ɑ k ə
tuckers	t ɔ k ɝ z
tucson	t u s ɔ n
tucson	t u s ə n
tully's	t ɑ l i z
tumultuous	t u m ə l tʃ u ə s
tun	t u n
tuns	t ɑ n z
tunstall	t ɑ n s t ə l
tunstall	t ʌ n s t ɔ l
tupac	t u p ʌ k
turkey's	t ɝ k ɪ s
turkeys	t ɑ ɹ k i z
tussle	t ɑ s ə l
tutte	t ʊ t
two	t ʊ
types	t aɪ p z
tyres	t aɪ ɝ z
tyrol	t aɪ ɹ oʊ l
tyrol	t aɪ ɹ ə l
u	ə
ulster	ɔ l s t ɝ
ultimately	ɔ l t ə m ə t l i
ultrasonic	ʌ l t ɹ ə s ə n ɪ k
umbrellas	ə m b ɹ ɛ l ə z
unaffected	ʌ n ə f ɛ k t ɪ d
unauthorised	ʌ n ɔ θ ɝ aɪ z d
unbolted	ə n b oʊ l t ɪ d
uncollected	ʌ n k ə l ɛ k t ɪ d
uncomfortable	ə n k ʌ m f t ə b ə l
uncomplicated	ʌ n k ɑ m p l ə k eɪ t ɪ d
uncompromising	ʌ n k ɑ m p ɹ ə m aɪ z ɪ ŋ
uncontacted	ə n k ə n t æ k t ɪ d
uncontacted	ʌ n k ə n t ɛ k t ɪ d
uncontrolled	ə n k ə n t ɹ oʊ l d
under	ɔ n d ɝ
under	ə n d ɝ
undercuts	ʌ n d ɝ k ʌ t s
underfunded	ʌ n d ɝ f ʌ n d ɪ d
undisclosed	ə n d ɪ s k l oʊ z d
unearthed	ʌ n ɝ θ t
unearthly	ɔ n ɝ θ l i
unemployed	ʌ n ɪ m p l ɔɪ d
unemployment	ʌ n ɪ m p l ɔɪ m ə n t
unenthusiastic	ʌ n ɪ n θ u z i æ s t ɪ k
unequalled	ʌ n i k w ə l d
uneventful	ʌ n ɪ v ɛ n t f ə l
uneventfully	ʌ n ɪ v ɛ n t f ə l i
unfermented	ʌ n f ɝ m ɛ n t ɪ d
ungodly	ə n ɡ ɑ d l i
ungrammatical	ʌ n ɡ ɹ ə m æ t ɪ k ə l
unhealthy	ɔ n h ɛ l θ i
unicode	j u n i k oʊ d
unicorn	j u n ɪ k ə n
unintentionally	ʌ n ɪ n t ɛ n ʃ ə n ə l i
uninterested	ʌ n ɪ n t ɹ ɪ s t ɪ d
uninvolved	ʌ n ɪ n v ɑ l v d
unique	j u n ɪ k
unitary	j u n ɪ t eɪ ɹ i
universal	j u n ə f ɝ s ə l
universe	j u n ə f ɝ s
university's	j u n ə v ɝ s ə t ɪ s
unlike	ɔ n l aɪ k
unlined	ɔ n l aɪ n d
unoccupied	ʌ n ɑ k j ə p aɪ d
unpolished	ə n p ɑ l ɪ ʃ t
unpolite	ə n p ə l aɪ t
unproved	ʌ n p ɹ u v d
unrealistic	ə n ɹ i l ɪ s t ɪ k
unrecoverable	ə n ɹ ɪ k ʌ v ɹ ə b ə l
unreformed	ʌ n ɹ ɪ f ɔ ɹ m d
unrelated	ə n ɹ i l eɪ t ɪ d
unreleased	ʌ n ɹ i l i s t
unrepentant	ʌ n ɹ ɪ p ɛ n t ə n t
unresolved	ə n ɹ i z ʌ l v d
unresolved	ʌ n ɹ i z ɑ l v d
unresponsive	ʌ n ɹ ɪ s p ɑ n s ɪ v
unrestricted	ʌ n ɹ i s t ɹ ɪ k t ɪ d
unseen	ə n s ɪ ŋ
unsubstantiated	ʌ n s ə b s t æ n ʃ i eɪ t ɪ d
unsure	ɔ n ʃ ʊ ɹ
unwanted	ə n w oʊ n t ɪ d
unwanted	ə n w ɑ n t ɪ d
up	ɔ p
upend	ə p ɛ n d
upgrade	ə p ɡ ɹ eɪ d
upheavals	ʌ p h i v ə l z
uphold	ʌ p h oʊ l d
upjohn	ʌ p dʒ ə n
upperville	ɑ p ɝ v ɪ l
uppsala	u p s ɑ l ə
upson	ɑ p s ə n
urban	ɔ ɹ b ə n
urbana	ɝ b eɪ n ə
urdaneta	ɔ ɹ d ə n ɛ t ə
urdu	ɔ ɹ d u
urine	j u ɹ ə n
us	ɑ s
usable	j u s ə b ə l
used	j u s d
useful	j u s f ɔ l
user	j u s ɝ
uses	j u s i z
uses	j u s ɪ s
using	j u s ɪ ŋ
using	j u z ɪ n
utah	j u t ə
uzbek	u s b ɛ k
vaccine	v æ k s ɪ n
vaginal	f æ dʒ ə n ə l
vagrant	v æ ɡ ɹ ə n t
vaishnavism	v æ ʃ n ə v ɪ z ə m
valdosta	v æ l d ʌ s t ə
valentia	v ə l ɛ n ʃ ə
valenza	v ə l ɛ n s ə
valeria	v ə l ɪ ɹ i ə
vampire	v æ m p aɪ ɝ
vampires	v æ m p aɪ ɝ z
vampires	v ɛ m p aɪ ɝ z
vance	v æ n z
vanderbilt	v ɛ n d ɝ b ɪ l t
varicose	v ɛ ɹ ə k oʊ z
variety	f ɝ aɪ ə t i
various	v eɪ ɹ i ə s
various	v ɛ ɹ i ə z
vasari	v ə s ɑ ɹ i
vase	v eɪ z
vassal	v ɛ s ə l
vastus	f ɛ s t ə s
vaud	v ɔ d
vaudeville	v oʊ d ə v ɪ l
vault	v oʊ l t
vaulting	v oʊ l t ɪ ŋ
vaux	v oʊ k s
vectors	f æ k t ɝ z
vedic	v ɛ d ɪ k
veer	v i ə
vegan	v eɪ ɡ ə n
vegan	v ɪ ɡ ə n
vehicular	v ɪ h ɪ k j ə l ɝ
velveeta	v æ l v i t ə
venetian	v ə n ɪ ʃ ə n
venezuela	v ɛ n ɪ s w eɪ l ə
venue	v eɪ n u
venue	v æ n j u
veracruz	v ɛ ɹ ə k ɹ u z
vermont	v ɝ m ə n t
verse	f ɝ s
versicolor	v ɝ s ə k ə l ɝ
version	f ɝ ʃ ə n
version	f ɝ ʒ ə n
version	v ɝ s ə n
versions	v ɝ ʃ ə n z
vertical	f ɝ t ɪ k ə l
vesey	v eɪ z i
vesicles	v ɛ s ɪ k ə l z
vessels	v æ s ə l z
vestas	f ɛ s t ə s
veteran	v æ t ɝ ə n
veterans'	v ɛ t ɹ ə n z
viaduct	v aɪ ə d ʌ k t
vibrato	v ɪ b ɹ ɑ t oʊ
victory	f ɪ k t ɝ i
video	v i d i oʊ
vietnam	v i ɛ t n ə m
viewer	f j u ɝ
vigour	v ɪ ɡ ɝ
viking	v aɪ k ɪ n
vikings	v aɪ k i n z
vikings	v aɪ k ɪ n z
villena	v ɪ l eɪ n ə
vincenzo	v ɪ n tʃ ɛ n z oʊ
vineyard	v ɪ n j ɑ ɹ d
vineyards	v ɪ n j ɑ ɹ d z
vinyard	v ɪ n j ɑ ɹ d
viruses	v aɪ ɹ ə s ɪ s
visby	v ɪ z b i
vise	v aɪ z
visibility	v ɪ s ə b ɪ l ɪ t i
vistas	v i s t ə s
visual	f ɪ ʒ u ə l
visual	v ɪ ʃ u ə l
visual	v ɪ ʃ ə l
visually	v ɪ ʃ u ə l i
visum	v ɪ z ə m
viz	v ɪ z
voila	v w ɑ l ə
voles	v ɔ l z
volga	v ʌ l ɡ ə
volleyball	f ɑ l i b ɔ l
volleyball	v ɑ l i b ə l
volleyball	v ɑ l ɪ b ə l
volta	v oʊ l t ɑ
volts	v ɔ l t s
von	f ɑ n
von	v ɑ n
voting	v oʊ t i ŋ
voting	v oʊ t ɪ n
vs	v ɝ s ə s
vuk	v ʌ k
wagner	v ɑ ɡ n ɝ
wales	w eɪ l s
wales	w ɛ l z
wall	w oʊ l
wallabies	w ɔ l ə b i z
walled	w oʊ l d
wallingford	w ɑ l ɪ ŋ f ɝ d
wallington	w ɑ l ɪ ŋ t ə n
wallis	w ɑ l ɪ ʃ
wally	w ɑ l i
walsingham	w ɔ l ʃ ɪ ŋ h æ m
waltrip	w ɔ l t ɹ ɪ p
wan	w ʌ n
wander	w ʌ n d ɝ
wanderers	w ʌ n d ɝ z
wandering	w ʌ n d ɝ ɪ ŋ
want	w oʊ n t
wanting	w ɔ n t ɪ ŋ
waratah	w ɑ ɹ ə t ə
ward	w ɑ d
warred	w ɔ ɹ d
warrington	w ɑ ɹ ɪ ŋ t ə n
warriors	w ɔ ɹ i ɝ z
warriston	w ɔ ɹ ɪ s t ə n
wars	w ɑ z
warsaw	w ɑ ʃ ɔ
warsaw	w ɔ s oʊ
warsaw	w ɔ ɹ s oʊ
warsaw	w ɔ ɹ s ə
warsaw	w ʌ s ə
was	w ɑ s
was	w ɔ s
was	w ʌ s
washita	w ə ʃ i t ə
wassmuss	w ɑ s m ə s
wat	w ɑ t
watershed	w ɔ t ɝ ʃ æ d
watford	w ɑ t f ɝ d
wath	w ʌ t
watkins	w ɔ t k ɪ n z
watrous	w ɑ t ɹ ə s
watson	w ʌ t s ə n
watson's	w ɔ t s ə n z
wausau	w ɑ s ə
wayne	w ɛ n
we	w ɪ
we're	w ɛ ɹ
weathersby	w ɛ ð ɝ z b i
weber	w eɪ b ɝ
weber	w æ b ɝ
weiss	w aɪ z
well	w eɪ l
wenceslaus	w ɛ n s ə s l ə s
wesleyan	w ɛ s l i ə n
what	h w ɔ t
whatley	w ɑ t l i
whats	w ʌ t s
wheel	w ɪ l
wheels	w ɪ l z
wheelwright	w ɪ l ɹ aɪ t
when	w æ n
where	w ɛ ɹ
where'd	w ɛ ɹ d
whereas	w ɛ ɹ æ z
wherever	w ɛ ɹ ɛ v ɝ
whichever	w ɪ tʃ ɛ v ɝ
whipping	w ɪ p ɪ n
whitefield	h w aɪ t f ɪ l d
whitehall	h w aɪ t h oʊ l
whitehall	h w aɪ t h ə l
whitty	w ɪ t ɪ
wholly	h ɔ l i
wichita	w ɪ tʃ ə t ɑ
wichita	w ɪ tʃ ə t ə
wife	w aɪ v
wilfried	w ɪ l f ɹ ɪ d
will	w i l
willard	w ɪ l ɑ ɹ d
williamsport	w ɪ l j ə m z p ɔ ɹ t
willsie	w ɪ l z i
wind	w ɪ ŋ d
windsor	w ɪ n s ɝ
winfrey	w ɪ n f ɹ i
wingate	w ɪ ŋ ɡ eɪ t
winning	w ɪ n ɪ n
winship	w ɪ n s ɪ p
winslow	w ɪ n z l oʊ
winterbourne	w ɪ n t ɝ b ɔ ɹ n
winthrop	w ɪ n θ ɹ ɑ p
winthrop	w ɪ n θ ɹ ɔ p
wire	w aɪ ɝ
wires	w aɪ ɝ z
with	w i v
with	w i θ
with	w ɑ θ
with	w ɔ θ
with	w ʌ θ
wobble	w ɔ b ə l
wofford	w ɔ f ɝ d
wok	w ɔ k
wolcott	w ɔ l k ɑ t
wold	w ɔ l d
wollman	w ɔ l m ə n
wolverhampton	w ʊ l f ɝ h æ m p t ə n
wolves	w ʊ l v s
woman	w u m ə n
wombat	w ʌ m b æ t
won	w ɔ n
wonder	w ɑ n d ɝ
wong	w ɔ n
wong	w ə ŋ
wong	w ʌ ŋ
woodhall	w ʊ d h ə l
woodroffe	w ʊ d ɹ ɔ f
woofter	w ʊ f t ɝ
woolston	w u l s t ə n
wooster	w ʊ s t ɝ
worcestershire	w ɪ s t ɝ ʃ ɪ ɹ
worcestershire	w ʊ s t ɝ ʃ ɝ
wording	w ɔ ɹ d ɪ ŋ
words	w ɔ ɹ d z
work	w ɑ k
work	w ʌ k
working	w ɝ k ɪ n
worn	w ʌ n
worsley's	w ɝ z l i z
wortley	w ɔ ɹ t l i
wrap	ɹ ɛ p
wreaks	ɹ ɪ k s
wrestler	ɹ æ s l ɝ
wrestler	ɹ ɛ s l ɝ
wrestlers	ɹ ɛ s l ɝ z
writing	ɹ aɪ t ɪ n
wrong	ɹ oʊ n
wrong	ɹ ʌ ŋ
wrote	ɹ ɔ t
wu	w ʊ
wyre	w aɪ ɝ
x	æ k s
xavier	z eɪ v i ə
xenon	z ɛ n ɑ n
xerox	z ɪ ɹ ɑ k s
xerox	z ɪ ɹ ə k s
xining	s ɪ n ɪ ŋ
xtra	ɛ k s t ɹ ə
yah	j ə
yamaha	j ɑ m ə h ə
yamato	j ə m ɑ t oʊ
yandex	j æ n d æ k s
yang	j æ n
yangtze	j æ n s i
yangtze	j æ ŋ s i
yasuda	j ə s u d ə
yeah	j ɛ
yemen	j eɪ m ə n
yemen	j æ m ə n
yemeni	j eɪ m ə n i
yemeni	j æ m ə n i
yet	j æ t
yon's	j ɑ n z
yorkshire	j ɔ ɹ k ʃ ɝ
you	j ʊ
you're	j ʊ ɹ
young	j ʌ n
younger	j ʌ ŋ ɡ ɝ
youngstown	j ʌ ŋ s t aʊ n
your	j oʊ
your	j u ɹ
youre	j u ɹ
yours	j ʊ ɹ z
yvonne	i v ɑ n
yvonne	i v ə n
z	s eɪ d
zabel	z eɪ b ə l
zamindar	z ə m ɪ n d ə
zanesville	s eɪ n z v ɪ l
zanzibar	s æ n z ə b ɑ ɹ
zanzibar	z æ n s ə b ɑ ɹ
zapata	s ə p ɑ t ə
zapote	s ə p oʊ t
zavala	z ə v ɑ l ə
zealand	s i l ə n d
zeckendorf	z ɛ k ə n d ɔ ɹ f
zeeman	s i m ə n
zen	s æ n
zeng	s æ ŋ
zeppelin	z ɛ p l ɪ ŋ
zethus	s i t ə s
zhang	z æ n
zhang	z æ ŋ
zimbabwe	s ɪ m b ɑ b w eɪ
zombie	s ɑ m b i
zones	z oʊ n s
zoo	s u
zun	z u n
