1/2	h ˈɑ f
10	t ˈɛ n
160	w ˈʌ n h ˈʌ n d ɹ ɪ d ˈæ n d s ˈɪ k s t i
200	t ˈu h ˈʌ n d ɹ ɪ d
24	t w ˈɛ n t i f ˈɔ ɹ
3/4	θ ɹ i k w ɔ t ə z
5000	f ˈa ɪ v θ ˈa ʊ z ə n d
6	s ˈɪ k s
PA's	p ˈɑ z
TRUE	t ɹ ˈu
a	ə
a-i	ˈe ɪ ˈa ɪ
a-l	ˈe ɪ ˈɛ l
a-u	ˈe ɪ j ˈu
a-u-g-h	ˈe ɪ j ˈu d͡ʒ ˈi ˈe ɪ t͡ʃ
a-w	ˈe ɪ d ˈʌ b ə l j ˌu
a-y	ˈe ɪ w ˈa ɪ
aah	ˈɑ
aback	ə b ˈæ k
abandoned	ə b ˈæ n d ə n d
abdul	æ b d ˈu l
abi	ə b i
abi's	ə b i z
abilities	ə b ɪ l ə t ˌi z
abis	ˈæ b i z
able	ˈe ɪ b ə l
aboard	ə b ˈɔ ɹ d
abomination	ə b ˌɑ m ə n ˈe ɪ ʃ ə n
abound	ə b ˈa ʊ n d
about	ə b ˈa ʊ t
abouts	ə b ˌa ʊ t s
above	ə b ˈʌ v
abruptly	ə b ɹ ˈʌ p t l i
absent	æ b s ˈɛ n t
absent	ˈæ b s ə n t
absolute	ˈæ b s ə l ˌu t
absolutely	ˌæ b s ə l ˈu t l i
absorbed	ə b s ɔ b d
abuse	ə b j ˈu s
abuse	ə b j ˈu z
abuses	ə b j ˈu z ɪ z
abuses	ə b j ˈu s ɪ z
accent	æ k s ə n t
accept	æ k s ˈɛ p t
accepted	æ k s ˈɛ p t ɪ d
accepts	æ k s ˈɛ p t s
access	ˈæ k s ˌɛ s
accessing	ˈæ k s ˌɛ s ɪ ŋ
accident	ˈæ k s ə d ə n t
accidentally	ˌæ k s ə d ˈɛ n t ə l l i
accidents	ˈæ k s ə d ə n t s
accomplish	ə k ˈɑ m p l ɪ ʃ
according	ə k ˈɔ ɹ d ɪ ŋ
account	ə k ˈa ʊ n t
accounts	ə k ˈa ʊ n t s
accurate	ˈæ k j ˈu ɹ ɪ t
accusation	ˌæ k j u z ˈe ɪ ʃ ə n
ache	ˈe ɪ k
ached	ˈe ɪ k t
achievement	ə t͡ʃ ˈi v m ə n t
achievements	ə t͡ʃ ˈi v m ə n t s
achoo	æ t͡ʃ u
acorn	ˈe ɪ k ɔ ɹ n
acorns	ˈe ɪ k ɔ ɹ n z
across	ə k ɹ ˈɔ s
act	ˈæ k t
acted	ˈæ k t ɪ d
acting	ˈæ k t ɪ ŋ
action	ˈæ k ʃ ə n
actions	ˈæ k ʃ ə n z
activate	ˈæ k t ɪ v ˌe ɪ t
activation	ˌæ k t ɪ v ˈe ɪ ʃ ə n
active	ˈæ k t ɪ v
activity	æ k t ˈɪ v ɪ t i
acts	ˈæ k t s
actual	ˈæ k t͡ʃ u ə l
actually	ˈæ k t͡ʃ u ə l l i
ada	ˈe ɪ d ə
ada's	ˈe ɪ d ə z
adas	ˈe ɪ d ə z
add	ˈæ d
added	ˈæ d d ɪ d
addict	ˈæ d d ˌɪ k t
addict	ə d d ˈɪ k t
addicts	ə d d ˈɪ k t s
addicts	ˈæ d d ˌɪ k t s
adding	ˈæ d ɪ ŋ
addition	ˌɑ d i ʃ ə n
additionally	ə d ɪ ʃ ə n l i
address	ˈæ d d ɹ ˌɛ s
adds	ˈæ d z
adjust	ə d͡ʒ ˈʌ s t
adjusted	ə d͡ʒ ˈʌ s t ɪ d
admired	ə d m ˈa ɪ ɚ d
admit	ə d m ˈɪ t
admits	ə d m ˈɪ t s
admittance	ə d m ˈɪ t t ə n s
admitted	æ d m ˈɪ t ɪ d
adobe	ə d ˈo ʊ b i
adorable	ə d ˈɔ ɹ ə b ə l
adult	ə d ˈʌ l t
adults	ə d ˈʌ l t s
advance	ə d v ˈæ n s
adventure	æ d v ˈɛ n t͡ʃ ɚ
adventures	æ d v ˈɛ n t͡ʃ ɚ z
adventurous	æ d v ˈɛ n t͡ʃ ɚ ɹ ə s
advice	æ d v ˈa ɪ s
advise	æ d v ˈa ɪ z
advocate	ˈæ d v ə k ˌe ɪ t
advocate	ˈæ d v ə k ɪ t
advocates	ˈæ d v ə k ˌe ɪ t s
advocates	ˈæ d v ə k ɪ t s
aeon	ˈi ˌo ʊ n
afar	ə f ˈɑ ɹ
affect	ˈæ f f ɛ k t
affect	ə f ˈɛ k t
affected	ə f ˈɛ k t ɪ d
affection	ə f ˈɛ k ʃ ə n
affects	ə f ˈɛ k t s
affinity	ə f ˈɪ n ɪ t i
affix	ˈæ f f ɪ k s
affix	ə f f ˈɪ k s
affixes	ˈæ f f ɪ k s ɪ z
affixes	ə f f ˈɪ k s ɪ z
afford	ə f ˈɔ ɹ d
afforded	ə f ˈɔ ɹ d ɪ d
afoot	ə f ˈʊ t
afraid	ə f ɹ ˈe ɪ d
africa	ˈæ f ɹ ɪ k ə
african	ˈæ f ɹ ɪ k ə n
after	ˈæ f t ɚ
afterglow	ˈæ f t ɚ ɡ l o ʊ
afternoon	ˌæ f t ɚ n ˈu n
afternoons	ˌæ f t ɚ n ˈu n z
aftertaste	ˈæ f t ɚ t ˌe ɪ s t
afterthought	ˈæ f t ɚ θ ˌɔ t
again	ə ɡ ˈɛ n
against	ə ɡ ˈɛ n s t
agar	ˈe ɪ ɡ ɚ
age	ˈe ɪ d͡ʒ
aged	ˈe ɪ d͡ʒ d
ages	ˈe ɪ d͡ʒ ɪ z
agglomerate	ə ɡ ɡ l ˈɑ m ɚ ɪ t
agglomerate	ə ɡ ɡ l ˈɑ m ɚ ˌe ɪ t
aggregate	ˈæ ɡ ɡ ɹ ə ɡ ˌe ɪ t
aggregate	ˈæ ɡ ɡ ɹ ə ɡ ɪ t
aggregates	ˈæ ɡ ɡ ɹ ə ɡ ɪ t s
aggregates	ˈæ ɡ ɡ ɹ ə ɡ ˌe ɪ t s
aggressive	ə ɡ ɹ ˈɛ s ɪ v
agile	ˈæ d͡ʒ a ɪ l
agitated	ˌæ d͡ʒ ˈɪ t ˈe ɪ t ə d
ago	ə ɡ ˈo ʊ
agree	ə ɡ ɹ ˈi
agreed	ə ɡ ɹ ˈi d
agreement	ə ɡ ɹ ˈi m ə n t
agreements	ə ɡ ɹ ˈi m ə n t s
agrees	ə ɡ ɹ ˈi z
ah	ˈɑ
aha	ˌɑ h ˈɑ
ahead	ə h ˈɛ d
aid	ˈe ɪ d
aidan	ˈe ɪ d ə n
aim	ˈe ɪ m
aimed	ˈe ɪ m d
aimless	ˈe ɪ m l ə s
aims	ˈe ɪ m z
air	ˈɛ ɹ
airplane	ˈɛ ɹ p l ˌe ɪ n
airplanes	ˈɛ ɹ p l e ɪ n z
airport	ˈɛ ɹ p ˌɔ ɹ t
aisle	ˈa ɪ l
aisles	ˈa ɪ l z
alarm	ə l ˈɑ ɹ m
alas	ə l ˈæ s
albeit	ɔ l b ˈi ɪ t
alert	ə l ˈɚ t
alex	ˈæ l ɪ k s
alex's	ˈæ l ɪ k s ɪ z
alexs	æ l ɛ k s ə z
algae	ˈæ l d͡ʒ i
alice	ˈæ l ɪ s
alice's	ˈæ l ɪ s ɪ z
alien	ˈe ɪ l i ə n
alighted	ˈæ l ˈa ɪ t ɪ d
align	ə l ˈa ɪ n
aligning	ə l ˈa ɪ n ɪ ŋ
alike	ə l ˈa ɪ k
alive	ə l ˈa ɪ v
all	ˈɔ l
allergic	ə l ˈɚ d͡ʒ ɪ k
alley	ˈæ l i
allie	ˈæ l l ˈi
allie's	ˈæ l l ˈi z
allies	ˈæ l a ɪ z
allies	ˈæ l l a ɪ z
allies	ə l l ˈa ɪ z
alligator	ˈæ l ə ɡ ˌe ɪ t ɚ
allow	ə l ˈa ʊ
allowance	ə l ˈa ʊ ə n s
allowed	ə l ˈa ʊ d
allowing	ə l a ʊ ɪ ŋ
allows	ə l ˈa ʊ z
ally	ˈæ l l a ɪ
ally	ə l l ˈa ɪ
almighty	ɔ l m ˈa ɪ t i
almost	ˈɔ l m ˌo ʊ s t
alone	ə l ˈo ʊ n
along	ə l ˈɔ ŋ
alongside	ə l ˈɔ ŋ s ˈa ɪ d
aloud	ə l ˈa ʊ d
already	ɔ l ɹ ˈɛ d i
alright	ˌɔ l ɹ ˈa ɪ t
also	ˈɔ l s o ʊ
alternate	ˈɔ l t ɚ n ˌe ɪ t
alternate	ˈɔ l t ɚ n ɪ t
although	ɔ l ð ˈo ʊ
altogether	ˌɔ l t ə ɡ ɛ ð ə ɹ
always	ˈɔ l w ˌe ɪ z
am	ˈæ m
amazed	ə m ˈe ɪ z d
amazement	ə m ˈe ɪ z m ə n t
amazing	ə m ˈe ɪ z ɪ ŋ
amazingly	ə m ˈe ɪ z ɪ ŋ l i
ambition	æ m b ˈɪ ʃ ə n
amble	ˈæ m b ə l
ambles	ˈæ m b ə l z
ambling	ˈæ m b ə l ɪ ŋ
ambulance	ˈæ m b j ə l ə n s
america	ə m ˈɛ ɹ ɪ k ə
american	ə m ˈɛ ɹ ɪ k ə n
amethyst	ˈæ m ɪ θ ɪ s t
among	ə m ˈʌ ŋ
amount	ə m ˈa ʊ n t
amounts	ə m ˈa ʊ n t s
ample	ˈæ m p ə l
amur	ˈɑ m ˈu ɹ
amuse	ə m j ˈu z
amused	ə m j ˈu z d
an	ə n
anaconda	ˌæ n ə k ˈɑ n d ə
anacondas	ˈæ n ə k ə n d ə z
analyses	æ n ˈæ l ɪ s ˌi z
analyses	ˈæ n ə l a ɪ z ɪ z
ancestor	ˈæ n s ˌɛ s t ɚ
ancient	ˈe ɪ n ʃ ə n t
and	ˈæ n d
andy	ˈæ n d i
anemone	ə n ˈɛ m ə n i
anger	ˈæ ŋ ɡ ɚ
angers	ˈæ ŋ ɡ ɚ z
angle	ˈæ ŋ ɡ ə l
angles	ˈæ ŋ ɡ ə l z
angrily	ˈæ ŋ ɡ ɹ ə l i
angry	ˈæ ŋ ɡ ɹ i
anika	ˈæ n ˈi k ə
animal	ˈæ n ə m ə l
animals	ˈæ n ə m ə l z
animate	ˈæ n ə m ˌe ɪ t
animate	ˈæ n ə m ɪ t
animated	æ n ɪ m e ɪ t ɪ d
annie	ˈæ n n i
announcement	ə n ˈa ʊ n s m ə n t
annoy	ə n ˈɔ ɪ
annoyed	ə n n ˈɔ ɪ d
annoying	ə n ˈɔ ɪ ɪ ŋ
annual	ˈæ n j u ə l
annuals	ˈæ n n u ə l z
another	ə n ˈʌ ð ɚ
answer	ˈæ n s ɚ
answered	ˈæ n s ɚ d
answering	ˈæ n s ɚ ɹ ɪ ŋ
answers	ˈæ n s ɚ z
ant	ˈæ n t
ants	ˈæ n t s
anvil	ˈæ n v ə l
anxiety	æ ŋ z ˈa ɪ ə t i
anxious	ˈæ ŋ k ʃ ə s
anxiously	ˈæ ŋ k ʃ ə s l i
any	ˈɛ n i
anybody	ˈɛ n i b ə d i
anyhow	ˈɛ n i h ˌa ʊ
anymore	ˌɛ n i m ˈɔ ɹ
anyone	ˈɛ n i w ˌʌ n
anything	ˈɛ n i θ ˌɪ ŋ
anytime	ˈɛ n i t ˌa ɪ m
anyway	ˈɛ n i w ˌe ɪ
anyways	ˈɛ n i w ˌe ɪ z
anywhere	ˈɛ n i w ˌɛ ɹ
anywheres	ˈɛ n i w ˌɛ ɹ z
apam	ə p ə m
apart	ə p ˈɑ ɹ t
apartment	ə p ˈɑ ɹ t m ə n t
apartments	ə p ˈɑ ɹ t m ə n t s
ape	ˈe ɪ p
apes	ˈe ɪ p s
apex	ˈe ɪ p ˌɛ k s
apologise	ə p ˈɑ l ə d͡ʒ ˌa ɪ z
apologises	ə p ˈɑ l ə d͡ʒ ˌa ɪ z ɪ z
apologize	ə p ˈɑ l ə d͡ʒ ˌa ɪ z
apologizes	ə p ˈɑ l ə d͡ʒ ˌa ɪ z ə z
apology	ə p ˈɑ l ə d͡ʒ i
apophis	ə p ˈɑ f ɪ z
app	ˈæ p
apparently	ə p ˈɛ ɹ ə n t l i
appear	ə p ˈɪ ɹ
appearance	ə p ˈɪ ɹ ə n s
appeared	ə p ˈɪ ɹ d
appears	ə p ˈɪ ɹ z
appetite	ˈæ p ɪ t ˌa ɪ t
apple	ˈæ p ə l
apples	ˈæ p ə l z
applied	ə p l ˈa ɪ d
approach	ə p ɹ ˈo ʊ t͡ʃ
approached	ə p ɹ ˈo ʊ t͡ʃ t
approaches	ə p ɹ ˈo ʊ t͡ʃ ɪ z
approaching	ə p ɹ ˈo ʊ t͡ʃ ɪ ŋ
appropriate	ə p p ɹ ˈo ʊ p ɹ i ɪ t
appropriate	ə p p ɹ ˈo ʊ p ɹ i ˌe ɪ t
approval	ə p ɹ ˈu v ə l
approximate	ə p p ɹ ˈɑ k s ə m ɪ t
approximate	ə p p ɹ ˈɑ k s ə m ˌe ɪ t
apps	ˈæ p s
april	ˈe ɪ p ɹ ə l
apron	ˈe ɪ p ɹ ə n
aqua	ˈæ k w ʌ
arabian	ˈɑ ɹ ˈe ɪ b ˈi ə n
arch	ˈɑ ɹ t͡ʃ
arches	ˈɑ ɹ t͡ʃ ɪ z
archie	ˈɑ ɹ t͡ʃ i
arctic	ˈɑ ɹ k t ɪ k
are	ˈɑ ɹ
area	ˈɛ ɹ i ə
areas	ˈɛ ɹ i ə z
aren't	ˈɑ ɹ n t
arent	ˈɑ ɹ ə n t
argue	ˈɑ ɹ ɡ j u
argument	ˈɑ ɹ ɡ j ə m ə n t
arguments	ˈɑ ɹ ɡ j ə m ə n t s
argus	ˈɑ ɹ ɡ ə s
arm	ˈɑ ɹ m
armchair	ˈɑ ɹ m t͡ʃ ˌɛ ɹ
armed	ˈɑ ɹ m d
armor	ˈɑ ɹ m ɚ
armour	ˈɑ ɹ m ɚ
armourer	ˈɑ ɹ m ə ɹ ɚ
arms	ˈɑ ɹ m z
army	ˈɑ ɹ m i
around	ɚ ɹ ˈa ʊ n d
arrange	ɚ ɹ ˈe ɪ n d͡ʒ
arrive	ɚ ɹ ˈa ɪ v
arrived	ɚ ɹ ˈa ɪ v d
arrives	ɚ ɹ ˈa ɪ v z
arriving	ʌ ɹ ˌa ɪ v ˈi ŋ
arrow	ˈɛ ɹ o ʊ
arrows	ˈɛ ɹ o ʊ z
art	ˈɑ ɹ t
artefacts	ˈɑ ɹ t ə f ˌæ k t s
articulate	ɑ ɹ t ˈɪ k j ə l ɪ t
articulate	ɑ ɹ t ˈɪ k j ə l ˌe ɪ t
artifact	ˈɑ ɹ t ə f ˌæ k t
artifacts	ˈɑ ɹ t ə f ˌæ k t s
artificial	ˌɑ ɹ t ə f ˈɪ ʃ ə l
artist	ˈɑ ɹ t ɪ s t
artists	ˈɑ ɹ t ɪ s t s
arts	ˈɑ ɹ t s
artwork	ˈɑ ɹ t w ˌɚ k
as	ˈæ z
ascended	ə s ˈɛ n d ɪ d
ash	ˈæ ʃ
ashamed	ə ʃ ˈe ɪ m d
ashes	ˌæ ʃ ə z
asia	ˈe ɪ ʒ ə
asian	ˈe ɪ ʒ ə n
aside	ə s ˈa ɪ d
ask	ˈæ s k
asked	ˈæ s k t
asking	ˈæ s k ɪ ŋ
asks	ˈæ s k s
asleep	ə s l ˈi p
aspirate	ˈæ s p ɚ ɹ ˌe ɪ t
aspirate	ˈæ s p ɚ ɹ ɪ t
aspirates	ˈæ s p ɚ ɹ ɪ t s
aspirates	ˈæ s p ɚ ɹ ˌe ɪ t s
assembled	ə s ˈɛ m b ə l d
assembly	ə s ˈɛ m b l i
assign	ə s ˈa ɪ n
assigned	ə s ˈa ɪ n d
assignment	ə s ˈa ɪ n m ə n t
assistant	ə s ˈɪ s t ə n t
associate	ə s s ˈo ʊ ʃ i ˌe ɪ t
associate	ə s s ˈo ʊ ʃ i ɪ t
associates	ə s s ˈo ʊ ʃ i ɪ t s
associates	ə s s ˈo ʊ ʃ i ˌe ɪ t s
association	ə s ˌo ʊ ʃ i ˈe ɪ ʃ ə n
assured	ə ʃ ˈʊ ɹ d
asteroid	ˈæ s t ɚ ɹ ˌɔ ɪ d
asteroids	ˈæ s t ɚ ɹ ˌɔ ɪ d z
astonishing	ə s t ˈɑ n ɪ ʃ ɪ ŋ
astonishment	ə s t ˈɑ n ɪ ʃ m ə n t
astounded	ə s t ˈa ʊ n d d ɪ d
at	ˈæ t
ate	ˈe ɪ t
atop	ə t ˈɑ p
attached	ə t ˈæ t͡ʃ t
attack	ə t ˈæ k
attacked	ə t ˈæ k t
attacker	ə t ˈæ k ɚ
attackers	ə t ˈæ k ɚ z
attacking	ə t ˈæ k ɪ ŋ
attacks	ə t ˈæ k s
attempt	ə t ˈɛ m p t
attempts	ə t ˈɛ m p t s
attend	ə t ˈɛ n d
attendant	ə t ˈɛ n d ə n t
attention	ə t ˈɛ n ʃ ə n
attic	ˈæ t ɪ k
attract	ə t ɹ ˈæ k t
attraction	ə t ɹ ˈæ k ʃ ə n
attractions	ə t ɹ ˈæ k ʃ ə n z
attribute	ˈæ t t ɹ ɪ b j ˌu t
attribute	ə t t ɹ ˈɪ b j ˌu t
attributes	ə t t ɹ ˈɪ b j ˌu t s
attributes	ˈæ t t ɹ ɪ b j ˌu t s
audible	ˈɔ d ɪ b ə l
audibly	ˈɔ d ɪ b l i
audience	ˈɔ d i ə n s
auditorium	ˌɔ d ə t ˈɔ ɹ i ə m
august	ˈɔ ɡ ə s t
aunt	ˈæ n t
aunts	ˈæ n t s
australian	ɔ s t ɹ ˈe ɪ l j ə n
auto	ˈɔ t o ʊ
autobiography	ˌɔ t o ʊ b a ɪ ˈɑ ɡ ɹ ə f i
autoclave	ˈɔ t o ʊ k l ˌe ɪ v
automatic	ˌɔ t o ʊ m ˈæ t ɪ k
automatically	ˌɔ t o ʊ m ˈæ t ɪ k l i
autumn	ˈɔ t ə m
avail	ə v ˈe ɪ l
available	ə v ˈe ɪ l ə b ə l
avalanche	ˈæ v ə l ˌæ n t͡ʃ
average	ˈæ v ɚ ɪ d͡ʒ
avoid	ə v ˈɔ ɪ d
avoided	ʌ v ˈɔ ɪ d ə d
avoids	ə v ˈɔ ɪ d z
aw	ˈɔ
awake	ə w ˈe ɪ k
award	ə w ˈɔ ɹ d
awards	ə w ˈɔ ɹ d z
aware	ə w ˈɛ ɹ
awareness	ə w ˈɛ ɹ n ə s
away	ə w ˈe ɪ
awe	ˈɔ
awesome	ˈɔ s ə m
awful	ˈɔ f ə l
awkward	ˈa ʊ k w ɚ d
awkwardly	ˈɔ k w ɚ d l i
awning	ˈɔ n ɪ ŋ
awoke	ə w ˈo ʊ k
aww	ˈɔ
ax	ˈæ k s
axe	ˈæ k s
axes	ˈæ k s ɪ z
axolotl	ˈæ k s ə l ɔ t ə l
axolotls	ˈæ k s ə l ɔ t ə l s
ayy	ˈe ɪ
b	b ˈi
babies	b ˈe ɪ b i z
baby	b ˈe ɪ b i
back	b ˌæ k
backed	b ˈæ k t
backfired	b ˈæ k f ˌa ɪ ɚ d
backfires	b ˈæ k f ˌa ɪ ɚ z
background	b ˈæ k ɡ ɹ ˌa ʊ n d
backgrounds	b ˈæ k ɡ ɹ ˌa ʊ n d z
backing	b ˈæ k ɪ ŋ
backlash	b ˈæ k l ˌæ ʃ
backpack	b ˈæ k p ˌæ k
backpacks	b ˈæ k p ˌæ k s
backs	b ˈæ k s
backward	b ˈæ k w ɚ d
backwards	b ˈæ k w ɚ d z
backyard	b ˈæ k j ˌɑ ɹ d
bacteria	b æ k t ˈɪ ɹ i ə
bad	b ˈæ d
badly	b ˈæ d l i
baffled	b ˈæ f ə l d
bag	b ˈæ ɡ
bags	b ˈæ ɡ z
bahasa	b ˈɑ h ˈɑ s ˈɑ
bait	b ˈe ɪ t
bake	b ˈe ɪ k
baked	b ˈe ɪ k t
baker	b ˈe ɪ k ɚ
baker's	b e ɪ k ə z
bakery	b ˈe ɪ k ɚ ɹ i
bakes	b ˈe ɪ k s
baking	b ˈe ɪ k ɪ ŋ
balance	b ˈæ l ə n s
balanced	b ˈæ l ə n s t
bale	b ˈe ɪ l
bales	b ˈe ɪ l z
bali	b ˈɑ l ˈi
ball	b ˈɔ l
ballerina	b ˌæ l l ɚ ɹ ˈi n ə
ballerinas	b ˌæ l l ɚ ɹ ˈi n ə z
ballet	b æ l ˈe ɪ
ballets	b æ l ˈe ɪ z
balloon	b ə l ˈu n
balloons	b ə l ˈu n z
balls	b ˈɔ l z
bam	b ˈæ m
bamboo	b æ m b ˈu
banana	b ə n ˈæ n ə
bananas	b ə n ˈæ n ə z
band	b ˈæ n d
bandit	b ˈæ n d ə t
bands	b ˈæ n d z
bang	b ˈæ ŋ
bangs	b ˈæ ŋ z
bank	b ˈæ ŋ k
banks	b ˈæ ŋ k s
banned	b ˈæ n d
banners	b ˌæ n ə z
bant	b ˈæ n t
bar	b ˈɑ ɹ
barbara	b ˈɑ ɹ b ɚ ɹ ə
bare	b ˈɛ ɹ
barely	b ˈɛ ɹ l i
barged	b ˈɑ ɹ d͡ʒ d
bark	b ˈɑ ɹ k
barked	b ˈɑ ɹ k t
barking	b ˈɑ ɹ k ɪ ŋ
barks	b ˈɑ ɹ k s
barky	b ɑ k ˌi
barn	b ˈɑ ɹ n
barrel	b ˈɛ ɹ ə l
barrelling	b ˈɛ ɹ ˈɛ l ɪ ŋ
bars	b ˈɑ ɹ z
basalt	b æ s ˈɔ l t
base	b ˈe ɪ s
based	b ˈe ɪ s d t
basement	b ˈe ɪ s m ə n t
bases	b ˈe ɪ s ɪ z
bash	b ˈæ ʃ
basic	b e ɪ s ɪ k
basics	b ˈe ɪ s ɪ k s
basil	b ˈæ z ə l
basis	b ˈe ɪ s ɪ s
basket	b ˈæ s k ə t
baskets	b ˈæ s k ə t s
bat	b ˈæ t
bat-earred	b ˈæ t ˈɪ ɹ d
batch	b ˈæ t͡ʃ
bath	b ˈæ θ
bathe	b ˈe ɪ ð
bathing	b ˈe ɪ ð ɪ ŋ
baths	b ˈæ θ s
bathtub	b ˈæ θ t ə b
baton	b ˈæ t ə n
bats	b ˈæ t s
batter	b ˈæ t ɚ
batteries	b ˈæ t ˈɚ ˈi z
battery	b ˈæ t ɚ i
battle	b ˈæ t ə l
battled	b ˈæ t ə l d
bauble	b ˈɔ b ə l
baubles	b ˈɔ b ə l z
bawls	b ˈɔ l z
bay	b ˈe ɪ
be	b ˈi
beach	b ˈi t͡ʃ
beaches	b ˈi t͡ʃ ɪ z
bead	b ˈi d
beads	b ˈi d z
beak	b ˈi k
beaks	b ˈi k s
beamed	b ˈi m d
beaming	b ˈi m ɪ ŋ
bean	b ˈi n
beans	b ˈi n z
bear	b ˈɛ ɹ
beard	b ˈi ɹ d
bears	b ˈɛ ɹ z
beast	b ˈi s t
beast's	b ˈi s t s
beasts	b ˈi s t s
beat	b ˈi t
beaten	b ˈi t ə n
beating	b ˈi t ɪ ŋ
beats	b ˈi t s
beautiful	b j ˈu t ɪ f ə l
beauty	b j ˈu t i
became	b ɪ k ˈe ɪ m
because	b ɪ k ˈʌ z
beckon	b ˈɛ k ə n
beckoned	b ɛ k ə n d
become	b ɪ k ˈʌ m
becomes	b ɪ k ˈʌ m z
bed	b ˈɛ d
bedrock	b ˈɛ d ɹ ˈɑ k
bedroom	b ˈɛ d ɹ ˌu m
bedrooms	b ˈɛ d ɹ ˌu m z
beds	b ˈɛ d z
bedside	b ˈɛ d s ˌa ɪ d
bedtime	b ˈɛ d t ˌa ɪ m
bee	b ˈi
bee's	b ˈi z
beef	b ˈi f
beehive	b ˈi h ˌa ɪ v
been	b ˈɪ n
beeps	b ˈi p s
bees	b ˈi z
beetle	b ˈi t ə l
beetles	b ˈi t ə l z
beetroot	b ˈi t ɹ ˈu t
before	b ɪ f ˈɔ ɹ
beg	b ˈɛ ɡ
began	b ɪ ɡ æ n
begged	b ˈɛ ɡ d
begging	b ˈɛ ɡ ɪ ŋ
begin	b ɪ ɡ ˈɪ n
beginning	b ɪ ɡ ˈɪ n ɪ ŋ
begins	b ɪ ɡ ˈɪ n z
begun	b ɪ ɡ ˈʌ n
behave	b ɪ h ˈe ɪ v
behavior	b ɪ h ˈe ɪ v j ɚ
behaviors	b ɪ h ˈe ɪ v j ɚ z
behaviour	b ɪ h ˈe ɪ v j ɚ
behaviours	b ɪ h ˈe ɪ v j ɚ z
behind	b ɪ h ˈa ɪ n d
behold	b ɪ h ˈo ʊ l d
being	b ˈi ɪ ŋ
beings	b ˈɪ ˈɪ ŋ z
believe	b ɪ l ˈi v
believed	b ə l ˌi v d
bell	b ˈɛ l
bell-shaped	b ˈɛ l ʃ ˈe ɪ p t
bella	b ˈɛ l l ə
bella's	b ˈɛ l l ə z
bellies	b ˈɛ l i z
bellow	b ˈɛ l o ʊ
bellows	b ˈɛ l o ʊ z
bells	b ˈɛ l z
belly	b ˈɛ l i
bellyit	b ˈɛ l i ɪ t
belong	b ɪ l ˈɔ ŋ
belonging	b ɪ l ˈɔ ŋ ɪ ŋ
belongings	b ɪ l ˈɔ ŋ ɪ ŋ z
belongs	b ɪ l ˈɔ ŋ z
beloved	b ɪ l ˈʌ v ɪ d
below	b ɪ l ˈo ʊ
belt	b ˈɛ l t
belting	b ˈɛ l t ɪ ŋ
ben	b ˈɛ n
ben's	b ˈɛ n z
bench	b ˈɛ n t͡ʃ
bend	b ˈɛ n d
bending	b ˈɛ n d ɪ ŋ
bends	b ˈɛ n d z
beneath	b ɪ n ˈi θ
bengal	b ɛ n ɡ ɔ l
benny	b ˈɛ n i
bennys	b ˈɛ n i z
bent	b ˈɛ n t
benthik	b ˈɛ n θ ɪ k
berate	b ɪ ɹ ˈe ɪ t
berates	b ɚ ɹ ˌe ɪ t s
berries	b ˈɛ ɹ i z
berry	b ˈɛ ɹ i
berth	b ˈɚ θ
beside	b ɪ s ˈa ɪ d
besides	b ɪ s ˈa ɪ d z
best	b ˈɛ s t
best-known	b ˈɛ s t n ˈo ʊ n
best-looking	b ˈɛ s t l ˈʊ k ɪ ŋ
bested	b ɛ s t ɛ d
bet	b ˈɛ t
beth	b ˈɛ θ
beth's	b ˈɛ θ s
bets	b ˈɛ t s
better	b ˈɛ t ɚ
betters	b ˈɛ t t ɚ z
between	b ɪ t w ˈi n
beyond	b ɪ j ˈɔ n d
biased	b ˈa ɪ ə s t
biassed	b ˈa ɪ ə s t
bib	b ˈɪ b
bicker	b ˈɪ k ʌ
bicycle	b ˈa ɪ s ɪ k ə l
bid	b ˈɪ d
big	b ˈɪ ɡ
bigger	b ˈɪ ɡ ɚ
biggest	b ˈɪ ɡ ɪ s t
bike	b ˈa ɪ k
bikes	b ˈa ɪ k s
bill	b ˈɪ l
billy	b ˈɪ l l i
bin	b ˈɪ n
bind	b ˈa ɪ n d
binds	b ˈa ɪ n d z
bins	b ˈɪ n z
biographies	b a ɪ ˈɑ ɡ ɹ ə f i z
biography	b a ɪ ˈɑ ɡ ɹ ə f i
biologist	b a ɪ ˈɑ l ə d͡ʒ ɪ s t
biologists	b a ɪ ˈɑ l ə d͡ʒ ɪ s t s
biology	b a ɪ ˈɑ l ə d͡ʒ i
biome	b ˈa ɪ ˌo ʊ m
biomes	b a ɪ o ʊ m z
biosphere	b ˈa ɪ o ʊ s f ˌɪ ɹ
birch	b ˈɚ t͡ʃ
bird	b ˈɚ d
bird's	b ˈɚ d z
birds	b ˈɚ d z
birth	b ˈɚ θ
birthdate	b ˈɚ θ d ˌe ɪ t
birthday	b ˈɚ θ d ˌe ɪ
birthdays	b ˈɚ θ d ˌe ɪ z
biscuit	b ˈɪ s k ə t
biscuits	b ˈɪ s k ə t s
bit	b ˈɪ t
bite	b ˈa ɪ t
biter	b ˈa ɪ t ɚ
bites	b ˈa ɪ t s
biting	b ˈa ɪ t ɪ ŋ
bits	b ˈɪ t s
bitten	b ˈɪ t ə n
bitter	b ˈɪ t ɚ
bitters	b ˈɪ t ɚ z
bizarre	b ɪ z ˈɑ ɹ
black	b l ˈæ k
blackbird	b l ˈæ k b ɚ d
blackout	b l ˈæ k ˌa ʊ t
bladder	b l ˈæ d ɚ
blade	b l ˈe ɪ d
blades	b l ˈe ɪ d z
blame	b l ˈe ɪ m
blaming	b l ˈe ɪ m ɪ ŋ
bland	b l ˈæ n d
blank	b l ˈæ ŋ k
blanket	b l ˈæ ŋ k ɪ t
blankets	b l ˈæ ŋ k ɪ t s
blast	b l ˈæ s t
bleak	b l ˈi k
bleat	b l ˈi t
bleating	b l ˈi t ɪ ŋ ɡ
bleats	b l ˈi t s
bleed	b l ˈi d
bleeds	b l ˈi d z
blend	b l ˈɛ n d
blends	b l ˈɛ n d z
blessed	b l ˈɛ s ɪ d
blessed	b l ˈɛ s t
blessing	b l ˈɛ s ɪ ŋ
blew	b l ˈu
blight	b l ˈa ɪ t
blind	b l ˈa ɪ n d
blinds	b l ˈa ɪ n d z
blink	b l ˈɪ ŋ k
blinked	b l ˈɪ ŋ k t
blinking	b l ˈɪ ŋ k ɪ ŋ
blinks	b l ˈɪ ŋ k s
blob	b l ˈɑ b
blobs	b l ɑ b z
block	b l ˈɑ k
blocked	b l ˈɑ k t
blocking	b l ˈɔ k ˈi ŋ
blocks	b l ˈɑ k s
blog	b l ˈɔ ɡ
blood	b l ˈʌ d
bloom	b l ˈu m
blooms	b l ˈu m z
blossom	b l ˈɑ s ə m
blossoms	b l ˈɑ s ə m z
blotches	b l ˈɑ t t͡ʃ ə z
blow	b l ˈo ʊ
blowhole	b l ˈo ʊ h ˈo ʊ l
blowing	b l ˈo ʊ ɪ ŋ
blown	b l o ʊ n
blows	b l ˈo ʊ z
blue	b l ˈu
blue's	b l ˈu z
blues	b l ˈu z
bluish	b l ˈu ɪ ʃ
blush	b l ˈʌ ʃ
blushing	b l ˈʌ ʃ ɪ ŋ
board	b ˈɔ ɹ d
boarded	b ˈɔ ɹ d ɪ d
boarded-up	b ˈɔ ɹ d ɪ d ˈʌ p
boards	b ˈɔ ɹ d z
boars	b ˈɔ ɹ z
boast	b ˈo ʊ s t
boasts	b ˈo ʊ s t s
boat	b ˈo ʊ t
boating	b ˈo ʊ t ɪ ŋ
boats	b ˈo ʊ t s
bob	b ˈɑ b
bobbed	b ˈɑ b d
bobber	b ˈɑ b ɚ
bobbing	b ˈɑ b ɪ ŋ
bobs	b ˈɑ b z
bode	b ˈo ʊ d
bodies	b ˈɑ d i z
body	b ˈɑ d i
bog	b ˈɔ ɡ
boil	b ˈɔ ɪ l
boils	b ˈɔ ɪ l z
boing	b ˈɔ ɪ ŋ
bold	b ˈo ʊ l d
boldly	b ˈo ʊ l d l i
bolt	b ˈo ʊ l t
bolted	b ˈo ʊ l t ɪ d
bolts	b ˈo ʊ l t s
bomb	b ˈɑ m
bon	b ˈɑ n
bon's	b ˈɑ n z
bond	b ˈɑ n d
bonded	b ˈɑ n d ɪ d
bone	b ˈo ʊ n
bonemeal	b ˈo ʊ n m ˌi l
bones	b ˈo ʊ n z
bonk	b ˈɑ ŋ k
bonus	b o ʊ n ə s
bony	b ˈo ʊ n i
boo	b ˈu
book	b ˈʊ k
book's	b ˈʊ k s
bookbot	b ˈʊ k b ˈɔ t
bookbot's	b ˈʊ k b ˈɔ t s
bookbots	b ˈʊ k b ˈɔ t s
bookcase	b ˈʊ k k ˌe ɪ s
bookcases	b ˈʊ k k ˌe ɪ s ə z
books	b ˈʊ k s
bookshelf	b ˈʊ k ʃ ˌɛ l f
bookshelves	b ˈʊ k ʃ ˈɛ l v z
bookshop	b ˈʊ k ʃ ˌɑ p
bookworm	b ˈʊ k w ˌɚ m
boom	b ˈu m
boombox	b ˈʊ m b ˌɑ k s
booms	b ˈu m z
boot	b ˈu t
booted	b ˈu t ɪ d
boots	b ˈu t s
bop	b ˈɑ p
border	b ˈɔ ɹ d ɚ
bore	b ˈɔ ɹ
bored	b ˈɔ ɹ d
boring	b ˈɔ ɹ ɪ ŋ
born	b ˈɔ ɹ n
borneo	b ˈɔ ɹ n ˈi ˈo ʊ
borrow	b ˈɑ ɹ o ʊ
boss	b ˈɔ s
bot	b ˈɔ t
botanist	b ˈɑ t ə n ɪ s t
both	b ˈo ʊ θ
bother	b ˈɑ ð ɚ
bothered	b ˈɑ ð ɚ d
bots	b ˈɔ t s
bottle	b ˈɑ t ə l
bottled	b ˈɑ t ə l d
bottles	b ˈɑ t ə l z
bottom	b ˈɑ t ə m
boudoir	b ˈu d ˌɔ ɪ ɹ
bough	b ˈa ʊ
bought	b ˈɔ t
boulder	b ˈo ʊ l d ɚ
bounce	b ˈa ʊ n s
bounced	b ˈa ʊ n s t
bounces	b ˈa ʊ n s ɪ z
bouncy	b ˈa ʊ n s ˈi
bound	b ˈa ʊ n d
boundary	b ˈa ʊ n d ɚ ɹ i
bounded	b ˈa ʊ n d ɪ d
bounds	b ˈa ʊ n d z
bounty	b ˈa ʊ n t i
bout	b ˈa ʊ t
bow	b ˈo ʊ
bowerbird	b ˈa ʊ w ɚ b ɚ d
bowerbirds	b ˈa ʊ w ɚ b ˈɚ d z
bowl	b ˈo ʊ l
bowls	b ˈo ʊ l z
bows	b ˈo ʊ z
box	b ˈɑ k s
boxes	b ˈɑ k s ɪ z
boxing	b ˈɑ k s ɪ ŋ
boy	b ˈɔ ɪ
boys	b ˈɔ ɪ z
bracelet	b ɹ ˈe ɪ s l ɪ t
braid	b ɹ ˈe ɪ d
braids	b ɹ ˈe ɪ d z
brain	b ɹ ˈe ɪ n
brains	b ɹ ˈe ɪ n z
brainstorm	b ɹ ˈe ɪ n s t ˌɔ ɹ m
brainstorming	b ɹ ˈe ɪ n s t ˌɔ ɹ m ɪ ŋ
brainwash	b ɹ ˈe ɪ n w ˌɑ ʃ
brainwave	b ɹ ˈe ɪ n w ˌe ɪ v
brake	b ɹ ˈe ɪ k
brakes	b ɹ ˈe ɪ k s
branch	b ɹ ˈæ n t͡ʃ
branched	b ɹ ˈæ n t͡ʃ t
branches	b ɹ ˈæ n t͡ʃ ɪ z
brand	b ɹ ˈæ n d
brands	b ɹ ˈæ n d z
brat	b ɹ ˈæ t
brave	b ɹ ˈe ɪ v
bravery	b ɹ ˈe ɪ v ɚ ɹ i
braying	b ɹ ˈe ɪ ˈɪ ŋ
breach	b ɹ ˈi t͡ʃ
bread	b ɹ ˈɛ d
break	b ɹ ˈe ɪ k
breakfast	b ɹ ˈɛ k f ə s t
breaking	b ɹ ˈe ɪ k ɪ ŋ
breaks	b ɹ ˈe ɪ k s
breath	b ɹ ˈɛ θ
breathe	b ɹ ˈi ð
breathed	b ɹ ˈi ð d
breathes	b ɹ ˈi ð z
breathing	b ɹ ˈi ð ɪ ŋ
breathless	b ɹ ˈɛ θ l ə s
bred	b ɹ ˈɛ d
breed	b ɹ ˈi d
breeding	b ɹ i d i ŋ
breeds	b ɹ ˈi d z
breeze	b ɹ ˈi z
brew	b ɹ ˈu
brewing	b ɹ ˈu ɪ ŋ
brick	b ɹ ˈɪ k
bricked	b ɹ ˈɪ k t
bricks	b ɹ ˈɪ k s
bridge	b ɹ ˈɪ d͡ʒ
bridges	b ɹ ˈɪ d͡ʒ ɪ z
brief	b ɹ ˈi f
briefly	b ɹ ˈi f l i
briefs	b ɹ ˈi f s
brigh	b ɹ ˈa ɪ t
bright	b ɹ ˈa ɪ t
brighten	b ɹ ˈa ɪ t ə n
brighter	b ɹ ˈa ɪ t ˈɚ
brightness	b ɹ ˈa ɪ t n ə s
brilliant	b ɹ ˈɪ l j ə n t
brim	b ɹ ˈɪ m
bring	b ɹ ˈɪ ŋ
bringing	b ɹ ˈɪ ŋ ɪ ŋ
brings	b ɹ ˈɪ ŋ z
brink	b ɹ ˈɪ ŋ k
brisk	b ɹ ˈɪ s k
broad	b ɹ ˈɔ d
broaden	b ɹ ˈɔ d ə n
broke	b ɹ ˈo ʊ k
broken	b ɹ ˈo ʊ k ə n
brolga	b ɹ ˈɑ l ɡ ə
brooch	b ɹ ˈo ʊ t͡ʃ
broom	b ɹ ˈu m
brooms	b ɹ ˈu m z
broth	b ɹ ˈɔ θ
brother	b ɹ ˈʌ ð ɚ
brother's	b ɹ ʌ ð ˈɚ z
brothers	b ɹ ˈʌ ð ɚ z
brought	b ɹ ˈɔ t
brow	b ɹ ˈa ʊ
brown	b ɹ ˈa ʊ n
brownish	b ɹ ˈa ʊ n ɪ ʃ
brows	b ɹ ˈa ʊ z
bruce	b ɹ ˈu s
bruise	b ɹ ˈu z
bruised	b ɹ ˈu z d
bruisers	b ɹ u z ə ɹ z
bruises	b ɹ ˈu z ɪ z
brush	b ɹ ˈʌ ʃ
brushed	b ɹ ˈʌ ʃ t
brushes	b ɹ ˈʌ ʃ ɪ z
brutal	b ɹ ˈu t ə l
brute	b ɹ ˈu t
brutes	b ɹ ˈu t s
bub	b ˈʌ b
bubbles	b ˈʌ b ə l z
bucket	b ˈʌ k ɪ t
buckets	b ˈʌ k ɪ t s
bud	b ˈʌ d
buddies	b ˈʌ d i z
buddy	b ˈʌ d i
budge	b ˈʌ d͡ʒ
budget	b ˈʌ d͡ʒ ɪ t
buds	b ˈʌ d z
buffalo	b ˈʌ f ə l o ʊ
bug	b ˈʌ ɡ
buggies	b ˈʌ ɡ i z
buggy	b ˈʌ ɡ i
bugs	b ˈʌ ɡ z
build	b ˈɪ l d
builder	b ˈɪ l d ɚ
building	b ˈɪ l d ɪ ŋ
buildings	b ɪ l d ɪ ŋ z
builds	b ˈɪ l d z
built	b ˈɪ l t
bulb	b ˈʌ l b
bulging	b ˈʌ l d͡ʒ ɪ ŋ
bulk	b ˈʌ l k
bull	b ˈʊ l
bullied	b ˈʊ l i d
bulls	b ˈʊ l z
bully	b ˈʊ l i
bullying	b ˈʊ l i ɪ ŋ
bulrush	b ˈʊ l ɹ ə ʃ
bump	b ˈʌ m p
bumped	b ˈʌ m p t
bumper	b ˈʌ m p ɚ
bumping	b ˈʌ m p ˈɪ ŋ
bumps	b ˈʌ m p s
bumpy	b ˈʌ m p i
bun	b ˈʌ n
bunburied	b ˈʌ n b ɚ ˈi d
bunch	b ˈʌ n t͡ʃ
bunches	b ˈʌ n t͡ʃ ə z
bundle	b ˈʌ n d ə l
bundles	b ʌ n d l z
bunk	b ˈʌ ŋ k
bunker	b ˈʌ ŋ k ɚ
bunks	b ˈʌ ŋ k s
bunnies	b ˈʌ n i z
bunny	b ˈʌ n i
bunyip	b ˈʌ n j ˈɪ p
bunyips	b ˈʌ n j ˈɪ p s
burger	b ˈɚ ɡ ɚ
buried	b ˈɛ ɹ i d
buries	b ˈɛ ɹ i z
burn	b ˈɚ n
burned	b ˈɚ n d
burning	b ˈɚ n ɪ ŋ
burns	b ˈɚ n z
burnt	b ˈɚ n t
burrow	b ˈɚ ɹ o ʊ
burrows	b ˈɚ ɹ o ʊ z
burst	b ˈɚ s t
bursting	b ˈɚ s t ɪ ŋ
bursts	b ˈɚ s t s
bury	b ˈɛ ɹ i
burying	b ˈɛ ɹ i ɪ ŋ
bus	b ˈʌ s
bush	b ˈʊ ʃ
bushes	b ˈʊ ʃ ɪ z
busiest	b ˌi z i ˈɛ s t
business	b ˈɪ z n ɪ s
businesses	b ˈɪ z n ɪ s ɪ z
busted	b ˈʌ s t ɪ d
bustling	b ˈʌ s l ɪ ŋ
busy	b ˈɪ z i
but	b ˈʌ t
butcher	b ˈʊ t͡ʃ ɚ
butcher's	b ˈʊ t͡ʃ ə ɹ z
butt	b ˈʌ t
butter	b ˈʌ t ɚ
butter's	b ˈʌ t ɚ z
butterflies	b ˈʌ t ɚ f l ˌa ɪ z
butterfly	b ˈʌ t t ɚ f l ˌa ɪ
button	b ˈʌ t ə n
buttons	b ˈʌ t ə n z
buy	b ˈa ɪ
buys	b ˈa ɪ z
buzz	b ˈʌ z
buzzes	b ˈʌ z ɪ z
buzzing	b ˈʌ z ɪ ŋ
by	b ˈa ɪ
bye	b ˈa ɪ
c	s ˈi
c-h	s ˈi ˈe ɪ t͡ʃ
c-i	s ˈi ˈa ɪ
c-k	s ˈi k ˈe ɪ
cab	k ˈæ b
cabin	k ˈæ b ə n
cackled	k æ k ə l d
cackling	k æ k ə l ɪ ŋ
cactus	k ˈæ k t ə s
cage	k ˈe ɪ d͡ʒ
cages	k e ɪ d͡ʒ ə z
cake	k ˈe ɪ k
cakes	k ˈe ɪ k s
calculation	k ˌæ l k j ə l ˈe ɪ ʃ ə n
calf	k ˈæ f
calico	k ˈæ l ˈɪ k ˈo ʊ
call	k ˈɔ l
called	k ˈɔ l d
calling	k ˈɔ l ɪ ŋ
calls	k ˈɔ l z
callum	k ˈæ l ə m
calm	k ˈɑ m
calming	k ˈɑ l m ɪ ŋ ɡ
calmly	k ˈɑ m l i
calms	k ˈɑ m z
calves	k ˈæ v z
cam	k ˈæ m
cam's	k ˈæ m z
came	k ˈe ɪ m
camel	k ˈæ m ə l
camera	k ˈæ m ɚ ɹ ə
cameras	k ˈæ m ɚ ɹ ə z
camouflage	k ˈæ m ə f l ˌɑ ʒ
camp	k ˈæ m p
campaigning	k æ m p ˈe ɪ n ɪ ŋ
campfire	k ˈæ m p f ˌa ɪ ɚ
can	k æ n
can't	k ˈæ n t
canal	k ə n æ l
cancel	k ˈæ n s ə l
candle	k ˈæ n d ə l
candy	k ˈæ n d i
cane	k ˈe ɪ n
canes	k ˈe ɪ n z
cannot	k æ n ˈɑ t
cans	k ˈæ n z
cant	k ɑ n t
canvas	k ˈæ n v ə s
canville	k ˌæ n v ˈɪ l
cap	k ˈæ p
capable	k ˈe ɪ p ə b ə l
capital	k ˈæ p ɪ t ə l
caps	k ˈæ p s
captain	k ˈæ p t ə n
captive	k ˈæ p t ɪ v
captivity	k æ p t ˈɪ v ə t i
capture	k ˈæ p t͡ʃ ɚ
car	k ˈɑ ɹ
card	k ˈɑ ɹ d
cardboard	k ˈɑ ɹ d b ˌɔ ɹ d
cards	k ˈɑ ɹ d
care	k ˈɛ ɹ
cared	k ˈɛ ɹ d
carefree	k ˈɛ ɹ f ɹ ˌi
careful	k ˈɛ ɹ f ə l
carefully	k ˈɛ ɹ f ə l i
careless	k ˈɛ ɹ l ə s
carelessly	k ˈɛ ɹ l ə s l i
cares	k ˈɛ ɹ z
carfeul	k ˈɛ ɹ f ə l
carnival	k ˈɑ ɹ n ɪ v ə l
carnivals	k ˈɑ ɹ n ɪ v ə l z
carnivore	k ˈɑ ɹ n ɪ v ˌɔ ɹ
carnivores	k ˈɑ ɹ n ɪ v ˌɔ ɹ z
carpenter	k ˈɑ ɹ p ə n t ɚ
carpet	k ˈɑ ɹ p ɪ t
carried	k ˈɛ ɹ ɹ i d
carrier	k ˈɛ ɹ ɹ i j ɚ
carries	k ˈɛ ɹ i z
carrot	k ˈɛ ɹ ə t
carrots	k ˈɛ ɹ ə t s
carry	k ˈɛ ɹ i
carrying	k ˈɛ ɹ i ɪ ŋ
cars	k ˈɑ ɹ z
cart	k ˈɑ ɹ t
cartographer	k ɑ t ˈɑ ɡ ɹ ə f ə
carts	k ˈɑ ɹ t s
cartwheels	k ˈɑ ɹ t w ˌi l z
carved	k ˈɑ ɹ v d
carving	k ˈɑ ɹ v ɪ ŋ
carvings	k ˈɑ ɹ v ɪ ŋ z
case	k ˈe ɪ s
cases	k ˈe ɪ s ɪ z
cash	k ˈæ ʃ
casque	k ˈæ s k
cassowaries	k ˈæ s o ʊ w ɚ ɹ i z
cassowary	k ˈæ s ə w ˌɛ ɹ i
cast	k ˈæ s t
castle	k ˈæ s ə l
castles	k ˈæ s ə l z
casts	k ˈæ s t s
casual	k ˈæ ʒ u ə l
casually	k ˈæ ʒ u ə l i
cat	k ˈæ t
cat's	k ˈæ t s
catch	k ˈæ t͡ʃ
catches	k ˈæ t͡ʃ ɪ z
catching	k ˈæ t͡ʃ ɪ ŋ
caterpillar	k ˈæ t ɚ p ˌɪ l ɚ
caterpillars	k ˈæ t ɚ p ˌɪ l ɚ z
cats	k ˈæ t s
cattle	k ˈæ t ə l
caught	k ˈɔ t
cause	k ˈɔ z
caused	k ˈɔ z d
causes	k ˈɔ z ɪ z
causing	k ˈɔ z ɪ ŋ
caution	k ˈɔ ʃ ə n
cautious	k ˈɔ ʃ ə s
cautiously	k ˈɔ ʃ ə s l i
cave	k ˈe ɪ v
cavern	k ˈæ v ɚ n
caves	k ˈe ɪ v z
cavity	k ˈæ v ə t i
caw	k ˈɔ
ceiling	s ˈi l ɪ ŋ
celebrate	s ˈɛ l ə b ɹ ˌe ɪ t
celebrated	s ˈɛ l ə b ɹ ˌe ɪ t ɪ d
celebration	s ˌɛ l ə b ɹ ˈe ɪ ʃ ə n
celery	s ˈɛ l ɚ ɹ i
cell	s ˈɛ l
cells	s ˈɛ l z
celsius	s ɛ l s ˈi ə s
center	s ˈɛ n t ɚ
centimeters	s ɛ n t ˈi m ˈi t ɚ z
centimetres	s ɛ n t ə m ˈi t ɚ z
centipede	s ˈɛ n t ɪ p ˌi d
centre	s ˈɛ n t ɚ
centred	s ɛ n t ə d
century	s ˈɛ n t͡ʃ ɚ ɹ i
certain	s ˈɚ t ə n
certainly	s ˈɚ t ə n l i
cetus	s ˈi t ə s
chain	t͡ʃ ˈe ɪ n
chair	t͡ʃ ˈɛ ɹ
chairs	t͡ʃ ˈɛ ɹ z
challenge	t͡ʃ ˈæ l ɪ n d͡ʒ
challenges	t͡ʃ ˈæ l ɪ n d͡ʒ ə z
chamber	t͡ʃ ˈe ɪ m b ɚ
chameleon	k ə m ˈi l i ə n
chameleons	k ˈæ m ˈɪ l ˈɪ ə n z
championship	t͡ʃ ˈæ m p i ə n ʃ ˌɪ p
chance	t͡ʃ ˈæ n s
change	t͡ʃ ˈe ɪ n d͡ʒ
changed	t͡ʃ ˈe ɪ n d͡ʒ d
changes	t͡ʃ ˈe ɪ n d͡ʒ ɪ z
changing	t͡ʃ ˈe ɪ n d͡ʒ ɪ ŋ
channel	t͡ʃ ˈæ n ə l
channels	t͡ʃ ˈæ n ə l z
chant	t͡ʃ ˈæ n t
chanted	t͡ʃ ˈæ n t ɪ d
chants	t͡ʃ ˈæ n t s
chaos	k ˈe ɪ ɑ s
chaotic	k e ɪ ɑ t ɪ k
chapter	t͡ʃ ˈæ p t ɚ
character	k ˈɛ ɹ ɪ k t ɚ
characters	k ˈɛ ɹ ɪ k t ɚ z
charcoal	t͡ʃ ˈɑ ɹ k ˌo ʊ l
charge	t͡ʃ ˈɑ ɹ d͡ʒ
charged	t͡ʃ ˈɑ ɹ d͡ʒ d
charges	t͡ʃ ˈɑ ɹ d͡ʒ ɪ z
charm	t͡ʃ ˈɑ ɹ m
chase	t͡ʃ ˈe ɪ s
chased	t͡ʃ ˈe ɪ s t
chases	t͡ʃ ˈe ɪ s ɪ z
chasing	t͡ʃ ˈe ɪ s ɪ ŋ
chasings	t͡ʃ ˈæ s ɪ ŋ z
chat	t͡ʃ ˈæ t
chats	t͡ʃ ˈæ t s
chatter	t͡ʃ ˈæ t ɚ
chatterer	t͡ʃ ˈæ t t ɚ ɚ
chatting	t͡ʃ ˈæ t t ɪ ŋ
cheap	t͡ʃ ˈi p
cheaper	t͡ʃ ˈi p ɚ
cheat	t͡ʃ ˈi t
check	t͡ʃ ˈɛ k
checked	t͡ʃ ˈɛ k t
checking	t͡ʃ ˈɛ k ɪ ŋ
checks	t͡ʃ ˈɛ k s
cheek	t͡ʃ ˈi k
cheeks	t͡ʃ ˈi k s
cheeky	t͡ʃ ˈi k i
cheer	t͡ʃ ˈɪ ɹ
cheered	t͡ʃ ˈɪ ɹ d
cheerful	t͡ʃ ˈɪ ɹ f ə l
cheerfully	t͡ʃ ˈɪ ɹ f ə l i
cheers	t͡ʃ ˈɪ ɹ z
cheese	t͡ʃ ˈi z
chef	ʃ ˈɛ f
chemical	k ˈɛ m ɪ k ə l
chemicals	k ˈɛ m ɪ k ə l z
cherry	t͡ʃ ˈɛ ɹ i
chess	t͡ʃ ˈɛ s
chest	t͡ʃ ˈɛ s t
chests	t͡ʃ ˈɛ s t s
chew	t͡ʃ ˈu
chewing	t͡ʃ ˈu ɪ ŋ
chews	t͡ʃ ˈu z
chh	t͡ʃ ə
chick	t͡ʃ ˈɪ k
chicken	t͡ʃ ˈɪ k ə n
chickens	t͡ʃ ɪ k ə n z
chicks	t͡ʃ ˈɪ k s
chief	t͡ʃ ˈi f
chihuahua	t͡ʃ ɪ w ˈɑ w ˌɑ
child	t͡ʃ ˈa ɪ l d
child's	t͡ʃ ˈa ɪ l d z
children	t͡ʃ ˈɪ l d ɹ ə n
children's	t͡ʃ ˈɪ l d ɹ ə n z
childrens	t͡ʃ ɪ l d ɹ ə n z
chili	t͡ʃ ˈɪ l l i
chill	t͡ʃ ˈɪ l
chilli	t͡ʃ ˈɪ l i
chills	t͡ʃ ˈɪ l z
chilly	t͡ʃ ˈɪ l l i
chimed	t͡ʃ ˈa ɪ m d
chimp	t͡ʃ ˈɪ m p
chimpanzees	t͡ʃ ˈɪ m p ˈæ n z ˈi z
chin	t͡ʃ ˈɪ n
china	t͡ʃ ˈa ɪ n ə
chinese	t͡ʃ a ɪ n ˈi z
chip	t͡ʃ ˈɪ p
chipper	t͡ʃ ˈɪ p p ɚ
chipping	t͡ʃ ˌi p ˌi ŋ
chips	t͡ʃ ˈɪ p s
chirp	t͡ʃ ˈɚ p
chirping	t͡ʃ ˈɚ p ɪ ŋ
chirps	t͡ʃ ˈɚ p s
chirruping	t͡ʃ ˈɪ ɹ ɹ ˌu p p ɪ ŋ
chocolate	t͡ʃ ˈɔ k ə l ɪ t
choice	t͡ʃ ˈɔ ɪ s
choir	k w ˈa ɪ ɚ
chomp	t͡ʃ ˈɑ m p
chomps	k ˈɑ m p s
choo	t͡ʃ ˈu
choose	t͡ʃ ˈu z
chooses	t͡ʃ ˈu z ɪ z
choosey	t͡ʃ ˈu s i
choosing	t͡ʃ ˈu z ɪ ŋ
chop	t͡ʃ ˈɑ p
chopping	t͡ʃ ˈɑ p ɪ ŋ
chops	t͡ʃ ˈɑ p s
chopstick	t͡ʃ ˈɑ p s t ˌɪ k
chopsticks	t͡ʃ ˈɑ p s t ˌɪ k s
chore	t͡ʃ ˈɔ ɹ
chores	t͡ʃ ˈɔ ɹ z
chorus	k ˈɔ ɹ ə s
choruses	k ˈɔ ɹ ə s ɪ z
chose	t͡ʃ ˈo ʊ z
chosen	t͡ʃ ˈo ʊ z ə n
choses	t͡ʃ ˈo ʊ z ə z
chow	t͡ʃ ˈa ʊ
chows	t͡ʃ ˈa ʊ z
christmas	k ɹ ˈɪ s m ə s
chuck	t͡ʃ ˈʌ k
chucking	t͡ʃ ˈʌ k ɪ ŋ
chuckle	t͡ʃ ˈʌ k ə l
chuckled	t͡ʃ ˈʌ k ə l d
chucks	t͡ʃ ˈʌ k s
chuff	t͡ʃ ˈʌ f
chuffed	t͡ʃ ˈʌ f t
chum	t͡ʃ ʌ m
chunk	t͡ʃ ˈʌ ŋ k
chunks	t͡ʃ ˈʌ ŋ k s
chunky	t͡ʃ ˈʌ ŋ k i
church	t͡ʃ ˈɚ t͡ʃ
churn	t͡ʃ ˈɚ n
chute	ʃ ˈu t
cicada	s ɪ k ˈe ɪ d ə
cicadas	s ɪ k ˈe ɪ d ə z
cinders	s i n d ə z
circle	s ˈɚ k ə l
circles	s ˈɚ k ə l z
circuit	s ˈɚ k ɪ t
circus	s ˈɚ k ə s
circuses	s ɚ k ə s ə z
cities	s ˈɪ t i z
city	s ˈɪ t i
civil	s ˈɪ v ə l
claim	k l ˈe ɪ m
claimed	k l ˈe ɪ m d
clan	k l ˈæ n
clang	k l ˈæ ŋ
clank	k l ˈæ ŋ k
clanks	k l ˈæ n k s
clap	k l ˈæ p
clapping	k l ˈæ p ɪ ŋ
claps	k l ˈæ p s
clash	k l ˈæ ʃ
clashes	k l ˈæ ʃ ɪ z
class	k l ˈæ s
classes	k l ˈæ s ɪ z
classmate	k l ˈæ s m ˌe ɪ t
classmates	k l ˈæ s m ˌe ɪ t s
classroom	k l ˈæ s ɹ ˌu m
clatter	k l ˈæ t ɚ
claw	k l ˈɔ
claws	k l ˈɔ z
clay	k l ˈe ɪ
clean	k l ˈi n
cleaned	k l ˈi n d
cleaner	k l ˈi n ɚ
cleaning	k l ˈi n ɪ ŋ
cleans	k l ˈi n z
cleanup	k l ˈi n ˌʌ p
clear	k l ˈɪ ɹ
cleared	k l ˈɪ ɹ d
clearing	k l ˈɪ ɹ ɪ ŋ
clearly	k l ˈɪ ɹ l i
clears	k l ˈɪ ɹ z
clench	k l ˈɛ n t͡ʃ
clenching	k l ˈɛ n t͡ʃ ɪ ŋ
cleric	k l ˈɛ ɹ ɪ k
clever	k l ˈɛ v ɚ
click	k l ˈɪ k
clicked	k l ˈɪ k t
clicking	k l ˈɪ k ɪ ŋ
clicks	k l ˈɪ k s
client	k l ˈa ɪ ə n t
clients	k l ˈa ɪ ə n t s
cliff	k l ˈɪ f
cliffs	k l ˈɪ f s
climate	k l ˈa ɪ m ɪ t
climb	k l ˈa ɪ m
climbed	k l ˈa ɪ m d
climber	k l ˈa ɪ m ɚ
climbers	k l ˈa ɪ m ə ɹ z
climbing	k l ˈa ɪ m ɪ ŋ
climbs	k l ˈa ɪ m z
cling	k l ˈɪ ŋ
clinging	k l ˈɪ ŋ ɪ ŋ
clings	k l ˈɪ ŋ z
clinic	k l ˈɪ n ɪ k
clink	k l ˈɪ ŋ k
clip	k l ˈɪ p
clips	k l ˈɪ p s
cloak	k l ˈo ʊ k
clobbered	k l ˈɑ b ɚ d
clobbering	k l ˈɑ b ɚ ɹ ɪ ŋ
clock	k l ˈɑ k
clocks	k l ˈɑ k s
clockwise	k l ˈɑ k w ˌa ɪ z
close	k l ˈo ʊ z
close	k l ˈo ʊ s
closed	k l ˈo ʊ z d
closely	k l ˈo ʊ s l i
closer	k l ˈo ʊ s ɚ
closer	k l ˈo ʊ z ɚ
closes	k l ˈo ʊ z ə z
closest	k l ˈo ʊ s ɪ s t
closing	k l ə ʊ z ɪ ŋ
closure	k l ˈo ʊ ʒ ɚ
cloth	k l ˈɔ θ
clothe	k l ˈo ʊ ð
clothes	k l ˈo ʊ ð z
clothing	k l ˈo ʊ ð ɪ ŋ
cloths	k l ˈɔ θ s
cloud	k l ˈa ʊ d
clouds	k l ˈa ʊ d z
cloudy	k l ˈa ʊ d i
cloven	k l ˈo ʊ v ə n
clown	k l ˈa ʊ n
club	k l ˈʌ b
clubs	k l ˈʌ b z
cluck	k l ˈʌ k
clucked	k l ˈʌ k t
clucking	k l ʌ k ɪ ŋ
clucks	k l ˈʌ k s
clue	k l ˈu
clues	k l ˈu z
clump	k l ˈʌ m p
clumps	k l ˈʌ m p s
clunk	k l ˈʌ ŋ k
co-ordinates	k ˌo ʊ ˌɔ ɹ d ə n ə t s
coach	k ˈo ʊ t͡ʃ
coal	k ˈo ʊ l
coalesce	k ˌo ʊ ə l ˈɛ s
coast	k ˈo ʊ s t
coastal	k ˈo ʊ s t ə l
coasting	k ˈo ʊ s t ɪ ŋ
coasts	k ˈo ʊ s t s
coat	k ˈo ʊ t
coated	k ˈo ʊ t ɪ d
coats	k ˈo ʊ t s
coax	k ˈo ʊ æ k s
cob	k ˈɑ b
cobble	k ˈɑ b ə l
cobblestone	k ˈɑ b ə l s t ˌo ʊ n
cobs	k ˈɑ b z
cobwebs	k ˈɑ b w ˌɛ b z
cocoa	k ˈo ʊ k o ʊ
coconut	k ˈo ʊ k ə n ˌʌ t
coconuts	k ˈo ʊ k ə n ˌʌ t s
cocoon	k ə k ˈu n
cod	k ˈɑ d
code	k ˈo ʊ d
codes	k ˈo ʊ d z
coexist	k ˌo ʊ ə ɡ z ˈɪ s t
coffee	k ˈɔ f i
cog	k ˈɔ ɡ
cogs	k ˈɑ ɡ z
coil	k ˈɔ ɪ l
coiled	k ˈɔ ɪ l d
coils	k ˈɔ ɪ l z
coin	k ˈɔ ɪ n
coins	k ˈɔ ɪ n z
cold	k ˈo ʊ l d
colder	k ˈo ʊ l d ɚ
collar	k ˈɑ l ɚ
collars	k ˈɑ l l ˈɚ z
colleague	k ˈɑ l i ɡ
colleagues	k ˈɑ l i ɡ z
collect	k ə l ˈɛ k t
collected	k ə l ˈɛ k t ɪ d
collecting	k ə l ˈɛ k t ɪ ŋ
collection	k ə l ˈɛ k ʃ ə n
collects	k ə l ˈɛ k t s
collie	k ˈɑ l i
collies	k ˈɑ l i z
collision	k ə l ˈɪ ʒ ə n
cologne	k ə l ˈo ʊ n
color	k ˈʌ l ɚ
colored	k ˈʌ l ɚ d
colorful	k ˈʌ l ɚ f ə l
coloring	k ˈʌ l ɚ ɪ ŋ
colors	k ˈʌ l ɚ z
colour	k ˈʌ l ɚ
coloured	k ˈʌ l ɚ d
colourful	k ˈo ʊ l ɚ f ə l
colouring	k ˈʌ l l ɚ ɹ ɪ ŋ
colours	k ˈʌ l l ɚ z
colt	k ˈo ʊ l t
column	k ˈɑ l ə m
com	k ˈɑ m
comb	k ˈo ʊ m
combat	k ˈɑ m b æ t
combine	k ˈɑ m b a ɪ n
combine	k ə m b ˈa ɪ n
combined	k ə m b ˈa ɪ n d
combines	k ə m b ˈa ɪ n z
combs	k ˈo ʊ m z
come	k ˈʌ m
comes	k ˈʌ m z
comfort	k ˈʌ m f ɚ t
comfortable	k ˈʌ m f ɚ t ə b ə l
comforting	k ˈʌ m f ɚ t ɪ ŋ
comfy	k ʌ m f ˈi
coming	k ˈʌ m ɪ ŋ
command	k ə m ˈæ n d
commanded	k ə m ˈæ n d ə d
commanding	k ə m æ n d ɪ ŋ
comment	k ˈɑ m ɛ n t
comments	k ˈɑ m m ɛ n t s
commission	k ə m ˈɪ ʃ ə n
common	k ˈɑ m ə n
commonly	k ˈɑ m ə n l i
commons	k ˈɑ m ə n z
commotion	k ə m o ʊ ʃ ə n
commune	k ˈɑ m j u n
commune	k ə m j ˈu n
communes	k ə m j ˈu n z
communes	k ˈɑ m j u n z
communicate	k ə m j ˈu n ɪ k ˌe ɪ t
communities	k ə m j ˈu n ɪ t i z
community	k ə m j ˈu n ɪ t i
compact	k ə m p ˈæ k t
compact	k ˈɑ m p æ k t
compacted	k ə m p ˈæ k t ɪ d
compacts	k ə m p ˈæ k t s
compacts	k ˈɑ m p æ k t s
companies	k ˈʌ m p ə n i z
company	k ˈʌ m p ə n i
compared	k ə m p ˈɛ ɹ d
comparison	k ə m p ˈɛ ɹ ə s ə n
comparitors	k ə m p ˈæ ɹ ɪ t ə z
compass	k ˈʌ m p ə s
compasses	k ˈɑ m p ˈæ s ɪ z
compatible	k ə m p ˈæ t ə b ə l
compatibles	k ə m p ˈæ t ɪ b ə l z
compel	k ə m p ˈɛ l
compels	k ə m p ˈɛ l z
compete	k ə m p ˈi t
competence	k ˈɑ m p ə t ɪ n s
competitions	k ɑ m p ə t ˈɪ ʒ ə n z
competitive	k ə m p ˈɛ t ɪ t ɪ v
complain	k ə m p l ˈe ɪ n
complained	k ə m p l ˈe ɪ n d
complaint	k ə m p l ˈe ɪ n t
complete	k ə m p l ˈi t
completed	k ə m p l ˈi t ɪ d
completely	k ə m p l ˈi t l i
complex	k ə m p l ˈɛ k s
complex	k ˈɑ m p l ɛ k s
complexion	k ə m p l ˈɛ k ʃ ə n
compliments	k ˈɑ m p l ə m ɛ n t s
composter	k ˈɑ m p ˈɑ s t ɚ
compound	k ˈɑ m p a ʊ n d
compound	k ə m p ˈa ʊ n d
compounded	k ə m p a ʊ n d ɪ d
compress	k ə m p ɹ ˈɛ s
compress	k ˈɑ m p ɹ ɛ s
compresses	k ə m p ɹ ˈɛ s s ɪ z
compresses	k ˈɑ m p ɹ ɛ s s ɪ z
computer	k ə m p j ˈu t ɚ
con	k ˈɑ n
conceals	k ɑ n s ˈi l z
conceited	k ə n s i t ɪ d
conceive	k ə n s ˈi v
concern	k ə n s ˈɚ n
concerned	k ə n s ˈɚ n d
concerns	k ə n s ˈɚ n z
concert	k ˈɑ n s ɚ t
concert	k ə n s ˈɚ t
concerts	k ˈɑ n s ɚ t s
concerts	k ə n s ˈɚ t s
conclusion	k ə ŋ k l ˈu ʒ ə n
concoction	k ə ŋ k ɑ k ʃ ə n
concur	k ə n k ˈɚ
condemning	k ə n d ˈɛ m ɪ ŋ
condition	k ə n d ˈɪ ʃ ə n
conditions	k ə n d ˈɪ ʃ ə n z
conduct	k ə n d ˈʌ k t
conduct	k ˈɑ n d ʌ k t
conductor	k ə n d ˈʌ k t ɚ
cone	k ˈo ʊ n
conencted	k ə n ˈɛ k t ɪ d
cones	k ˈo ʊ n z
confess	k ə n f ˈɛ s
confetti	k ə n f ˈɛ t i
confidence	k ˈɑ n f ə d ə n s
confident	k ˈɑ n f ə d ə n t
confidently	k ˈɑ n f ə d ə n t l i
confines	k ə n f ˈa ɪ n z
confines	k ˈɑ n f a ɪ n z
confirm	k ə n f ˈɚ m
confirmed	k ə n f ˈɚ m d
confirms	k ə n f ɚ m z
confiscated	k ˈɑ n f ə s k ˌe ɪ t ɪ d
conflict	k ə n f l ˈɪ k t
conflict	k ˈɑ n f l ɪ k t
conflicts	k ə n f l ˈɪ k t s
conflicts	k ˈɑ n f l ɪ k t s
confused	k ə n f j ˈu z d
confusing	k ə n f j ˈu z ɪ ŋ
confusion	k ə n f j ˈu ʒ ə n
connect	k ə n ˈɛ k t
connected	k ə n ˈɛ k t ɪ d
connection	k ə n ˈɛ k ʃ ə n
connections	k ə n ˈɛ k ʃ ə n z
connects	k ə n ˈɛ k t s
cons	k ˈɑ n z
conscript	k ˈɑ n s k ɹ ˌɪ p t
conscript	k ə n s k ɹ ˈɪ p t
conscripts	k ˈɑ n s k ɹ ɪ p t s
conscripts	k ə n s k ɹ ˈɪ p t s
consequence	k ˈɑ n s ə k w ə n s
consequences	k ˈɑ n s ə k w ˌɛ n s ɪ z
consider	k ə n s ˈɪ d ɚ
considered	k ə n s ˈɪ d ɚ d
considering	k ə n s ˈɪ d ɚ ɹ ɪ ŋ
console	k ˈɑ n s o ʊ l
console	k ə n s ˈo ʊ l
consoles	k ə n s ˈo ʊ l z
consoles	k ˈɑ n s o ʊ l z
consonant	k ˈɑ n s ə n ə n t
consort	k ə n s ˈɔ ɹ t
consort	k ˈɑ n s ɔ ɹ t
constellation	k ˌɑ n s t ə l ˈe ɪ ʃ ə n
constellations	k ˌɑ n s t ə l ˈe ɪ ʃ ə n z
construct	k ə n s t ɹ ˈʌ k t
construct	k ˈɑ n s t ɹ ʌ k t
construction	k ə n s t ɹ ˈʌ k ʃ ə n
constructs	k ˈɑ n s t ɹ ʌ k t s
constructs	k ə n s t ɹ ˈʌ k t s
consult	k ˈɑ n s ʌ l t
consumed	k ə n s ˈu m d
consummate	k ˈɑ n s ə m m ɪ t
consummate	k ˈɑ n s ə m m ˌe ɪ t
contact	k ˈɑ n t ˌæ k t
content	k ə n t ˈɛ n t
content	k ˈɑ n t ɛ n t
contented	k ə n t ˈɛ n t ɪ d
contents	k ə n t ˈɛ n t s
contents	k ˈɑ n t ɛ n t s
contest	k ˈɑ n t ɛ s t
contest	k ə n t ˈɛ s t
contests	k ˈɑ n t ɛ s t s
contests	k ə n t ˈɛ s t s
continue	k ə n t ˈɪ n j u
continued	k ə n t ˈɪ n j u d
continues	k ə n t ˈɪ n j u z
contract	k ˈɑ n t ɹ ˌæ k t
contract	k ə n t ɹ ˈæ k t
contracts	k ə n t ɹ ˈæ k t s
contracts	k ˈɑ n t ɹ ˌæ k t s
contraption	k ə n t ɹ ˈæ p ʃ ə n
contraptions	k ə n t ɹ ˌæ p ʃ ə n s
contrast	k ˈɑ n t ɹ æ s t
contrast	k ə n t ɹ ˈæ s t
contrasts	k ə n t ɹ ˈæ s t s
contrasts	k ˈɑ n t ɹ æ s t s
contribute	k ə n t ɹ ˈɪ b j u t
control	k ə n t ɹ ˈo ʊ l
controls	k ə n t ɹ ˈo ʊ l z
convene	k ə n v ˈi n
conversation	k ˌɑ n v ɚ s ˈe ɪ ʃ ə n
conversations	k ˌɑ n v ɚ s ˈe ɪ ʃ ə n z
converse	k ə n v ˈɚ s
converse	k ˈɑ n v ɚ s
convert	k ˈɑ n v ɚ t
convert	k ə n v ˈɚ t
converts	k ˈɑ n v ɚ t s
converts	k ə n v ˈɚ t s
convict	k ˈɑ n v ɪ k t
convict	k ə n v ˈɪ k t
convicts	k ˈɑ n v ɪ k t s
convicts	k ə n v ˈɪ k t s
convince	k ə n v ˈɪ n s
convinced	k ə n v ˈɪ n s t
cook	k ˈʊ k
cooked	k ˈʊ k t
cookie	k ˈʊ k i
cookies	k ˈʊ k i z
cooking	k ˈʊ k ɪ ŋ
cooks	k ˈʊ k s
cool	k ˈu l
cooled	k ˈʊ l d
cooler	k ˈu l ɚ
coop	k ˈu p
cooperate	k o ʊ ˈɑ p ɚ ˌe ɪ t
coordinate	k o ʊ ˈɔ ɹ d ɪ n ˌe ɪ t
coordinate	k o ʊ ˈɔ ɹ d ɪ n ɪ t
coordinates	k o ʊ ˈɔ ɹ d ɪ n ˌe ɪ t s
coordinates	k o ʊ ˈɔ ɹ d ɪ n ɪ t s
coordinating	k o ʊ ˈɔ ɹ d ɪ n ˌe ɪ t ɪ ŋ
cop	k ˈɑ p
cope	k ˈo ʊ p
copies	k ˈɑ p i z
copilot	k ˈo ʊ p a ɪ l ə t
cops	k ˈɑ p s
copy	k ˈɑ p i
copying	k ˈɑ p i ɪ ŋ
copyright	k ˈɑ p i ɹ ˌa ɪ t
coral	k ˈɔ ɹ ə l
corals	k ˈɔ ɹ ə l z
cord	k ˈɔ ɹ d
corgi	k ˈɔ ɹ ɡ i
corn	k ˈɔ ɹ n
corner	k ˈɔ ɹ n ɚ
corners	k ˈɔ ɹ n ɚ z
correct	k ɚ ɹ ˈɛ k t
corrected	k ɚ ˈɛ k t ɪ d
corrugated	k ˈɔ ɹ ə ɡ ˌe ɪ t ɪ d
cos	k ˈɔ s
cost	k ˈɔ s t
costs	k ˈɔ s t s
costume	k ˈɔ s t u m
cosy	k ˈo ʊ z i
cot	k ˈɑ t
cotton	k ˈɑ t ə n
couch	k ˈa ʊ t͡ʃ
couches	k ˈa ʊ t͡ʃ ɪ z
cough	k ˈɔ f
coughs	k ˈɔ f s
could	k ˈʊ d
couldn't	k ˈʊ d ə n t
couldnt	k ˈa ʊ l d n t
count	k ˈa ʊ n t
counter	k ˈa ʊ n t ɚ
counting	k ˈa ʊ n t ɪ ŋ
countries	k ˈʌ n t ɹ i z
country	k ˈʌ n t ɹ i
country's	k ɑ n t ɹ ˈi z
counts	k ˈa ʊ n t s
couple	k ˈʌ p ə l
courage	k ˈɚ ɪ d͡ʒ
course	k ˈɔ ɹ s
court	k ˈɔ ɹ t
cousin	k ˈʌ z ə n
cousins	k ˈʌ z ə n z
cover	k ˈʌ v ɚ
covered	k ˈʌ v ɚ d
covering	k ˈʌ v v ɚ ɹ ɪ ŋ
cow	k ˈa ʊ
cowardly	k ˈa ʊ w ɚ d l i
cows	k ˈa ʊ z
coy	k ˈɔ ɪ
cozy	k ˈo ʊ z i
crab	k ɹ ˈæ b
crab's	k ɹ ˈæ b z
crabs	k ɹ ˈæ b z
crack	k ɹ ˈæ k
cracker	k ɹ ˈæ k ɚ
crackle	k ɹ ˈæ k ə l
cracks	k ɹ ˈæ k s
cradle	k ɹ ˈe ɪ d ə l
cradles	k ɹ ˈe ɪ d ə l z
craft	k ɹ ˈæ f t
crafting	k ɹ ˈæ f t ɪ ŋ
crafts	k ɹ ˈæ f t s
cramped	k ɹ ˈæ m p t
crane	k ɹ ˈe ɪ n
crank	k ɹ ˈæ ŋ k
cranky	k ɹ ˈæ ŋ k i
crash	k ɹ ˈæ ʃ
crashed	k ɹ ˈæ ʃ t
crashes	k ɹ ˈæ ʃ ɪ z
crate	k ɹ ˈe ɪ t
crater	k ɹ ˈe ɪ t ɚ
craters	k ɹ ˈe ɪ t ɚ z
crates	k ɹ ˈe ɪ t s
crawl	k ɹ ˈɔ l
crawled	k ɹ ˈɔ l d
crawling	k ɹ ˈɔ l ɪ ŋ
crawls	k ɹ ˈɔ l z
crayon	k ɹ ˈe ɪ ˌɑ n
craze	k ɹ ˈe ɪ z
crazes	k ɹ ˈe ɪ z ə z
crazy	k ɹ ˈe ɪ z i
creak	k ɹ ˈi k
creaked	k ɹ ˈi k t
creaks	k ɹ ˈi k s
cream	k ɹ ˈi m
creams	k ɹ ˈi m z
create	k ɹ i ˈe ɪ t
created	k ɹ i ˈe ɪ t ɪ d
creates	k ɹ i ˈe ɪ t s
creating	k ɹ i ˈe ɪ t ɪ ŋ
creation	k ɹ i ˈe ɪ ʃ ə n
creative	k ɹ i ˈe ɪ t ɪ v
creature	k ɹ ˈi t͡ʃ ɚ
creatures	k ɹ ˈi t͡ʃ ɚ z
creek	k ɹ ˈi k
creeks	k ɹ ˈi k s
creep	k ɹ ˈi p
creeper	k ɹ ˈi p ɚ
creepers	k ɹ ˈi p ə ɹ z
creepier	k ɹ ˈi p i ɚ
creeping	k ɹ ˈi p ɪ ŋ
creepy	k ɹ ˈi p i
crept	k ɹ ˈɛ p t
crest	k ɹ ˈɛ s t
crew	k ɹ ˈu
crick	k ɹ ˈɪ k
cricket	k ɹ ˈɪ k ɪ t
crickets	k ɹ ˈɪ k ɪ t s
cried	k ɹ ˈa ɪ d
cries	k ɹ ˈa ɪ z
cringed	k ɹ ˈɪ n d͡ʒ d
crinkly	k ɹ ɪ n k ə l ˈi
crisp	k ɹ ˈɪ s p
crispy	k ɹ ɪ s p i
critically	k ɹ ˈɪ t ɪ k l i
critter	k ɹ ˈɪ t ɚ
critters	k ɹ ˈɪ t ɚ z
croc	k ɹ ˈɑ k
croc's	k ɹ ˈɑ k s
crocodile	k ɹ ˈɑ k ə d ˌa ɪ l
crocodile's	k ɹ ˈɑ k ə d ˌa ɪ l z
crocodiles	k ɹ ˈɑ k ə d ˌa ɪ l z
crocs	k ɹ ˈɑ k s
crook	k ɹ ˈʊ k
crooked	k ɹ ˈʊ k ɪ d
crooked	k ɹ ˈʊ k t
crop	k ɹ ˈɑ p
crops	k ɹ ˈɑ p s
cross	k ɹ ˈɔ s
crossbow	k ɹ ˈɔ s b o ʊ
crossing	k ɹ ˈɔ s ɪ ŋ
crosswise	k ɹ ˈɔ s w ˌa ɪ z
crouch	k ɹ ˈa ʊ t͡ʃ
crouched	k ɹ ˈa ʊ t͡ʃ t
crouches	k ɹ ˈa ʊ t͡ʃ ɪ z
crow	k ɹ ˈo ʊ
crowd	k ɹ ˈa ʊ d
crowded	k ɹ ˈa ʊ d ɪ d
crowds	k ɹ ˈa ʊ d z
crown	k ɹ ˈa ʊ n
crowned	k ɹ ˈa ʊ n d
crowning	k ɹ ˈa ʊ n ɪ ŋ
crowns	k ɹ ˈa ʊ n z
crows	k ɹ ˈo ʊ z
cruel	k ɹ ˈu l
cruelty	k ɹ ˈu ə l t i
cruise	k ɹ ˈu z
cruises	k ɹ ˈu z ɪ z
crumb	k ɹ ˈʌ m
crumbs	k ɹ ˈʌ m z
crunch	k ɹ ˈʌ n t͡ʃ
crunches	k ɹ ˈʌ n t͡ʃ ɪ z
crunching	k ɹ ˈʌ n t͡ʃ ɪ ŋ
crush	k ɹ ˈʌ ʃ
crushed	k ɹ ˈʌ ʃ t
crusher	k ɹ ˈʌ ʃ ɚ
crushes	k ɹ ˈʌ ʃ ɪ z
crushing	k ɹ ˈʌ ʃ ɪ ŋ
crust	k ɹ ʌ s t
cry	k ɹ ˈa ɪ
crying	k ɹ ˈa ɪ ɪ ŋ
crystal	k ɹ ˌi s t ə l
crystals	k ɹ ˈɪ s t ə l z
cub	k ˈʌ b
cubs	k ˈʌ b z
cuckoo	k ˈu k ˌu
cuckoo's	k ˈu k u z
cuckoos	k ˈu k u z
cucumber	k j ˈu k ʌ m b ɚ
cucumbers	k j ˈu k ʌ m b ɚ z
cud	k ʌ d
cuddle	k ˈʌ d ə l
cuddles	k ˈʌ d l z
culprit	k ˈʌ l p ɹ ɪ t
culprits	k ˈʌ l p ɹ ɪ t s
culture	k ˈʌ l t͡ʃ ɚ
cup	k ˈʌ p
cupboard	k ˈʌ b ɚ d
cupboards	k ˈʌ b ɚ d z
cups	k ˈʌ p s
curate	k j ˈʊ ɹ ɪ t
curate	k j ˈʊ ɹ e ɪ t
cure	k j ˈʊ ɹ
cured	k j ˈʊ ɹ d
curious	k j ˈʊ ɹ i ə s
curl	k ˈɚ l
curled	k ˈɚ l d
curls	k ˈɚ l z
curly	k ˈɚ l i
current	k ˈɚ ə n t
curry	k ˈɚ i
curse	k ˈɚ s
cursed	k ˈɚ s t
curtain	k ˈɚ t ə n
curve	k ˈɚ v
curved	k ˈɚ v d
curves	k ˈɚ v z
curving	k ˈɚ v ɪ ŋ
custody	k ˈʌ s t ə d i
customer	k ˈʌ s t ə m ɚ
cut	k ˈʌ t
cute	k j ˈu t
cuteness	k j ˈu t n ə s
cuts	k ˈʌ t s
cutting	k ˈʌ t ɪ ŋ
cuttlefish	k ˈʌ t ə l f ˌɪ ʃ
cycle	s ˈa ɪ k ə l
cycles	s ˈa ɪ k ə l z
d	d ˈi
dab	d ˈæ b
dabs	d ˈæ b z
dad	d ˈæ d
dad's	d ˈæ d z
daddy	d ˈæ d i
dads	d ˈæ d z
daffodils	d ˈæ f ˈo ʊ d ˈɪ l z
daily	d ˈe ɪ l i
daintily	d ˈe ɪ n t ɪ l i
daisies	d ˈe ɪ z i z
daisy	d ˈe ɪ z i
dam	d ˈæ m
damage	d ˈæ m ɪ d͡ʒ
damages	d ˈæ m ɪ d͡ʒ ɪ z
dame	d ˈe ɪ m
damp	d ˈæ m p
dampen	d ˈæ m p ə n
dams	d ˈæ m z
dan	d ˈæ n
dan's	d ˈæ n z
dance	d ˈæ n s
danced	d ˌæ n s d
dancer	d ˈæ n s ɚ
dancers	d æ n s ə z
dances	d ˈæ n s ɪ z
dancing	d ˈæ n s ɪ ŋ
dandelions	d ˈæ n d ə l ˌa ɪ ə n z
dander	d ˈæ n d ɚ
danger	d ˈe ɪ n d͡ʒ ɚ
dangerous	d ˈe ɪ n d͡ʒ ɚ ɹ ə s
dangers	d ˌe ɪ n d͡ʒ ə ɹ z
dangle	d ˈæ ŋ ɡ ə l
dangling	d ˈæ ŋ ɡ l ɪ ŋ
dank	d ˈæ ŋ k
dare	d ˈɛ ɹ
dark	d ˈɑ ɹ k
darker	d ˈɑ ɹ k k ɚ
darkey	d ˈɑ ɹ k i
darkness	d ˈɑ ɹ k n ə s
darn	d ˈɑ ɹ n
darren	d ˈɑ ɹ ə n
darren's	d ˈɔ ɹ ɹ ə n z
darrens	d ˈɑ ɹ ə n z
dart	d ˈɑ ɹ t
darted	d ˈɑ ɹ t ɪ d
darting	d ˈɑ ɹ t ɪ ŋ
darts	d ˈɑ ɹ t s
dash	d ˈæ ʃ
dash's	d ˈæ ʃ ə z
dashed	d ˈæ ʃ t
dashes	d ˈæ ʃ ɪ z
data	d ˈæ t ə
date	d ˈe ɪ t
daub	d ˈɔ b
daubs	d ˈa ʊ b z
daughter	d ˈɔ t ɚ
david's	d ˈe ɪ v ɪ d z
dawn	d ˈɔ n
day	d ˈe ɪ
day's	d ˈe ɪ z
daydream	d ˈe ɪ d ɹ ˌi m
daylight	d ˈe ɪ l ˌa ɪ t
days	d ˈe ɪ z
daytime	d ˈe ɪ t ˈa ɪ m
dead	d ˈɛ d
deadly	d ˈɛ d l i
deafening	d ˈɛ f ə n ɪ ŋ
deal	d ˈi l
dealing	d i l ɪ ŋ
dealt	d ˈɛ l t
dear	d ˈɪ ɹ
dears	d ˈe ɪ ɹ z
death	d ˈɛ θ
deb	d ˈɛ b
debrief	d ɪ b ɹ ˈi f
debris	d ɪ b ɹ ˈi
debt	d ˈɛ t
deceit	d ɪ s ˈi t
decent	d ˈi s ə n t
decide	d ɪ s ˈa ɪ d
decided	d ɪ s ˈa ɪ d ɪ d
decides	d ɪ s ˈa ɪ d z
decision	d ɪ s ˈɪ ʒ ə n
deck	d ˈɛ k
declared	d ˌi k l ˈæ ɹ d
declares	d ɪ k l ˈɛ ɹ z
decor	d ˈe ɪ k ɔ ɹ
decorate	d ˈɛ k k ɚ ɹ ˌe ɪ t
decorates	d ɪ k ɚ ɹ ˌe ɪ t s
decorating	d ˈɛ k ɚ ˌe ɪ t ɪ ŋ
decoration	d ˌɛ k ɚ ɹ e ɪ ʃ n
decorations	d ɛ k ə ɹ ˌe ɪ t͡ʃ ə n z
decorative	d ˈɛ k ɹ ɪ t ɪ v
decrease	d ˈi k ɹ ˌi s
decrease	d ɪ k ɹ ˈi s
decreases	d ˈi k ɹ ˌi s ɪ z
decreases	d ɪ k ɹ ˈi s ɪ z
deed	d ˈi d
deeds	d ˈi d z
deep	d ˈi p
deeper	d ˈi p ɚ
deepest	d ˈi p ə s t
deeply	d ˈi p l ˈi
deepslate	d ˈi p s l ˈe ɪ t
deer	d ˈɪ ɹ
defeated	d ɪ f ˈi t ɪ d
defect	d ɪ f ˈɛ k t
defect	d ˈi f ɛ k t
defects	d ˈi f ɛ k t s
defects	d ɪ f ˈɛ k t s
defend	d ɪ f ˈɛ n d
defended	d ɪ f ˈɛ n d ɪ d
defends	d ɪ f ˈɛ n d z
defense	d ɪ f ˈɛ n s
definitely	d ˈɛ f f ɪ n ɪ t l i
deflate	d ɪ f l ˈe ɪ t
deflect	d ɪ f l ˈɛ k t
deflected	d ɪ f l ˈɛ k t ɪ d
deflects	d ɪ f l ˈɛ k t s
degenerate	d ɪ d͡ʒ ˈɛ n ɚ ˌe ɪ t
degenerate	d ɪ d͡ʒ ˈɛ n ɚ ɪ t
degenerates	d ɪ d͡ʒ ˈɛ n ɚ ɪ t s
degenerates	d ɪ d͡ʒ ˈɛ n ɚ ˌe ɪ t s
degree	d ɪ ɡ ɹ ˈi
degrees	d ə ɡ ɹ ˈi z
delegate	d ˈɛ l ə ɡ ɪ t
delegate	d ˈɛ l ə ɡ ˌe ɪ t
delegates	d ˈɛ l ə ɡ ˌe ɪ t s
delegates	d ˈɛ l ə ɡ ɪ t s
delhi	d ˈɛ l i
deliberate	d ɪ l ˈɪ b ɚ ɹ ˌe ɪ t
deliberate	d ɪ l ˈɪ b ɚ ɹ ɪ t
delicacy	d ˈɛ l ɪ k ə s i
delicious	d ɪ l ˈɪ ʃ ə s
delight	d ɪ l ˈa ɪ t
delighted	d ɪ l ˈa ɪ t ɪ d
delightful	d ɪ l ˈa ɪ t f ə l
delights	d ɪ l a ɪ t z
delivering	d ɪ l ˈɪ v ɚ ɹ ɪ ŋ
demand	d ɪ m ˈæ n d
demands	d ɪ m ˈæ n d z
demon	d ˈi m ə n
den	d ˈɛ n
denial	d ɪ n ˈa ɪ ə l
dens	d ˈɛ n z
dense	d ˈɛ n s
denser	d ˈɛ n s ɚ
dependable	d ɪ p ˈɛ n d ə b ə l
depo	d ˈi p o ʊ
depth	d ˈɛ p θ
depths	d ˈɛ p θ s
descended	d ɪ s ˈɛ n d ɪ d
description	d ɪ s k ɹ ˈɪ p ʃ ə n
descriptions	d ɪ s k ɹ ˈɪ p ʃ ə n z
desert	d ˈɛ z ɚ t
desert	d ɪ z ˈɚ t
deserts	d ɪ z ˈɚ t s
deserts	d ˈɛ z ɚ t s
deserved	d ɪ z ˈɚ v d
deserves	d ɪ z ɛ v z
design	d ɪ z ˈa ɪ n
designed	d ə z a ɪ n d d
designing	d ɪ z ˈa ɪ n ɪ ŋ
designs	d ə z ˈa ɪ n z
desire	d ɪ z ˈa ɪ ɚ
desired	d ɪ z ˈa ɪ ɚ d
desk	d ˈɛ s k
desks	d ˈɛ s k s
desolate	d ˈɛ s ə l ɪ t
desolate	d ˈɛ s ə l ˌe ɪ t
desolate	d ˈɛ s ə l ɪ t
despair	d ɪ s p ˈɛ ɹ
desperately	d ˈɛ s p ɚ ə t l i
destroy	d ɪ s t ɹ ˈɔ ɪ
destroyed	d ɪ s t ɹ ˈɔ ɪ d
destroying	d ɪ s t ɹ ˈɔ ɪ ɪ ŋ
destructive	d ɪ s t ɹ ˈʌ k t ɪ v
detach	d i t ˈæ t͡ʃ
detaches	d ɪ t ˈæ t͡ʃ ɪ z
detail	d ˈi t e ɪ l
details	d ˈi t e ɪ l z
detective	d ɪ t ˈɛ k t ɪ v
deter	d ɪ t ˈɚ
determine	d ɪ t ˈɚ m ə n
determined	d ɪ t ˈɚ m ə n d
deterred	d ɪ t ˈɚ d
detour	d ˈi t ʊ ɹ
develop	d ɪ v ˈɛ l ə p
developed	d ɪ v ˈɛ l ə p t
developing	d ɪ v ˈɛ l ə p ɪ ŋ
development	d ɪ v ˈɛ l ə p m ə n t
device	d ɪ v ˈa ɪ s
device's	d ɪ v ˈa ɪ s ɪ z
devices	d ɪ v ˈa ɪ s ɪ z
devil	d ˈɛ v ə l
devious	d i v i ə s
dew	d ˈu
dholes	d ˈo ʊ l z
di	d ˈi
di's	d ɪ z
diagonally	d a ɪ ˈæ ɡ ə n ə l i
dial	d ˈa ɪ l
dials	d ˈa ɪ l z
diamond	d ˈa ɪ ə m ə n d
diamonds	d ˈa ɪ m ə n d z
diane	d a ɪ ˈæ n
diane's	d a ɪ ˈæ n z
dib's	d ˈɪ b z
dibs	d ˈɪ b z
dice	d ˈa ɪ s
did	d ˈɪ d
didn't	d ˈɪ d ə n t
didnt	d ˈɪ d n t
die	d ˈa ɪ
died	d ˈa ɪ d
dies	d ˈa ɪ z
diet	d ˈa ɪ ə t
differ	d ˈɪ f ɚ
difference	d ˈɪ f ɹ ə n s
differences	d ˈɪ f ɹ ə n s ɪ z
different	d ˈɪ f ɹ ə n t
difficult	d ˈɪ f ɪ k ʌ l t
difficulty	d ˈɪ f ɪ k ʌ l t i
diffuse	d ɪ f f j ˈu s
diffuse	d ɪ f f j ˈu z
dig	d ˈɪ ɡ
digest	d a ɪ d͡ʒ ˈɛ s t
digger	d ˈɪ ɡ ɡ ɚ
digging	d ˈɪ ɡ ɡ ɪ ŋ
diggings	d ˈɪ ɡ ɪ ŋ z
dignity	d ˈɪ ɡ n ə t i
digs	d ˈɪ ɡ z
dilapidated	d ɪ l ˈæ p ɪ d ˌe ɪ t ɪ d
dilemma	d ɪ l ˈɛ m m ə
dilemmas	d ə l ˈɛ m ə z
dim	d ˈɪ m
din	d ˈɪ n
dinner	d ˈɪ n ɚ
dino	d ˈi n o ʊ
dinos	d ˈi n o ʊ z
dinosaur	d ˈa ɪ n ə s ˌɔ ɹ
dinosaur's	d ˈa ɪ n ə s ˌɔ ɹ z
dinosaurs	d ˈa ɪ n ə s ˌɔ ɹ z
dip	d ˈɪ p
dipped	d ˈɪ p t
dips	d ˈɪ p s
dire	d a ɪ ə
direction	d a ɪ ɹ ˈɛ k ʃ ə n
directions	d a ɪ ɹ ˈɛ k ʃ ə n z
directly	d a ɪ ɹ ɛ k t l ˌi
dirt	d ˈɚ t
dirty	d ˈɚ t i
dis	d ˈɪ s
disadvantaged	d ɪ s ə d v ɑ n t ɪ d͡ʒ d
disappear	d ˌɪ s ə p ˈɪ ɹ
disappearance	d ˌɪ s ə p ˈɪ ɹ ə n s
disappearances	d ˌɪ s s ə p ˈɪ ɹ ə n s ɪ z
disappeared	d ˌɪ s ə p ˈɪ ɹ d
disappears	d ˌi s ɑ p ˈɪ ɹ z
disappoint	d ˌɪ s ə p ˈɔ ɪ n t
disappointing	d ˌɪ s ə p ˈɔ ɪ n t ɪ ŋ
disapproving	d ɪ s ə p p ɹ ˈu v ɪ ŋ
disaster	d ɪ z ˈæ s t ɚ
disbelief	d ˌɪ s b ɪ l ˈi f
discomfort	d ɪ s k ˈʌ m f ɚ t
discount	d ˈɪ s k a ʊ n t
discounts	d ˈɪ s k a ʊ n t s
discover	d ɪ s k ˈʌ v ɚ
discovered	d ə s k ˈɑ v ə ɹ d
discovery	d ɪ s k ˈʌ v ɚ ɹ i
disease	d ɪ z ˈi z
diseases	d ɪ z ˈi z ɪ z
disguise	d ɪ s ɡ ˈa ɪ z
disgust	d ɪ s ɡ ˈʌ s t
disgusted	d ə s ɡ ˈʌ s t ə d
disgusting	d ɪ s ɡ ˈʌ s t ɪ ŋ
dish	d ˈɪ ʃ
dishes	d ˈɪ ʃ ɪ z
dishonest	d ɪ s ˈɑ n ɪ s t
disinfect	d ɪ s ɪ n f ˈɛ k t
dislike	d ɪ s l ˈa ɪ k
dislodge	d ɪ s l ˈɑ d͡ʒ
dislodges	d ɪ s l ˈɑ d͡ʒ ə z
disorder	d ɪ s ˈɔ ɹ d ɚ
disparity	d ɪ s p æ ɹ ɪ t i
dispose	d ɪ s p ˈo ʊ z
disquiet	d ɪ s k w ˈa ɪ ə t
disrupt	d ɪ s ɹ ˈʌ p t
dissection	d a ɪ s ˈɛ k ʃ ə n
distance	d ˈɪ s t ə n s
distances	d ˈɪ s t ə n s ə z
distant	d ˈɪ s t ə n t
distinct	d ɪ s t ˈɪ ŋ k t
distinctive	d ɪ s t ˈɪ ŋ k t ɪ v
distract	d ɪ s t ɹ ˈæ k t
distracted	d ɪ s t ɹ ˈæ k t ɪ d
distraction	d ɪ s t ɹ ˈæ k ʃ ə n
distracts	d ɪ s t ɹ ˈæ k t s
distraught	d ɪ s t ɹ ˈɔ t
disturb	d ɪ s t ˈɚ b
disturbed	d ɪ s t ˈɚ b d
disturbing	d ɪ s t ˈɚ b ɪ ŋ
disturbs	d ˌi s t ˈɚ b z
ditch	d ˈɪ t͡ʃ
ditches	d ɪ t ʃ ɪ z
dive	d ˈa ɪ v
diversity	d ɪ v ˈɚ s ɪ t i
dives	d ˈa ɪ v z
divine	d ɪ v ˈa ɪ n
diving	d ˈa ɪ v ɪ ŋ
division	d ɪ v ˈɪ ʒ ə n
divorce	d ɪ v ˈɔ ɹ s
diya	d ˈa ɪ j ə
dizziness	d ˈɪ z i n ə s
dizzy	d ˈɪ z i
dna	d ˈi ˈɛ n ˈe ɪ
do	d ˈu
do's	d ˈʊ z
dock	d ˈɑ k
doctor	d ˈɑ k t ɚ
doctor's	d ˈɑ k t ɚ z
doctors	d ˈɑ k t ɚ z
document	d ˈɑ k j ə m ə n t
document	d ˈɑ k j ə m ɛ n t
documents	d ˈɑ k j ə m ə n t s
documents	d ˈɑ k j ə m ɛ n t s
dodge	d ˈɑ d͡ʒ
dodged	d ˈɑ d͡ʒ d
dodo	d ˈo ʊ d o ʊ
does	d ˈʌ z
doesn't	d ˈʌ z ə n t
doesnt	d ˈʌ z ə n t
dog	d ˈɔ ɡ
dog's	d ˈɔ ɡ z
dogged	d ˈɔ ɡ ɡ ɪ d
dogged	d ˈɔ ɡ d
dogs	d ˈɔ ɡ z
doing	d ˈu ɪ ŋ
doll	d ˈɑ l
doll's	d ˈɑ l z
dollars	d ˈɑ l ɚ z
dolls	d ˈɑ l z
dolphin	d ˈɑ l f ə n
dolphins	d ˈɑ l f ə n z
domesticated	d ə m ˈɛ s t ɪ k ˌe ɪ t ɪ d
domino	d ˈɑ m ɪ n o ʊ
don	d ˈɑ n
don's	d ˈɑ n z
don't	d ˈo ʊ n t
done	d ˈʌ n
donkey	d ˈɔ ŋ k i
donkey's	d ˈɔ ŋ k i z
dont	d ˈɑ n t
door	d ˈɔ ɹ
doors	d ˈɔ ɹ z
doorstep	d ˈɔ ɹ s t ˌɛ p
doorway	d ˈɔ ɹ w ˈe ɪ
dora	d ˈɔ ɹ ə
dora's	d ˈɔ ɹ ə z
doras	d ˈɔ ɹ ə z
dot	d ˈɑ t
dots	d ˈɑ t s
dotted	d ˈɑ t ə d
double	d ˈʌ b ə l
doubled	d ˈʌ b ə l d
doubtful	d ˈa ʊ t f ə l
doubtless	d ˈa ʊ t l ə s
dove	d ˈʌ v
doves	d ˈʌ v z
dow	d ˈa ʊ
dowel	d ˈa ʊ ə l
down	d ˈa ʊ n
downheaded	d ˈa ʊ n h ˈi d ɪ d
download	d ˈa ʊ n l ˌo ʊ d
downloading	d ˈa ʊ n l ˌo ʊ d ɪ ŋ
downloads	d ˈa ʊ n l ˌo ʊ d z
downstairs	d ˈa ʊ n s t ˈɛ ɹ z
doze	d ˈo ʊ z
dr	d ɑ k t ə
draco	d ɹ ˈe ɪ k o ʊ
draft	d ɹ ˈæ f t
drafts	d ɹ ˈæ f t s
drag	d ɹ ˈæ ɡ
dragged	d ɹ ˈæ ɡ d
dragging	d ɹ ˈæ ɡ ɪ ŋ ɡ
dragon	d ɹ ˈæ ɡ ə n
dragon's	d ɹ ˈæ ɡ ə n z
dragon-like	d ɹ ˈæ ɡ ə n l ˈa ɪ k
dragonflies	d ɹ ˈæ ɡ ə n f l ˈi z
dragonfly	d ɹ ˈæ ɡ ə n f l i
dragons	d ɹ ˈæ ɡ ə n z
drags	d ɹ ˈæ ɡ z
drain	d ɹ ˈe ɪ n
drained	d ɹ ˈe ɪ n d
drains	d ɹ ˈe ɪ n z
drama	d ɹ ˈɑ m ə
dramas	d ɹ ɑ m ə z
drank	d ɹ ˈæ ŋ k
draught	d ɹ ˈæ f t
draughts	d ɹ ˈæ f t s
draw	d ɹ ˈɔ
drawer	d ɹ ˈɔ ɹ
drawers	d ɹ ˈɔ ɹ z
drawing	d ɹ ˈɔ ɪ ŋ
drawings	d ɹ ˈɔ ɪ ŋ z
drawn	d ɹ ˈɔ n
draws	d ɹ ˈɔ z
dread	d ɹ ˈɛ d
dreadful	d ɹ ˈɛ d f ə l
dream	d ɹ ˈi m
dreaming	d ɹ ˈi m ˈɪ ŋ
dreams	d ɹ ˈi m z
dreamt	d ɹ ˈɛ m t
dress	d ɹ ˈɛ s
dressed	d ɹ ˈɛ s t
dresses	d ɹ ˈɛ s s ɪ z
drew	d ɹ ˈu
dried	d ɹ ˈa ɪ d
drier	d ɹ ˈa ɪ ɚ
dries	d ɹ ˈa ɪ z
drift	d ɹ ˈɪ f t
drifting	d ɹ ˈɪ f t ɪ ŋ
drifts	d ɹ ˈɪ f t s
drink	d ɹ ˈɪ ŋ k
drinking	d ɹ ˈɪ ŋ k ɪ ŋ
drinks	d ɹ ˈɪ ŋ k s
drip	d ɹ ˈɪ p
drippy	d ɹ ˈɪ p p i
drips	d ɹ ˈɪ p s
drive	d ɹ ˈa ɪ v
driver	d ɹ ˈa ɪ v ɚ
drivers	d ɹ ˈa ɪ v ɚ z
drives	d ɹ ˈa ɪ v z
driveway	d ɹ ˈa ɪ v w ˌe ɪ
driving	d ɹ ˈa ɪ v ɪ ŋ
droid	d ɹ ˌɔ i d
drone	d ɹ ˈo ʊ n
droop	d ɹ ˈu p
drooped	d ɹ ˈu p t
droops	d ɹ ˈu p s
drop	d ɹ ˈɑ p
dropped	d ɹ ˈɑ p t
dropping	d ɹ ˈɑ p ɪ ŋ
drops	d ɹ ˈɑ p s
drought	d ɹ ˈa ʊ t
drove	d ɹ ˈo ʊ v
drown	d ɹ ˈa ʊ n
drowned	d ɹ ˈa ʊ n d
druid	d ɹ ˈʊ ə d
drum	d ɹ ˈʌ m
drums	d ɹ ˈʌ m z
dry	d ɹ ˈa ɪ
duck	d ˈʌ k
duckling	d ˈʌ k l ɪ ŋ
duckling's	d ˈʌ k l ɪ ŋ z
ducks	d ˈʌ k s
due	d ˈu
duet	d u ˈɛ t
duets	d u ˈɛ t s
dug	d ˈʌ ɡ
dull	d ˈʌ l
duller	d ʌ l ə
dump	d ˈʌ m p
dumps	d ˈʌ m p s
dune	d ˈu n
dunes	d ˈu n z
dung	d ˈʌ ŋ
dungeon	d ˈʌ n d͡ʒ ə n
dunk	d ˈʌ ŋ k
duo	d ˈu o ʊ
duplicate	d ˈu p l ɪ k ˌe ɪ t
duplicate	d ˈu p l ɪ k ɪ t
duplicates	d ˈu p l ɪ k ɪ t s
duplicates	d ˈu p l ɪ k ˌe ɪ t s
during	d ˈʊ ɹ ɪ ŋ
dusk	d ˈʌ s k
dust	d ˈʌ s t
dusty	d ˈʌ s t i
duties	d ˈu t i z
duty	d ˈu t i
dwarf	d w ˈɔ ɹ f
dwindling	d w ˈɪ n d l ɪ ŋ
dye	d ˈa ɪ
dyes	d ˈa ɪ z
dzh	d͡ʒ ə
e	ˈi
e-a	ˈi ˌi ˈe ɪ
e-e	ˈi ˈi
e-i	ˈi ˈa ɪ
e-i-g-h	ˈi ˈa ɪ d͡ʒ ˈi ˈe ɪ t͡ʃ
e-l	ˈi ˈɛ l
e-s	ˈi ˈɛ s
e-w	ˈi d ˈʌ b ə l j ˌu
each	ˈi t͡ʃ
eachfield	ˈi t͡ʃ f ˈi l d
eager	ˈi ɡ ɚ
eagerly	ˈi ɡ ɚ l i
eagle	ˈi ɡ ə l
eagles	ˈi ɡ ə l z
ear	ˈɪ ɹ
earlier	ɚ l ˌi ʌ
early	ˈɚ l i
earn	ˈɚ n
earned	ˈɚ n d
earnest	ˈɚ n ɪ s t
earred	ˈɛ ɹ ɪ d
earring	ˈɪ ɹ ɪ ŋ
ears	ˈɪ ɹ z
earth	ˈɚ θ
earthquakes	ə ɹ θ k w ˈe ɪ k s
earthworm	ˈɚ θ w ˌɚ m
earthworms	ˈɚ θ w ˌɚ m z
ease	ˈi z
easier	ˈi z i ɚ
easiest	ˈi z i ɪ s t
easily	ˈi z ə l i
east	ˈi s t
easy	ˈi z i
eat	ˈi t
eaten	ˈi t ə n
eater	ˈi t ɚ
eaters	ˈi t ɚ z
eating	ˈi t ɪ ŋ
eats	ˈi t s
echidna	ɪ k ˈɪ d n ə
echoing	ˈɛ k o ʊ ɪ ŋ
ecology	ɪ k ˈɑ l ə d͡ʒ i
ecosystem	ˈi k o ʊ s ˌɪ s t ə m
ecosystems	ˈi k o ʊ s ˌɪ s t ə m z
edge	ˈɛ d͡ʒ
edges	ˈɛ d͡ʒ ɪ z
edna	ˈɛ d n ə
edna's	ˈɛ d n ə z
ednas	ˈɛ d n ə z
educated	ˈɛ d͡ʒ ə k ˌe ɪ t ɪ d
educational	ɛ d j u k e ɪ ʃ ə n l
eee	ˈi
eel	ˈi l
eerie	ˈɪ ɹ i
eeyore	ˈi ˈɔ ɹ
effect	ɛ f ɛ k t
effective	ɪ f ˈɛ k t ɪ v
effects	ə f ɛ k t s
efficiency	ə f i ʃ ə n s i
effort	ˈɛ f ɚ t
efforts	ˈɛ f ɚ t s
egg	ˈɛ ɡ
eggs	ˈɛ ɡ z
ego	ˈi ɡ o ʊ
egos	ˈi ɡ o ʊ z
egypt	ˈi d͡ʒ ɪ p t
egyptian	ɪ d͡ʒ ˈɪ p ʃ ə n
ehh	ˈɛ
eight	ˈe ɪ t
eighteen	e ɪ t ˈi n
eighteenth	e ɪ t ˈi n θ
eighty	ˈe ɪ t i
either	ˈi ð ɚ
ejaculate	ɪ d͡ʒ ˈæ k j u l ɪ t
ejaculate	ɪ d͡ʒ ˈæ k j u l ˌe ɪ t
ejaculates	ɪ d͡ʒ ˈæ k j u l ɪ t s
ejaculates	ɪ d͡ʒ ˈæ k j u l ˌe ɪ t s
ejected	ɪ d͡ʒ ˈɛ k t ɪ d
elaborate	ɪ l ˈæ b b ɚ ɪ t
elaborate	ɪ l ˈæ b ɚ ɹ ɪ t
elaborate	ɪ l ˈæ b ɚ ɹ ˌe ɪ t
elder	ˈɛ l d ɚ
elders	ˈɛ l d ɚ z
elect	ɪ l ˈɛ k t
electric	ɪ l ˈɛ k t ɹ ɪ k
electricity	ɪ l ˌɛ k t ɹ ˈɪ s ə t i
electrics	ɪ l ˈɛ k t ɹ ɪ k s
electron	ɪ l ˈɛ k t ɹ ɔ n
elephant	ˈɛ l ə f ə n t
elephant's	ˈɛ l ə f ə n t s
elephants	ˈɛ l ə f ə n t s
eleven	ɪ l ˈɛ v ə n
elf	ˈɛ l f
eliminate	ɪ l ˈɪ m ə n ˌe ɪ t
elixir	ə l ˈɪ k s ˈɚ
ella	ˈɛ l ə
eloise	ˈɛ l o ʊ i z
else	ˈɛ l s
elsewhere	ˈɛ l s w ˌɛ ɹ
elsewheres	ˈɛ l s w ˌɛ ɹ z
elves	ˈɛ l v z
elytra	ˈɛ l a ɪ t ɹ ʌ
email	i i m ˈe ɪ l
emails	i i m ˈe ɪ l z
embarrassed	ɪ m b ˈɛ ɹ ɹ ə s t
embarrassing	ɪ m b ˈɛ ɹ ə s ɪ ŋ
embed	ɪ m b ˈɛ d
embedded	ɛ m b ɛ d ə d
emerald	ˈɛ m ˈɚ l d
emeralds	ˈɛ m ɚ ɹ ə l d z
emerge	ɪ m ˈɚ d͡ʒ
emily	ˈɛ m m ɪ l i
emma	ˈɛ m m ə
emma's	ˈɛ m m ə z
emmas	ˈɛ m ə z
emotion	ɪ m ˈo ʊ ʃ ə n
emotions	ɪ m ˈo ʊ ʃ ə n z
emotive	ɪ m ˈo ʊ t ɪ v
emperor	ˈɛ m p ɚ ɚ
empty	ˈɛ m p t i
enable	ɪ n ˈe ɪ b ə l
encase	ɪ ŋ k ˈe ɪ s
enchanted	ˈɛ n t͡ʃ ˈæ n t ə d
enchanting	ɪ n t͡ʃ ˈæ n t ɪ ŋ
enchantment	ɪ n t͡ʃ ˈæ n t m ə n t
enchantments	b ˈʊ k k ˌe ɪ s ə z
enclose	ɪ ŋ k l ˈo ʊ z
encourage	ɪ ŋ k ˈɚ ɹ ɪ d͡ʒ
encouraged	ɛ n k ʌ ɹ ə d͡ʒ d
encouraging	ə n k ʌ ɹ ə d͡ʒ i ŋ
end	ˈɛ n d
endangered	ɪ n d ˈe ɪ n d͡ʒ ɚ d
ended	ˈɛ n d ɪ d
ender	ˈɛ n d ɚ
enderdragon	ˈɛ n d ɚ d ɹ ˈæ ɡ ə n
enderman	ˈɛ n d ɚ m ə n
ending	ˈɛ n d ɪ ŋ
endless	ˈɛ n d l ə s
ends	ˈɛ n d z
energy	ˈɛ n ɚ d͡ʒ i
engage	ɪ ŋ ɡ ˈe ɪ d͡ʒ
engine	ˈɛ n d͡ʒ ə n
engineer	ˈɛ n d͡ʒ ə n ˈɪ ɹ
england	ɪ ŋ l ə n d
english	ˈɪ ŋ ɡ l ɪ ʃ
englishes	ɪ ŋ ɡ l ɪ ʃ ə z
enjoy	ɪ n d͡ʒ ˈɔ ɪ
enjoyed	ɪ n d͡ʒ ˈɔ ɪ d
enjoying	ɪ n d͡ʒ ˈɔ ɪ ɪ ŋ
enjoys	ɪ n d͡ʒ ˈɔ ɪ z
enlist	ɪ n l ˈɪ s t
enormous	ɪ n ˈɔ ɹ m ə s
enough	ɪ n ˈʌ f
enrage	ɛ n ɹ e ɪ d ʒ
enslaved	ɪ n s l ˈe ɪ v d
ensure	ə n ʃ ˈo ʊ ɹ
enter	ˈɛ n t ɚ
entered	ˈɛ n t ɚ d
entering	ˈɛ n t ɚ ɹ ɪ ŋ
enthusiastic	ɪ n θ ˌu z i ˈæ s t ɪ k
entire	ɪ n t ˈa ɪ ɚ
entirely	ɪ n t ˈa ɪ ɚ l i
entrails	ˈɛ n t ɹ ˈe ɪ l z
entrance	ˈɛ n t ɹ ə n s
entrance	ɪ n t ɹ ˈæ n s
entrances	ɪ n t ɹ ˈæ n s ɪ z
entrances	ˈɛ n t ɹ ə n s ɪ z
entries	ˈɛ n t ɹ i z
envelope	ˈɛ n v ə l ˌo ʊ p
environment	ɪ n v ˈa ɪ ɹ ə n m ə n t
environmental	ɪ n v ˌa ɪ ɹ ə n m ˈɛ n t ə l
eon	ˈi ɔ n
equal	ˈi k w ə l
equate	ɪ k w ˈe ɪ t
equipment	ɪ k w ˈɪ p m ə n t
era	ˈɛ ɹ ə
error	ˈɛ ɹ ɚ
escape	ɪ s k ˈe ɪ p
escaped	ɪ s k ˈe ɪ p t
escaping	ˈɛ s k ˈe ɪ p ˌi ŋ
escort	ˈɛ s k ɔ ɹ t
escort	ɪ s k ˈɔ ɹ t
escorts	ˈɛ s k ɔ ɹ t s
escorts	ɪ s k ˈɔ ɹ t s
especially	ɪ s p ˈɛ ʃ l l i
estimate	ˈɛ s t ɪ m ɪ t
estimate	ˈɛ s t ɪ m ˌe ɪ t
estimates	ˈɛ s t ɪ m ɪ t s
estimates	ˈɛ s t ɪ m ˌe ɪ t s
europe	j ˈʊ ɹ ə p
european	j ˌʊ ɹ ə p ˈi ə n
european-style	j ˌʊ ɹ ə p ˈi ə n s t ˈa ɪ l
evacuate	ɪ v ˈæ k j u ˌe ɪ t
evaporation	ɪ v ˌæ p ɚ ɹ ɹ ˈe ɪ ʃ ə n
evasive	ɪ v ˈe ɪ s ɪ v
even	ˈi v ə n
evening	ˈi v ə n ɪ ŋ
evenly	ˈi v ə n l i
evenly-coated	ˈi v ə n l i k ˈo ʊ t ɪ d
evens	ˈi v ə n z
event	ɪ v ˈɛ n t
events	ɪ v ˈɛ n t s
eventually	ɪ v ˈɛ n t͡ʃ u ə l i
ever	ˈɛ v ɚ
every	ˈɛ v ɹ i
everybody	ˈɛ v ɹ i b ˌɑ d i
everyday	ˈɛ v ɹ i d ˈe ɪ
everyone	ˈɛ v ɹ i w ˌʌ n
everything	ˈɛ v ɹ i θ ˌɪ ŋ
everywhere	ˈɛ v ɹ i w ˌɛ ɹ
everywheres	ˈɛ v ɹ i w ˌɛ ɹ z
evil	ˈi v ə l
evolution	ˌɛ v ə l ˈu ʃ ə n
evolve	ɪ v ˈɑ l v
evolved	ɪ v ˈɑ l v d
exact	ə ɡ s ˌæ k t
exactly	ɪ ɡ z ˈæ k t l i
exam	ɪ ɡ z ˈæ m
examine	ɪ ɡ z ˈæ m ɪ n
examines	ɪ ɡ z ˈæ m ə n z
example	ɪ ɡ z ˈæ m p ə l
examples	ˈɛ ɡ z ˈæ m p ə l z
excellent	ˈɛ k s ə l ə n t
except	ɪ k s ˈɛ p t
excise	ɪ k s s ˈa ɪ s
excise	ˈɛ k s s ˌa ɪ z
excited	ɪ k s ˈa ɪ t ɪ d
excitedly	ɪ k s s ˈa ɪ t ɪ d l i
excitement	ɪ k s ˈa ɪ t m ə n t
exciting	ɪ k s ˈa ɪ t ɪ ŋ
exclaim	ɪ k s k l ˈe ɪ m
exclaimed	ɪ k s k l ˈe ɪ m d
exclaims	ɪ k s k l ˈe ɪ m z
exclamation	ˌɛ k s k l ə m ˈe ɪ ʃ ə n
exclusion	ɪ k s k l ˈu ʒ ə n
excursion	ɪ k s k ˈɚ ʒ ə n
excuse	ɪ k s k j ˈu z
excuse	ɪ k s k j ˈu s
excuse	ɪ k s k j ˈu z
excuses	ɪ k s k j ˈu s ɪ z
excuses	ɪ k s k j ˈu z ɪ z
exercise	ˈɛ k s ɚ s ˌa ɪ z
exhausted	ɪ ɡ z ˈɔ s t ɪ d
exist	ɪ ɡ z ˈɪ s t
existed	ə ɡ z ˈɪ s t ə d
existence	ɪ ɡ z ˈɪ s t ə n s
existing	ɪ ɡ z ˈɪ s t ɪ ŋ
exists	ə ɡ z ˈɪ s t s
exit	ˈɛ k s ɪ t
exited	ˈɛ ɡ z ɪ t ɪ d
exits	ˈɛ ɡ z ɪ t s
expanding	ɪ k s p ˈæ n d ɪ ŋ
expansion	ɪ k s p ˈæ n ʃ ə n
expatriate	ˌɛ k s p ˈe ɪ t ɹ i ˌe ɪ t
expatriate	ˌɛ k s p ˈe ɪ t ɹ i ɪ t
expatriates	ˌɛ k s p ˈe ɪ t ɹ i ˌe ɪ t s
expatriates	ˌɛ k s p ˈe ɪ t ɹ i ɪ t s
expect	ɪ k s p ˈɛ k t
expected	ɪ k s p ˈɛ k t ɪ d
expecting	ˈɛ k s p ˈɛ k t ˌi ŋ
expedition	ˈɛ k s p ə d ˌi t͡ʃ ə n
expensive	ɪ k s p ˈɛ n s ɪ v
experience	ɪ k s p ˈɪ ɹ i ə n s
experienced	ɪ k s p ˈɪ ɹ i ə n s t
experiences	ɪ k s p ˈɪ ɹ i ə n s ɪ z
experiment	ɪ k s p ˈɛ ɹ ɪ m ə n t
experiments	ɪ k s p ˈɛ ɹ ɪ m ə n t s
expert	ˈɛ k s p ɚ t
experts	ɛ k s p ɚ t s
expiration	ˌɛ k s p ɚ ˈe ɪ ʃ ə n
explain	ɪ k s p l ˈe ɪ n
explained	ɪ k s p l ˈe ɪ n d
explains	ɪ k s p l ˈe ɪ n z
explanation	ˌɛ k s p l ə n e ɪ ʃ ə n
explode	ɪ k s p l ˈo ʊ d
exploded	ɪ k s p l ˈo ʊ d ɪ d
explodes	ə k s p l ˈo ʊ d z
exploding	ɪ k s p l ˈo ʊ d ɪ ŋ
exploit	ˈɛ k s p l ɔ ɪ t
exploit	ɪ k s p l ˈɔ ɪ t
exploits	ɪ k s p l ˈɔ ɪ t s
exploits	ˈɛ k s p l ɔ ɪ t s
explore	ɪ k s p l ˈɔ ɹ
explored	ɪ k s p l ˈɔ ɹ d
explorer	ɪ k s p l ˈɔ ɹ ɚ
exploring	ɪ k s p l ˈɔ ɹ ɪ ŋ
explosion	ɪ k s p l ˈo ʊ ʒ ə n
export	ɪ k s p ˈɔ ɹ t
export	ˈɛ k s p ɔ ɹ t
exports	ɪ k s p ˈɔ ɹ t s
exports	ˈɛ k s p ɔ ɹ t s
express	ɪ k s p ɹ ˈɛ s
expression	ɪ k s p ɹ ˈɛ s ʃ ə n
extinct	ɪ k s t ˈɪ ŋ k t
extra	ˈɛ k s t ɹ ə
extract	ˈɛ k s s t ɹ æ k t
extremely	ɪ k s t ɹ ˈi m l i
eye	a ɪ
eyed	ˈa ɪ d
eyes	a ɪ z
eyeshadow	ˈa ɪ ʃ ˌæ d o ʊ
eyespot	ˈa ɪ s p ˌɑ t
eyespots	a ɪ s p ˈɑ t s
f	ˈɛ f
fab	f ˈæ b
fabric	f ˈæ b ɹ ɪ k
fabulous	f ˈæ b j ˈu l ə s
face	f ˈe ɪ s
faced	f ˈe ɪ s d
faces	f ˈe ɪ s ɪ z
fact	f ˈæ k t
factories	f ˈæ k t ə ɹ i z
factory	f ˈæ k t ɚ ɹ i
facts	f ˈæ k t s
fade	f ˈe ɪ d
faded	f ˈe ɪ d ɪ d
fafa	f ˈɑ f ə
fail	f ˈe ɪ l
failed	f ˈe ɪ l d
fails	f ˈe ɪ l z
faint	f ˈe ɪ n t
faints	f ˈe ɪ n t s
fair	f ˈɛ ɹ
fairies	f ˈɛ ɹ i z
fairly	f ˈɛ ɹ l i
fairness	f ˈɛ ɹ n ə s
fairy	f ˈɛ ɹ i
faithful	f ˈe ɪ θ f ə l
fall	f ˈɔ l
fallen	f ˈɔ l ə n
falling	f ˈɔ l ɪ ŋ
falls	f ˈɔ l z
false	f ˈɔ l s
familiar	f ə m ˈɪ l ˈi j ɚ
families	f ˈæ m ɪ l i z
family	f ˈæ m ɪ l i
famous	f ˈe ɪ m ə s
fan	f ˈæ n
fancy	f ˈæ n s i
fandom	f ˈæ n d ə m
fang	f ˈæ ŋ
fangs	f ˈæ ŋ z
fans	f ˈæ n z
fantastic	f æ n t ˈæ s t ɪ k
far	f ˈɑ ɹ
far-away	f ˈɑ ɹ ə w ˈe ɪ
fare	f ˈɛ ɹ
farewell	f ˌɛ ɹ w ˈɛ l
farm	f ˈɑ ɹ m
farmer	f ˈɑ ɹ m ɚ
farmer's	f ˈɑ ɹ m ɚ z
farmers	f ˈɑ ɹ m ɚ z
farmhouse	f ˈɑ ɹ m h ˌa ʊ s
farming	f ˈɑ ɹ m ɪ ŋ
farms	f ˈɑ ɹ m z
fart	f ˈɑ ɹ t
farther	f ˈɑ ɹ ð ɚ
farts	f ˈɑ ɹ t s
fascinated	f ˈæ s s ə n ˌe ɪ t ɪ d
fashion	f ˈæ ʃ ə n
fashioned	f ˈæ ʃ ə n d
fast	f ˈæ s t
fastened	f ˈæ s ə n d
faster	f ˈæ s t ɚ
fat	f ˈæ t
fatal	f ˈe ɪ t ə l
father	f ˈɑ ð ɚ
father's	f ˈɑ ð ɚ z
fathers	f ˈɑ ð ɚ z
fault	f ˈɔ l t
faulty	f ˈɔ l t i
fauna	f ˈɔ n ə
favor	f ˈe ɪ v ɚ
favorite	f ˈe ɪ v ɚ ɹ ɪ t
favorites	f ˈe ɪ v ɚ ɹ ɪ t s
favour	f ˈe ɪ v ɚ
favourite	f ˈe ɪ v ɚ ɹ ɪ t
favourites	f ˈæ v ˈa ʊ ɹ ɪ t s
fawn	f ˈɔ n
fay	f ˈe ɪ
fear	f ˈɪ ɹ
fears	f ˈɪ ɹ z
fearsome	f ˈɪ ɹ s ə m
feast	f ˈi s t
feat	f ˈi t
feather	f ˈɛ ð ɚ
feathered	f ˈɛ ð ɚ d
feathers	f ˈɛ ð ɚ z
feathery	f ˈɛ ð ɚ ɹ i
feature	f ˈi t͡ʃ ɚ
february	f ˈɛ b j u ˌɛ ɹ i
fed	f ˈɛ d
feed	f ˈi d
feeder	f ˈi d ɚ
feeding	f ˈi d ɪ ŋ
feeds	f ˈi d z
feel	f ˈi l
feeler	f ˈi l ɚ
feelers	f ˈi l ɚ z
feeling	f ˈi l ɪ ŋ
feels	f ˈi l z
feet	f ˈi t
feisty	f ˈa ɪ s t i
feline	f ˈi l ˌa ɪ n
fell	f ˈɛ l
fella	f ˈɛ l l ə
fellow	f ˈɛ l o ʊ
fellows	f ˈɛ l o ʊ z
felt	f ˈɛ l t
female	f ˈi m ˌe ɪ l
females	f ˈi m ˌe ɪ l z
fence	f ˈɛ n s
fenced	f ˈɛ n s t
fences	f ˈɛ n s ɪ z
fend	f ˈɛ n d
fending	f ˈɛ n d ɪ ŋ
fennec	f ˈɛ n ɪ k
fern	f ˈɚ n
ferns	f ˈɚ n z
ferocious	f ɚ ɹ ˈo ʊ ʃ ə s
ferocity	f ɚ ɹ ˈɑ s s ə t i
ferris	f ˈɛ ɹ ɹ ɪ s
ferry	f ˈɛ ɹ i
fertile	f ˈɚ t ə l
fertiliser	f ˈɚ t ˈɪ l ˌa ɪ z ɚ
fertilizer	f ˈɚ t ɪ l ˌa ɪ z ɚ
fervor	f ˈɚ v ˈɚ
festival	f ˈɛ s t ɪ v ə l
festive	f ˈɛ s t ɪ v
fetch	f ˈɛ t͡ʃ
fetches	f ˈɛ t͡ʃ ɪ z
fete	f ˈe ɪ t
fethers	f ˈɛ ð ɚ z
fever	f i v ə ɹ
feverish	f ˈi v ɚ ɪ ʃ
few	f j ˈu
fewer	f j ˈu ɚ
fff	f f
fibers	f ˈa ɪ b ɚ z
fibres	f ˈa ɪ b ɚ z
fiction	f ˈɪ k ʃ ə n
fiddle	f ˈɪ d ə l
fidget	f ˈɪ d͡ʒ ɪ t
field	f ˈi l d
fields	f ˈi l d z
fiendish	f ˈi n d ɪ ʃ
fierce	f ˈɪ ɹ s
fifteen	f ɪ f t ˈi n
fifth	f ˈɪ f θ
fifty	f ˈɪ f t i
fig	f ˈɪ ɡ
fight	f ˈa ɪ t
fighter	f ˈa ɪ t ɚ
fighting	f ˈa ɪ t ɪ ŋ
fights	f ˈa ɪ t s
figment	f ˈɪ ɡ m ɪ n t
figure	f ˈɪ ɡ j ɚ
figured	f ˈɪ ɡ j ɚ d
figures	f ˈɪ ɡ ə ɹ z
file	f ˈa ɪ l
files	f ˈa ɪ l z
fill	f ˈɪ l
filled	f ˈɪ l d
filling	f ˈɪ l ɪ ŋ
fills	f ˈɪ l z
film	f ˈɪ l m
films	f ˈɪ l m z
filmy	f ˈɪ l m i
filth	f ˈɪ l θ
fin	f ˈɪ n
final	f ˈa ɪ n ə l
finally	f ˈa ɪ n ə l i
finch	f ˌi n t͡ʃ
find	f ˈa ɪ n d
finding	f ˈa ɪ n d ɪ ŋ
finds	f ˈa ɪ n d z
fine	f ˈa ɪ n
finery	f ˈa ɪ n ˈɛ ɚ ɹ i
finger	f ˈɪ ŋ ɡ ɚ
fingers	f ˈɪ ŋ ɡ ɚ z
finish	f ˈɪ n ɪ ʃ
finished	f ˈɪ n ɪ ʃ t
finishes	f ˈɪ n ɪ ʃ ɪ z
finishing	f ˈɪ n ɪ ʃ ɪ ŋ
finn	f ˈɪ n
fins	f ˈɪ n z
fire	f ˈa ɪ ɚ
fireballs	f ˈa ɪ ɚ b ˌɔ l z
fireflies	f ˈa ɪ ɚ f l ˌa ɪ z
firefly	f ˈa ɪ ɚ f l ˌa ɪ
firefly's	f ˈa ɪ ɹ f l ˈa ɪ z
fires	f ˈa ɪ ɚ z
firework	f ˈa ɪ ɚ w ˌɚ k
fireworks	f ˈa ɪ ɚ w ˌɚ k s
firing	f ˈa ɪ ɹ ɪ ŋ
firm	f ˈɚ m
firmly	f ˈɚ m l i
first	f ˈɚ s t
firstly	f ˈɚ s t l i
fish	f ˈɪ ʃ
fisherman	f ˈɪ ʃ ɚ m ə n
fishes	f ˈɪ ʃ ɪ z
fishing	f ˈɪ ʃ ɪ ŋ
fishy	f ˈɪ ʃ i
fist	f ˈɪ s t
fists	f ˈɪ s t s
fit	f ˈɪ t
fits	f ˈɪ t s
five	f ˈa ɪ v
fives	f ˈa ɪ v z
fix	f ˈɪ k s
fixed	f ˈɪ k s t
fixes	f ˈɪ k s ɪ z
fixing	f ˈɪ k s ɪ ŋ
fizzes	f ˈɪ z ɪ z
flag	f l ˈæ ɡ
flags	f l ˈæ ɡ z
flake	f l ˈe ɪ k
flaked	f l ˈe ɪ k t
flakes	f l ˈe ɪ k s
flame	f l ˈe ɪ m
flames	f l ˈe ɪ m z
flamingo	f l ə m ˈɪ ŋ ɡ o ʊ
flamingos	f l ə m ˈɪ ŋ ɡ o ʊ z
flank	f l ˈæ ŋ k
flanked	f l ˈæ ŋ k t
flap	f l ˈæ p
flapped	f l ˌæ p d
flapping	f l ˈæ p ɪ ŋ
flaps	f l ˈæ p s
flash	f l ˈæ ʃ
flashes	f l ˈæ ʃ ɪ z
flashing	f l ˈæ ʃ ɪ ŋ
flask	f l ˈæ s k
flasks	f l ˈæ s k s
flat	f l ˈæ t
flatly	f l ˈæ t l i
flatten	f l ˈæ t ə n
flavor	f l ˈe ɪ v ɚ
flavors	f l ˈe ɪ v ɚ z
flavour	f l ˈe ɪ v ɚ
flavours	f l ˈe ɪ v ɚ z
flaw	f l ˈɔ
flaws	f l ˈɔ z
flea	f l ˈi
fleas	f l ˈi z
flecks	f l ˈɛ k s
fled	f l ˈɛ d
flee	f l ˈi
flees	f l ˈi z
flesh	f l ˈɛ ʃ
fleshy	f l ˈɛ ʃ i
fletcher	f l ˈɛ t͡ʃ ɚ
fletching	f l ˈɛ t͡ʃ ɪ ŋ
flew	f l ˈu
flex	f l ˈɛ k s
flexible	f l ˈɛ k s ə b ə l
flick	f l ˈɪ k
flicked	f l ˈɪ k t
flickered	f l ˈɪ k ɚ d
flicking	f l ˈɪ k ɪ ŋ
flicks	f l ˈɪ k s
flies	f l ˈa ɪ z
flight	f l ˈa ɪ t
flights	f l ˈa ɪ t s
fling	f l ˈɪ ŋ
flings	f l ˈɪ ŋ z
flint	f l ˈɪ n t
flip	f l ˈɪ p
flipped	f l ˈɪ p t
flipper	f l ˈɪ p p ɚ
flippers	f l ˈɪ p ɚ z
flips	f l ˈɪ p s
flit	f l ˈɪ t
flits	f l ˈɪ t s
flitting	f l ˈɪ t ɪ ŋ
float	f l ˈo ʊ t
floated	f l ˈo ʊ t ɪ d
floating	f l ˈo ʊ t ɪ ŋ
floats	f l ˈo ʊ t s
flock	f l ˈɑ k
flood	f l ˈʌ d
flooded	f l ʌ d ə d
floods	f l ʌ d z
floor	f l ˈɔ ɹ
floors	f l ɔ ɹ z
flop	f l ˈɑ p
floppy	f l ˈɑ p i
flops	f l ˈɑ p s
floss	f l ˈɑ s
flour	f l ˈa ʊ ɚ
flow	f l ˈo ʊ
flower	f l ˈa ʊ ɚ
flower's	f l ˈa ʊ ɚ z
flowerbed	f l ˈa ʊ ɚ b ɪ d
flowers	f l ˈa ʊ ɚ z
flowing	f l ˈo ʊ w i ŋ
flown	f l ˈo ʊ n
flows	f l ˈo ʊ z
flu	f l ˈu
fluent	f l ˈu ə n t
fluff	f l ˈʌ f
fluffy	f l ˈʌ f i
fluid	f l ˈu ɪ d
fluids	f l ˈu ɪ d z
flung	f l ˈʌ ŋ
flunk	f l ˈʌ ŋ k
flush	f l ˈʌ ʃ
flushes	f l ˈʌ ʃ ɪ z
flute	f l ˈu t
flutes	f l ˈu t s
fluttered	f l ˈʌ t t ɚ d
fly	f l ˈa ɪ
flyers	f l a ɪ ə z
flying	f l ˈa ɪ ɪ ŋ
foam	f ˈo ʊ m
foamy	f ˈo ʊ m i
focus	f ˈo ʊ k ə s
focused	f ˈo ʊ k ə s t
fod	f ˈɑ d
fodder	f ˈɑ d ɚ
fog	f ˈɔ ɡ
foil	f ˈɔ ɪ l
foiled	f ˈɔ ɪ l d
foils	f ˈɔ ɪ l z
fold	f ˈo ʊ l d
folded	f ˈo ʊ l d ɪ d
folds	f ˈo ʊ l d z
folklore	f ˈo ʊ k l ˌɔ ɹ
folks	f ˈo ʊ l k s
follow	f ˈɑ l o ʊ
followed	f ˈɑ l o ʊ d
followers	f ˈɑ l l o ʊ ɚ z
following	f ˈɑ l o ʊ ɪ ŋ
follows	f ˈɑ l o ʊ z
fond	f ˈɑ n d
food	f ˈu d
foods	f ˈu d z
fool	f ˈu l
foolish	f ˈu l ɪ ʃ
foot	f ˈʊ t
footage	f ˈʊ t ɪ d͡ʒ
football	f ˈʊ t b ˌɔ l
footpath	f ˈʊ t p ˌæ θ
footprint	f ˈʊ t p ɹ ˌɪ n t
footprints	f ˈʊ t p ɹ ˌɪ n t s
footsteps	f ˈʊ t s t ˌɛ p s
for	f ˈɔ ɹ
forage	f ˈɔ ɹ ɪ d͡ʒ
forbidden	f ɚ b ˈɪ d d ə n
force	f ˈɔ ɹ s
forced	f ˈɔ ɹ s t
fore	f ˈɔ ɹ
forecast	f ˈɔ ɹ k ˌæ s t
forefront	f ˈɔ ɹ f ɹ ˌʌ n t
forehead	f ˈɔ ɹ h ɛ d
foreheads	f ˈɔ ɹ h ˌɛ d z
foreign	f ˈɔ ɹ ə n
forelimb	f ˈɔ ɹ l ˌɪ m
forelimbs	f ˈɔ ɹ l ˌɪ m z
foresee	f ɔ ɹ s ˈi
forest	f ˈɔ ɹ ɪ s t
forester	f ˈɔ ɹ ɪ s t ɚ
forests	f ˈɔ ɹ ɪ s t s
forever	f ɚ ˈɛ v v ɚ
forget	f ɚ ɡ ˈɛ t
forgetful	f ɚ ɡ ˈɛ t f ə l
forgetfulness	f ˈɔ ɹ ɡ ɪ t f ə l n ə s
forgets	f ɚ ɡ ˈɛ t s
forgot	f ɚ ɡ ˈɑ t
forgotten	f ɚ ɡ ˈɑ t t ə n
fork	f ˈɔ ɹ k
forked	f ˈɔ ɹ k t
forks	f ˈɔ ɹ k s
form	f ˈɔ ɹ m
formal	f ˈɔ ɹ m ə l
formation	f ɔ ɹ m ˈe ɪ ʃ ə n
formed	f ˈɔ ɹ m d
formidable	f ˈɔ ɹ m ə d ə b ə l
forms	f ˈɔ ɹ m z
formulate	f ˈɔ ɹ m j u l ˌe ɪ t
forth	f ˈɔ ɹ θ
fortress	f ˈɔ ɹ t ɹ ə s
fortunate	f ˈɔ ɹ t͡ʃ ə n ɪ t
fortune	f ˈɔ ɹ t͡ʃ u n
forty	f ˈɔ ɹ t i
forward	f ˈɔ ɹ w ɚ d
forwards	f ˈɔ ɹ w ɚ d z
fossil	f ˈɑ s ə l
fossils	f ˈɑ s ə l z
fought	f ˈɔ t
foul	f ˈa ʊ l
found	f ˈa ʊ n d
fountain	f ˈa ʊ n t ə n
fountains	f ˈa ʊ n t ə n z
four	f ˈɔ ɹ
four-legged	f ˈɔ ɹ l ˈɛ ɡ d
fours	f ˈɔ ɹ z
fourteenth	f ˌɔ ɹ t ˈi n θ
fox	f ˈɑ k s
foxes	f ˈɑ k s ɪ z
fragment	f ɹ ˈæ ɡ m ə n t
fragment	f ɹ æ ɡ m ˈɛ n t
fragments	f ɹ æ ɡ m ˈɛ n t s
fragments	f ɹ ˈæ ɡ m ə n t s
fragrance	f ɹ ˈe ɪ ɡ ɹ ə n s
fragrant	f ɹ ˈe ɪ ɡ ɹ ə n t
frame	f ɹ ˈe ɪ m
frames	f ɹ ˈe ɪ m z
frantically	f ɹ ˈæ n t ɪ k l l i
fraught	f ɹ ˈɔ t
freak	f ɹ ˈi k
free	f ɹ ˈi
freed	f ɹ ˈi d
freeing	f ɹ ˈi ɪ ŋ
freely	f ɹ ˈi l i
frees	f ɹ ˈi z
freeze	f ɹ ˈi z
freezing	f ɹ ˈi z ɪ ŋ
freight	f ɹ ˈe ɪ t
freighted	f ɹ ˈa ɪ t ɪ d
french	f ɹ ˈɛ n t͡ʃ
frenzy	f ɹ ˈɛ n z i
frequent	f ɹ ˈi k w ə n t
frequent	f ɹ ɪ k w ˈɛ n t
fresh	f ɹ ˈɛ ʃ
fret	f ɹ ˈɛ t
frets	f ɹ ˈɛ t s
friday	f ɹ ˈa ɪ d ˌe ɪ
fridge	f ɹ ˈɪ d͡ʒ
fried	f ɹ ˈa ɪ d
friend	f ɹ ˈɛ n d
friend's	f ɹ ˈɛ n d z
friendly	f ɹ ˈɛ n d l i
friends	f ɹ ˈɛ n d z
friendship	f ɹ ˈɛ n d ʃ ɪ p
friendships	f ɹ ˈɛ n d ʃ ɪ p s
fries	f ɹ ˈa ɪ z
fright	f ɹ ˈa ɪ t
frighten	f ɹ ˈa ɪ t ə n
frightened	f ɹ ˈa ɪ t ə n d
frightening	f ɹ ˈa ɪ t n ɪ ŋ
frightens	f ɹ ˈa ɪ t ə n z
frill	f ɹ ˈɪ l
frills	f ɹ ˈɪ l z
fro	f ɹ ˈo ʊ
frog	f ɹ ˈɑ ɡ
frogs	f ɹ ˈɑ ɡ z
from	f ɹ ˈʌ m
frond	f ɹ ˈɑ n d
front	f ɹ ˈʌ n t
fronts	f ɹ ˈʌ n t s
frost	f ɹ ˈɔ s t
frown	f ɹ ˈa ʊ n
frowned	f ɹ ˈa ʊ n d
frowning	f ɹ ˈa ʊ n ɪ ŋ
frowns	f ɹ ˈa ʊ n z
froze	f ɹ ˈo ʊ z
frozen	f ɹ ˈo ʊ z ə n
fruit	f ɹ ˈu t
fruits	f ɹ ˈu t s
frustrate	f ɹ ˈʌ s t ɹ ˌe ɪ t
frustrated	f ɹ ˈʌ s t ɹ ˌe ɪ t ɪ d
frustrates	f ɹ ˈʌ s t ɹ ˌe ɪ t s
frustration	f ɹ ə s t ɹ ˈe ɪ ʃ ə n
fry	f ɹ ˈa ɪ
fuel	f j ˈu ɚ l
ful	f ˈʊ l
full	f ˈʊ l
full-time	f ˈʊ l t ˈa ɪ m
fully	f ʊ l ˌi
fun	f ˈʌ n
fungus	f ˈʌ ŋ ɡ ə s
funk	f ˈʌ ŋ k
funny	f ˈʌ n i
fur	f ˈɚ
furball	f ˈɚ b ˈɑ l
furnace	f ˈɚ n ə s
furnish	f ˈɚ n ɪ ʃ
furniture	f ˈɚ n ɪ t͡ʃ ɚ
furry	f ˈɚ i
further	f ˈɚ ð ɚ
fuss	f ˈʌ s
fusses	f ˈʌ s ɪ z
fussy	f ˈʌ s i
future	f j ˈu t͡ʃ ɚ
fuzz	f ˈʌ z
fuzzy	f ˈʌ z i
g	ɡ ɹ ˌæ m z
g-h	d͡ʒ ˈi ˈe ɪ t͡ʃ
g-n	d͡ʒ ˈi ˈɛ n
gad	ɡ ˈæ d
gain	ɡ ˈe ɪ n
gained	ɡ a ɪ n d
gains	ɡ ˈe ɪ n z
gamble	ɡ ˈæ m b ə l
game	ɡ ˈe ɪ m
gamelan	ɡ ʌ m ə l ʌ n
gameplay	ɡ ˈe ɪ m p l ˌe ɪ
games	ɡ ˈe ɪ m z
gang	ɡ ˈæ ŋ
gaol	ɡ ˈe ɪ l
gap	ɡ ˈæ p
gape	ɡ ˈe ɪ p
gapes	ɡ ˈe ɪ p z
gaps	ɡ ˈæ p s
garage	ɡ ɚ ɹ ˈɑ ʒ
garbage	ɡ ˈɑ ɹ b ɪ d͡ʒ
garden	ɡ ˈɑ ɹ d ə n
gardener	ɡ ˈɑ ɹ d ə n ɚ
gardeners	ɡ ˈɑ ɹ d n ɚ z
gardens	ɡ ˈɑ ɹ d ə n z
gargoyle	ɡ ˈɑ ɹ ɡ ˌɔ ɪ l
gargoyles	ɡ ˈɑ ɹ ɡ ˌɔ ɪ l z
gas	ɡ ˈæ s
gasp	ɡ ˈæ s p
gasps	ɡ ɑ s p s
gate	ɡ ˈe ɪ t
gates	ɡ ˈe ɪ t s
gather	ɡ ˈæ ð ɚ
gathered	ɡ ˈæ ð ɚ d
gathering	ɡ ˈæ ð ɚ ɪ ŋ
gathers	ɡ ˈæ ð ɚ z
gaunt	ɡ ˈɔ n t
gave	ɡ ˈe ɪ v
gawking	ɡ ˈɔ k ɪ ŋ
gaze	ɡ ˈe ɪ z
gazes	ɡ ˈe ɪ z ɪ z
gear	ɡ ˈɪ ɹ
geckos	ɡ ɛ k ˈo ʊ z
gee	d͡ʒ ˈi
geese	ɡ ˈi s
geeze	d͡ʒ ˈi z
gem	d͡ʒ ˈɛ m
gems	d͡ʒ ˈɛ m z
generally	d͡ʒ ˈɛ n ɚ ə l i
generate	d͡ʒ ˈɛ n ɚ e ɪ t
generated	d͡ʒ ˈɛ n ə ɹ ˌe ɪ t ə d
generation	d͡ʒ ˌɛ n n ɚ ˈe ɪ ʃ ə n
generations	d͡ʒ ˌɛ n ɚ ɹ ˈe ɪ ʃ ə n z
generator	d͡ʒ ˈɛ n ɚ ˌe ɪ t ɚ
generous	d͡ʒ ˈɛ n n ɚ ə s
gentle	d͡ʒ ˈɛ n t ə l
gently	d͡ʒ ˈɛ n t l i
genuine	d͡ʒ ˈɛ n j u ɪ n
geode	d͡ʒ ˈi o ʊ d
george	d͡ʒ ˈɔ ɹ d͡ʒ
germ	d͡ʒ ˈɚ m
german	d͡ʒ ˈɚ m ə n
germen	ɡ ˈɚ m ə n
germs	d͡ʒ ˈɚ m z
gesture	d͡ʒ ˈɛ s t͡ʃ ɚ
get	ɡ ˈɛ t
gets	ɡ ɛ t s
getting	ɡ ˈɛ t ɪ ŋ
gharial	ɡ ˈɑ ɹ i ə l
gharials	ɡ ˈɑ ɹ i ə l z
ghast	ɡ ˈæ s t
ghastly	ɡ ˈæ s t l i
ghasts	ɡ ˈæ s t s
ghost	ɡ ˈo ʊ s t
ghostly	ɡ ˈo ʊ s t l i
ghosts	ɡ ˈo ʊ s t s
ghoul	ɡ ˈu l
ghoulish	ɡ ˈu l ɪ ʃ
ghouls	ɡ ˈʊ l z
giant	d͡ʒ ˈa ɪ ə n t
giants	d͡ʒ ˈa ɪ ə n t s
gibbons	ɡ ˈɪ b ə n z
gift	ɡ ˈɪ f t
gifts	ɡ ˈɪ f t s
gigantic	d͡ʒ a ɪ ɡ ˈæ n t ɪ k
giggle	ɡ ˈɪ ɡ ə l
giggled	ɡ ˈɪ ɡ ə l d
giggles	ɡ ˈɪ ɡ ə l z
gills	ɡ ˈɪ l z
gimble	ɡ ˈɪ m b ə l
gimp	ɡ ˈɪ m p
gimp-pee	ɡ ˈɪ m p p ˈi
ginger	d͡ʒ ˈɪ n d͡ʒ ɚ
gingerbread	d͡ʒ i n d͡ʒ ə ɹ b ɹ ɛ d
ginseng	d͡ʒ ˈɪ n s ˌɛ ŋ
giraffe	d͡ʒ ɚ ɹ ˈæ f
giraffes	d͡ʒ ɚ ɹ ˈæ f s
girl	ɡ ˈɚ l
girl's	ɡ ˈɚ l z
girls	ɡ ˈɚ l z
give	ɡ ˈɪ v
given	ɡ ˈɪ v ə n
gives	ɡ ˈɪ v z
giving	ɡ ˈɪ v ɪ ŋ
gizzard	ɡ ˈɪ z z ɚ d
gizzards	ɡ ˈɪ z z ɚ d z
glad	ɡ l ˈæ d
glade	ɡ l ˈe ɪ d
gladly	ɡ l ˈæ d l i
glance	ɡ l ˈæ n s
glass	ɡ l ˈæ s
glasses	ɡ l ˈæ s ɪ z
glaze	ɡ l ˈe ɪ z
glazes	ɡ l ˈe ɪ z ɪ z
gleaming	ɡ l ˈi m ɪ ŋ
gleams	ɡ l ˈi m z
glee	ɡ l ˈi
glide	ɡ l ˈa ɪ d
glider	ɡ l ˈa ɪ d ɚ
glides	ɡ l ˈa ɪ d z
glimmer	ɡ l ˈɪ m ɚ
glistened	ɡ l ˈɪ s ə n d
glitches	ɡ l ˈɪ t͡ʃ ə z
glitter	ɡ l ˈɪ t ɚ
glittering	ɡ l ˈɪ t ɚ ɪ ŋ
globe	ɡ l ˈo ʊ b
globs	ɡ l ˈɑ b z
gloom	ɡ l ˈu m
gloomily	ɡ l ˈu m ə l i
gloomy	ɡ l ˈu m i
gloop	ɡ l ˈu p
glorious	ɡ l ˈɔ ɹ i ə s
gloved	ɡ l ˈʌ v d
glow	ɡ l ˈo ʊ
glowed	ɡ l ˈo ʊ d
glowering	ɡ l ˈa ʊ w ɚ ɹ ɪ ŋ
glowing	ɡ l ˈo ʊ ɪ ŋ
glows	ɡ l ˈo ʊ z
glue	ɡ l ˈu
glum	ɡ l ˈʌ m
glumly	ɡ l ˈʌ m l i
gnarled	n ˈɑ ɹ l d
gnash	n ˈæ ʃ
gnashed	ɡ n ˈæ ʃ t
gnashes	n ˈæ ʃ ə z
gnashing	n ˈæ ʃ ɪ ŋ
gnat	n ˈæ t
gnats	n ˈæ t s
gnaw	n ˈɔ
gnawed	n ˈɔ d
gnawing	n ˈɔ ˈɪ ŋ
gnome	n ˈo ʊ m
gnomes	n ˈo ʊ m z
go	ɡ ˈo ʊ
goal	ɡ ˈo ʊ l
goalkeeper	ɡ ˈo ʊ l k ˈi p ɚ
goalkeepers	ɡ ˈo ʊ l k ˈi p ɚ z
goals	ɡ ˈo ʊ l z
goat	ɡ ˈo ʊ t
goats	ɡ ˈo ʊ t s
gobble	ɡ ˈɑ b ə l
gobbled	ɡ ˈɑ b ə l d
gobbles	ɡ ˈɑ b ə l z
gobbling	ɡ ˈɑ b ə l ɪ ŋ
god	ɡ ˈɑ d
god's	ɡ ˈɑ d z
goes	ɡ o ʊ z
gogo	ɡ ˈo ʊ ɡ o ʊ
going	ɡ ˈo ʊ ɪ ŋ
gold	ɡ ˈo ʊ l d
golden	ɡ ˈo ʊ l d ə n
golem	ɡ ˈo ʊ l ə m
golem's	ɡ ˈo ʊ l ə m z
golems	ɡ ˈo ʊ l ə m z
golf	ɡ ˈɑ l f
gone	ɡ ˈɔ n
goo	ɡ ˈu
good	ɡ ˈʊ d
goodbye	ɡ ˌʊ d b ˈa ɪ
goodnight	ɡ ˈʊ d n ˌa ɪ t
goods	ɡ ˈʊ d z
goop	ɡ ˈu p
goose	ɡ ˈu s
gorillas	ɡ ə ɹ ˈi l l ə z
gosh	ɡ ˈɑ ʃ
gossip	ɡ ˈɑ s ə p
gossiping	ɡ ɑ s ə p ˌi ŋ
got	ɡ ˈɑ t
gotten	ɡ ˈɑ t ə n
government	ɡ ˈʌ v ɚ n m ə n t
gown	ɡ ˈa ʊ n
gowns	ɡ ˈa ʊ n z
goya	ɡ ˈɔ ɪ j ˈɑ
goya's	ɡ ˈɔ ɪ ə z
grab	ɡ ɹ ˈæ b
grabbed	ɡ ɹ ˈæ b d
grabs	ɡ ɹ ˈæ b z
grace	ɡ ɹ ˈe ɪ s
grade	ɡ ɹ ˈe ɪ d d
grades	ɡ ɹ ˈe ɪ d z
graduate	ɡ ɹ ˈæ d͡ʒ u ɪ t
graduate	ɡ ɹ ˈæ d͡ʒ u ˌe ɪ t
graduates	ɡ ɹ ˈæ d͡ʒ u ˌe ɪ t s
graduates	ɡ ɹ ˈæ d͡ʒ u ɪ t s
graffiti	ɡ ɹ ə f ˈi t i
grail	ɡ ɹ ˈe ɪ l
grain	ɡ ɹ ˈe ɪ n
gran	ɡ ɹ ˈæ n
gran's	ɡ ɹ ˈæ n z
grand	ɡ ɹ ˈæ n d
grandad	ɡ ɹ ˈæ n d ˌæ d
grandad's	ɡ ɹ ˈæ n d ˌæ d z
grandads	ɡ ɹ ˈæ n d ˌæ d z
granddaughter	ɡ ɹ ˈæ n d ˌɔ t ɚ
grandfather	ɡ ɹ ˈæ n d f ˌɑ ð ɚ
grandma	ɡ ɹ ˈæ n d m ɑ
grandmother	ɡ ɹ ˈæ n d m ˌʌ ð ɚ
grandmother's	ɡ ɹ ˈæ n d m ˌʌ ð ɚ z
grandmothers	ɡ ɹ ˈæ n d m ˌʌ ð ɚ z
grandpa	ɡ ɹ ˈæ n d p ˌɑ
grandpa's	ɡ ɹ ˈæ n p ˌɑ z
granny	ɡ ɹ ˈæ n i
grant	ɡ ɹ ˈæ n t
granted	ɡ ɹ ˈæ n t ɪ d
graph	ɡ ɹ ˈæ f
graphs	ɡ ɹ ˈæ f s
grasp	ɡ ɹ ˈæ s p
grasped	ɡ ɹ ˈæ s p t
grass	ɡ ɹ ˈæ s
grasses	ɡ ɹ ˈæ s ɪ z
grasshopper	ɡ ɹ ˈæ s h ˌɑ p ɚ
grate	ɡ ɹ ˈe ɪ t
grateful	ɡ ɹ ˈe ɪ t f ə l
gratefully	ɡ ɹ ˈe ɪ t f ə l i
gratitude	ɡ ɹ ˈæ t ə t ˌu d
gravel	ɡ ɹ ˈæ v ə l
gravity	ɡ ɹ ˈæ v ɪ t i
gray	ɡ ɹ ˈe ɪ
graze	ɡ ɹ ˈe ɪ z
grazing	ɡ ɹ ˈe ɪ z ɪ ŋ
great	ɡ ɹ ˈe ɪ t
greek	ɡ ɹ ˈi k
green	ɡ ɹ ˈi n
greenery	ɡ ɹ ˈi n ɚ ɹ i
greenish	ɡ ɹ ˈi n ɪ ʃ
greet	ɡ ɹ ˈi t
greeting	ɡ ɹ ˈi t ɪ ŋ
greetings	ɡ ɹ ˈi t ˈɪ ŋ z
greets	ɡ ɹ ˈi t s
grew	ɡ ɹ ˈu
grey	ɡ ɹ e ɪ
grey	ɡ ɹ ˈe ɪ
grid	ɡ ɹ ˈɪ d
grief	ɡ ɹ ˈi f
griffin	ɡ ɹ ˈɪ f ɪ n
grime	ɡ ɹ ˈa ɪ m
grin	ɡ ɹ ˈɪ n
grind	ɡ ɹ ˈa ɪ n d
grinding	ɡ ɹ ˈa ɪ n d ɪ ŋ
grinds	ɡ ɹ ˈa ɪ n d z
grinned	ɡ ɹ ˈɪ n d
grinning	ɡ ɹ ˈɪ n n ɪ ŋ
grins	ɡ ɹ ˈɪ n z
grip	ɡ ɹ ˈɪ p
gripping	ɡ ɹ ˈɪ p ɪ ŋ
grit	ɡ ɹ ˈɪ t
grits	ɡ ɹ ˈɪ t s
grizzly	ɡ ɹ ˈɪ z l i
groan	ɡ ɹ ˈo ʊ n
groaned	ɡ ɹ ˈo ʊ n d
groaning	ɡ ɹ ˈo ʊ n ɪ ŋ
groans	ɡ ɹ ˈo ʊ n z
grocery	ɡ ɹ ˈo ʊ s ɚ i
groodle	ɡ ɹ ˈu d ə l
grooves	ɡ ɹ ˈu v z
gross	ɡ ɹ ˈo ʊ s
grossest	ɡ ɹ ˈo ʊ s s ɪ s t
ground	ɡ ɹ ˈa ʊ n d
grounds	ɡ ɹ ˈa ʊ n d z
group	ɡ ɹ ˈu p
groups	ɡ ɹ ˈu p s
grove	ɡ ɹ ˈo ʊ v
grow	ɡ ɹ ˈo ʊ
growing	ɡ ɹ ˈo ʊ ɪ ŋ
growl	ɡ ɹ ˈa ʊ l
growled	ɡ ɹ ˈa ʊ l d
growling	ɡ ɹ ˈo ʊ l ɪ ŋ
growls	ɡ ɹ ˈa ʊ l z
grown	ɡ ɹ ˈo ʊ n
grown-up	ɡ ɹ ˈo ʊ n ˈʌ p
grows	ɡ ɹ ˈo ʊ z
growth	ɡ ɹ ˈo ʊ θ
grub	ɡ ɹ ˈʌ b
grubs	ɡ ɹ ˈʌ b z
gruff	ɡ ɹ ˈʌ f
grumble	ɡ ɹ ˈʌ m b ə l
grumpily	ɡ ɹ ˈʌ m p ə l i
grumpy	ɡ ɹ ˈʌ m p i
grunt	ɡ ɹ ˈʌ n t
grunted	ɡ ɹ ˈʌ n t ɪ d
grunting	ɡ ɹ ˈʌ n t ɪ ŋ
grunts	ɡ ɹ ʌ n t z
gryphon	ɡ ɹ ˈɪ f ɪ n
guard	ɡ ˈɑ ɹ d
guardian	ɡ ˈɑ ɹ d i ə n
guardians	ɡ ˈɑ ɹ d i ə n z
guards	ɡ ˈɑ ɹ d z
guava	ɡ w ˈɑ v ə
guavas	ɡ w ˈɑ v ə z
guess	ɡ ˈɛ s
guessed	ɡ ˈɛ s t
guesses	ɡ ˈɛ s ɪ z
guest	ɡ ˈɛ s t
guests	ɡ ˈɛ s t s
guh	ɡ ˈʌ
guide	ɡ ˈa ɪ d
guided	ɡ ˈa ɪ d ɪ d
guildford	ɡ w ˈɪ l d f ɚ d
guilty	ɡ ˈɪ l t i
guise	ɡ ˈa ɪ z
guitar	ɡ ɪ t ˈɑ ɹ
gulp	ɡ ˈʌ l p
gulped	ɡ ˈʌ l p t
gum	ɡ ˈʌ m
gumboots	ɡ ˈʌ m b ˈu t s
gun	ɡ ˈʌ n
gunpowder	ɡ ˈʌ n p ˈa ʊ d ˈɚ
gust	ɡ ˈʌ s t
gut	ɡ ˈʌ t
gutters	ɡ ˈʌ t ɚ z
guy	ɡ ˈa ɪ
guys	ɡ ˈa ɪ z
gympie	ɡ ˈɪ m p i
gyre	d͡ʒ ˈa ɪ ɚ
ha	h ˈɑ
habit	h ˈæ b ə t
habitat	h ˈæ b ə t ˌæ t
habits	h ˈæ b ə t s
hack	h ˈæ k
hacking	h ˈæ k ɪ ŋ
had	h ˈæ d
haddocks	h ˈæ d d ə k s
hadn't	h ˈæ d ə n t
hadnt	h ˈæ d n t
hag	h ˈæ ɡ
hair	h ˈɛ ɹ
hairband	h ˈe ɪ ɹ b ˈæ n d
haircut	h ˈe ɪ ɹ k ˈʌ t
hairs	h ˈɛ ɹ z
hairy	h ˈɛ ɹ i
half	h ˈæ f
halfway	h ˈæ f w ˈe ɪ
hall	h ˈɔ l
halls	h ˈɔ l z
hallway	h ˈɔ l w ˌe ɪ
halo	h ˈe ɪ l o ʊ
halt	h ˈɔ l t
halves	h ˈæ v z
ham	h ˈæ m
hammer	h ˈæ m ɚ
hammered	h ˈæ m ɚ d
hand	h ˈæ n d
handed	h ˈæ n d ɪ d
handful	h ˈæ n d f ˈu l
handiwork	h ˈæ n d i w ˌɚ k
handle	h ˈæ n d ə l
handling	h ˈæ n d l ɪ ŋ
hands	h ˈæ n d z
handsome	h ˈæ n s ə m
handwriting	h ˈæ n d ɹ ˌa ɪ t ɪ ŋ
handwritten	h ˈæ n d ɹ ˌɪ t ə n
handy	h ˈæ n d i
hang	h ˈæ ŋ
hanging	h ˈæ ŋ ɪ ŋ
hangs	h ˈæ ŋ z
hank	h ˈæ ŋ k
hannibal	h ˈæ n n ɪ b ə l
hantu	h ˈʌ n t ˈu
happen	h ˈæ p ə n
happened	h ˈæ p ə n d
happening	h ˈæ p ə n ɪ ŋ
happens	h ˈæ p ə n z
happier	h ˈæ p i ɚ
happiest	h ˈæ p i ɪ s t
happily	h ˈæ p ə l i
happiness	h ˈæ p i n ə s
happy	h ˈæ p i
harassed	h ɚ ˈæ s t
hard	h ˈɑ ɹ d
hard-working	h ˈɑ ɹ d w ˈɚ k ɪ ŋ
hardened	h ˈɑ ɹ d ə n d
harder	h ˈɑ ɹ d ɚ
hardest	h ˈɑ ɹ d ə s t
hardly	h ˈɑ ɹ d l i
hardship	h ˈɑ ɹ d ʃ ɪ p
hardships	h ˈɑ ɹ d ʃ ɪ p s
hare	h ˈɛ ɹ
harm	h ˈɑ ɹ m
harmless	h ˈɑ ɹ m l ə s
harmony	h ˈɑ ɹ m ə n i
harsh	h ˈɑ ɹ ʃ
harvest	h ˈɑ ɹ v ɪ s t
harvested	h ˈɑ ɹ v ɪ s t ɪ d
harvesting	h ˈɑ ɹ v ɪ s t ɪ ŋ
has	h ˈæ z
hasn't	h ˈæ z ə n t
haste	h ˈe ɪ s t
hat	h ˈæ t
hatch	h ˈæ t͡ʃ
hatched	h ˈæ t͡ʃ t
hatches	h ˈæ t͡ʃ ɪ z
hatchling	h ˈæ t͡ʃ l ɪ ŋ
hate	h ˈe ɪ t
hated	h ˈe ɪ t ɪ d
hates	h ˈe ɪ t s
hats	h ˈæ t s
haul	h ˈɔ l
hauls	h ˈɔ l z
haunch	h ˈa ʊ n t͡ʃ
haunches	h ˈa ʊ n t͡ʃ ɪ z
haunt	h ˈɔ n t
haunted	h ˈɔ n t ɪ d
haunts	h ˈɔ n t s
have	h ˈæ v
haven	h ˈe ɪ v ə n
haven't	h æ v ə n t
havent	h ˈe ɪ v ə n t
having	h ˈæ v ɪ ŋ
havoc	h ˈæ v ə k
haw	h ˈɔ
hawk	h ˈɔ k
hay	h ˈe ɪ
haystack	h ˈe ɪ s t ˌæ k
hazard	h ˈæ z ɚ d
hazards	h ˈæ z ɚ d z
he	h ˈi
he'd	h ˈi d
he's	h ˈi z
head	h ˈɛ d
headband	h ˈɛ d b ˌæ n d
headbands	h ˈɛ d b ˌæ n d z
headcold	h ˈɛ d k ˌo ʊ l d
headed	h ˈɛ d ɪ d
heading	h ˈɛ d ɪ ŋ
heads	h ˈɛ d z
headscarf	h ˈɛ d s k ˈɑ ɹ f
heal	h ˈi l
healed	h ˈi l d
heals	h ˈi l z
health	h ˈɛ l θ
healthy	h ˈɛ l θ i
heap	h i p
heaping	h ˈi p ɪ ŋ
hear	h ˈɪ ɹ
heard	h ˈɚ d
hearing	h ˈɪ ɹ ɪ ŋ
hears	h ˈɪ ɹ z
heart	h ˈɑ ɹ t
heartbeat	h ɑ ɹ t b i t
hearts	h ˈɑ ɹ t s
heat	h ˈi t
heated	h i t ə d
heavier	h ˈɛ v i ɚ
heavies	h ˈɛ v i z
heavy	h ˈɛ v i
heckled	h ˈɛ k ə l d
heed	h ˈi d
heel	h ˈi l
heels	h ˈi l z
heft	h ˈɛ f t
height	h ˈa ɪ t
heights	h ˈa ɪ t s
heights	h ˈa ɪ t s
heinous	h ˈe ɪ n ə s
held	h ˈɛ l d
hello	h ɛ l ˈo ʊ
helmet	h ˈɛ l m ə t
help	h ˈɛ l p
helped	h ˈɛ l p t
helper	h ˈɛ l p ɚ
helpers	h ˈɛ l p ɚ z
helpful	h ˈɛ l p f ə l
helpin	h ˈɛ l p ɪ ŋ
helping	h ˈɛ l p ɪ ŋ
helpless	h ˈɛ l p l ə s
helplessly	h ˈɛ l p l ə s l i
helps	h ˈɛ l p s
hem	h ˈɛ m
hen	h ˈɛ n
hens	h ˈɛ n z
her	h ˈɚ
herb	ˈɚ b
herbivore	ˈɚ b ɪ v ˌɔ ɹ
herbivores	h ˈɚ b ɪ v ɚ z
herbs	ˈɚ b z
hercules	h ˈɚ k j ə l ˌi z
herd	h ˈɚ d
herded	h ˈɚ d ɪ d
here	h ˈɪ ɹ
here's	h ˈɪ ɹ z
hero	h ˈɪ ɹ o ʊ
heroes	h ˈɪ ɹ o ʊ z
heron	h ˈɛ ɹ ə n
heros	h ˈɪ ɹ o ʊ z
hers	h ˈɚ z
herself	h ɚ s ˈɛ l f
hes	h z
hesitation	h ˌɛ z ɪ t ˈe ɪ ʃ ə n
hexes	h ˈɛ k s ə z
hey	h ˈe ɪ
heyday	h ˈe ɪ d ˌe ɪ
hhh	h h h h h
hi	h ˈa ɪ
hid	h ˈɪ d
hidden	h ˈɪ d ə n
hide	h ˈa ɪ d
hideous	h ˈɪ d i ə s
hides	h ˈa ɪ d z
hiding	h ˈa ɪ d ɪ ŋ
high	h ˈa ɪ
higher	h ˈa ɪ ɚ
highest	h ˈa ɪ ɪ s t
highlight	h ˈa ɪ l ˌa ɪ t
highlighted	h ˈa ɪ l ˌa ɪ t ɪ d
highlights	h ˈa ɪ l ˌa ɪ t s
hike	h ˈa ɪ k
hikes	h ˈa ɪ k s
hilarious	h ɪ l ˈɛ ɹ i ə s
hill	h ˈɪ l
hills	h ˈɪ l z
hillside	h ˈɪ l s ˌa ɪ d
hilltop	h ˈɪ l t ˌɑ p
him	h ˈɪ m
himself	h ɪ m s ˈɛ l f
hind	h ˈa ɪ n d
hint	h ˈɪ n t
hip	h ˈɪ p
hippo	h ˈɪ p p o ʊ
hips	h ɪ p s
hire	h ˈa ɪ ɚ
his	h ˈɪ z
hiss	h ˈɪ s
hissed	h ˈɪ s t
hisses	h ˈɪ s ɪ z
hissing	h ˈɪ s s ɪ ŋ
hissy	h ˈɪ s s i
history	h ˈɪ s t ɚ ɹ i
hit	h ˈɪ t
hits	h ɪ t s
hitting	h ˈɪ t t ɪ ŋ
hive	h ˈa ɪ v
hives	h ˈa ɪ v z
hmm	h ə m
hmmm	h m m m
hoax	h ˈo ʊ k s
hoaxes	h ˈo ʊ k s ɪ z
hobbies	h ˈɑ b i z
hobby	h ˈɑ b i
hoe	h ˈo ʊ
hog	h ˈɑ ɡ
hoglin	h ˈɑ ɡ l ɪ n
hogs	h ˈɑ ɡ z
hoist	h ˈɔ ɪ s t
hold	h ˈo ʊ l d
holding	h ˈo ʊ l d ɪ ŋ
holds	h ˈo ʊ l d z
hole	h ˈo ʊ l
holes	h ˈo ʊ l z
holi	h ˈo ʊ l i
holiday	h ɑ l ə d e ɪ j
holidays	h ˈɑ l ɪ d ˌe ɪ z
hollow	h ˈɑ l o ʊ
holy	h ˈo ʊ l i
home	h ˈo ʊ m
homeland	h ˈo ʊ m l ˌæ n d
homes	h ˈo ʊ m z
homesick	h ˈo ʊ m s ˌɪ k
homework	h ˈo ʊ m w ˌɚ k
hominid	h ˈɑ m ˈɪ n ˈɪ d
honey	h ˈʌ n i
honeycombs	h ˈʌ n i k ˈo ʊ m z
honk	h ˈɔ ŋ k
honks	h ˈɔ ŋ k s
honor	ˈɑ n ɚ
honour	ˈɑ n ɚ
hood	h ˈʊ d
hook	h ˈʊ k
hooked	h ˈʊ k t
hooray	h ʊ ɹ ˈe ɪ
hooves	h ˈu v z
hop	h ˈɑ p
hope	h ˈo ʊ p
hoped	h ˈo ʊ p t
hopefully	h ˈo ʊ p f ə l i
hopeless	h ˈo ʊ p l ə s
hopes	h o ʊ p s
hoping	h ˈo ʊ p ɪ ŋ
hopped	h ˈɑ p t
hopper	h ɑ p ə
hopping	h ˈɑ p p ɪ ŋ
hops	h ˈɑ p s
horde	h ˈɔ ɹ d
hordes	h ˌɔ ɹ d z
horizon	h ɚ ɹ ˈa ɪ z ə n
horn	h ˈɔ ɹ n
hornbill	h ˈɔ ɹ n b ˌɪ l
hornbill's	h ˈɔ ɹ n b ˌɪ l z
horns	h ˈɔ ɹ n z
horrendous	h ˌɔ ɹ ˈɛ n d ə s
horrible	h ˈɔ ɹ ə b ə l
horrid	h ˈɔ ɹ ə d
horrified	h ˈɔ ɹ ə f a ɪ d
horrifying	h ˈɔ ɹ ə f ˌa ɪ ɪ ŋ
horror	h ˈɔ ɹ ɚ
horse	h ˈɔ ɹ s
horseman	h ɔ ɹ s m ˈɛ n
horses	h ɔ ɹ s ɪ z
hose	h ˈo ʊ z
hospital	h ˈɔ s p ˌɪ t ə l
host	h ˈo ʊ s t
hostile	h ɑ s t ˈa ɪ l
hot	h ˈɑ t
houdini	h u d ˈi n i
hound	h ˈa ʊ n d
hour	ˈa ʊ ɚ
hours	ˈa ʊ ɚ z
house	h ˈa ʊ s
house	h ˈa ʊ z
houseboat	h ˈa ʊ s b ˌo ʊ t
houseboats	h ˈa ʊ s b ˌo ʊ t s
housed	h ˈa ʊ z d
household	h ˈa ʊ s h ˌo ʊ l d
houses	h ˈa ʊ z ɪ z
housework	h ˈa ʊ s w ˌɚ k
hover	h ˈʌ v ɚ
hovered	h ˈʌ v ɚ d
how	h ˈa ʊ
however	h ˌa ʊ ˈɛ v ɚ
howl	h ˈa ʊ l
howling	h ˈa ʊ l ɪ ŋ
howls	h ˈa ʊ l z
hub	h ʌ b
hubbub	h ʌ b ə b
huddled	h ˈʌ d ə l d
huddles	h ˈʌ d ə l z
hue	h j ˈu
hues	h j ˈu z
huff	h ˈʌ f
hug	h ˈʌ ɡ
huge	h j ˈu d͡ʒ
hugged	h ˈʌ ɡ d
hugs	h ˈʌ ɡ z
huh	h ˈʌ
hum	h ˈʌ m
human	h j ˈu m ə n
human's	h j ˈu m ə n z
human-like	h j ˈu m ə n l ˈa ɪ k
humans	h j ˈu m ə n z
humble	h ˈʌ m b ə l
humid	h j ˈu m ɪ d
humming	h ˈʌ m ɪ ŋ
hump	h ˈʌ m p
hums	h ʌ m z
hundred	h ˈʌ n d ɹ ɪ d
hundreds	h ˈʌ n d ɹ ɪ d z
hung	h ˈʌ ŋ
hunger	h ˈʌ ŋ ɡ ɚ
hungrily	h ˈʌ ŋ ɡ ɹ ə l i
hungry	h ˈʌ ŋ ɡ ɹ i
hunker	h ʌ ŋ k ə ɹ
hunt	h ˈʌ n t
hunted	h ˈʌ n t ɪ d
hunter	h ˈʌ n t ɚ
hunters	h ˈɑ n t ɚ z
hunting	h ˈʌ n t ɪ ŋ
hunts	h ˈʌ n t s
hurled	h ˈɚ l d
hurries	h ˈɚ ɹ i z
hurry	h ˈɚ ɹ i
hurrying	h ˈɚ ɹ i ɪ ŋ
hurt	h ˈɚ t
hurting	h ˈɚ t ɪ ŋ
hurts	h ˈɚ t s
husband	h ˈʌ z b ə n d
husband's	h ˈʌ z b ə n d z
hush	h ˈʌ ʃ
hushed	h ˈʌ ʃ t
husk	h ˈʌ s k
husks	h ˈʌ s k s
hustle	h ˈʌ s ə l
hut	h ˈʌ t
huts	h ˈʌ t s
hybrid	h ˈa ɪ b ɹ ɪ d
hybrids	h ˈa ɪ b ɹ ɪ d z
hydra	h ˈa ɪ d ɹ ə
hyena	h a ɪ ˈi n ə
hyenas	h a ɪ ˈi n ə z
hype	h ˈa ɪ p
i	ˈa ɪ
i'd	ˈa ɪ d
i'll	ˈa ɪ l
i'm	a ɪ m
i've	ˈa ɪ v
i-e	ˈa ɪ ˈi
i-g-h	ˈa ɪ d͡ʒ ˈi ˈe ɪ t͡ʃ
i-l	ˈa ɪ ˈɛ l
ice	ˈa ɪ s
ice-cream	ˈa ɪ s k ɹ ˈi m
ice-creams	ˈa ɪ s k ɹ ˈi m z
icing	ˈa ɪ s ɪ ŋ
icon	ˈa ɪ k ɑ n
iconic	a ɪ k ˈɑ n ɪ k
icy	ˈa ɪ s i
id	ˈa ɪ d ˈi
idea	a ɪ d ˈi ə
ideas	a ɪ d ˈi ə z
identical	a ɪ d ˈɛ n t ɪ k ə l
idle	ˈa ɪ d ə l
if	ˈɪ f
ignorant	ˈɪ ɡ n ɚ ə n t
ignore	ɪ ɡ n ˈɔ ɹ
ignored	ɪ ɡ n ɔ ɹ d
ignores	ɪ ɡ n ˈɔ ɹ z
ignoring	ˈɪ ɡ n ˈɔ ɹ ˈɪ ŋ
ill	ˈɪ l
illegal	ɪ l ˈi ɡ ə l
illumination	ɪ l l ˌu m ɪ n ˈe ɪ ʃ ə n
illusion	ɪ l l ˈu ʒ ə n
ilse	ˈɪ l s ə
im	a ɪ m
image	ˈɪ m ɪ d͡ʒ
images	ˈɪ m ɪ d͡ʒ ɪ z
imagination	ɪ m ˌæ d͡ʒ ɪ n ˈe ɪ ʃ ə n
imagine	ɪ m ˈæ d͡ʒ ə n
imagined	ɪ m ˈæ d͡ʒ ə n d
imagines	ɪ m ˈæ d͡ʒ ə n z
immediately	ɪ m ˈi d i ɪ t l i
impact	ˈɪ m p æ k t
impatience	ɪ m p ˈe ɪ ʃ ə n s
impatiently	ɪ m p ˈe ɪ ʃ ə n t l i
impetuous	ɪ m p ˈɛ t͡ʃ u ə s
impish	ˈɪ m p ɪ ʃ
implement	ˈɪ m p l ə m ɛ n t
implement	ˈɪ m p l ə m ə n t
implements	ˈɪ m p l ə m ə n t s
implements	ˈɪ m p l ə m ɛ n t s
important	ɪ m p ˈɔ ɹ t ə n t
impossible	ɪ m p ˈɑ s ə b ə l
impress	ˈɪ m p ɹ ɛ s
impressed	ɪ m p ɹ ˈɛ s t
impression	ɪ m p ɹ ˈɛ ʃ ə n
impressions	ɪ m p ɹ ˈɛ ʃ ə n z
impressive	ɪ m p ɹ ˈɛ s ɪ v
improve	ɪ m p ɹ ˈu v
improving	ɪ m p ɹ ˈu v ɪ ŋ
in	ˈɪ n
inbound	i n b ˈa ʊ n d
inch	ˈɪ n t͡ʃ
inches	ˈi n t͡ʃ ə z
incident	ˈɪ n s ɪ d ə n t
incidents	ˈɪ n s ɪ d ə n t s
include	ɪ ŋ k l ˈu d
includes	ɪ ŋ k l ˈu d z
including	ɪ ŋ k l ˈu d ɪ ŋ
income	ˌi n k ʌ m
increased	ɪ ŋ k ɹ ˈi s t
indeed	ɪ n d ˈi d
india	ˈɪ n d i ˈɑ
indian	ˈɪ n d i ə n
indigeneous	ɪ n d ɪ ɡ j ɪ n ə s
individual	ˌɪ n d ɪ v ˈɪ d͡ʒ u ə l
individuals	ˌɪ n d ɪ v ˈɪ d͡ʒ u ə l z
indochinese	ˈɪ n d ˈo ʊ t͡ʃ ˈa ɪ n ˈi z
indonesia	ˌɪ n d o ʊ n ˈi ʒ ə
indonesia's	ɪ n d ə n ˈi ʒ ə z
indonesian	ˌɪ n d o ʊ n ˈi ʒ ə n
indside	ˈɪ n s ˌa ɪ d
inequality	ɪ n i k w o ʊ l ɪ t i
infest	ɪ n f ˈɛ s t
infinite	ˈɪ n f ɪ n ɪ t
influence	ˈɪ n f l u ə n s
inform	ɪ n f ɔ ɹ m
information	ˌɪ n f ɔ ɹ m ˈe ɪ ʃ ə n
infringing	ɪ n f ɹ ˈɪ n d͡ʒ ɪ ŋ
ingot	ˈɪ ŋ ɡ ə t
ingots	i n ɡ ə t s
ingredient	ɪ ŋ ɡ ɹ ˈi d i ə n t
ingredients	ɪ ŋ ɡ ɹ ˈi d i ə n t s
injured	ˌi n d͡ʒ ə d
injuries	ɪ n d ʒ ə ɹ i z
ink	ˈɪ ŋ k
inks	ˈɪ ŋ k s
inky	ˈɪ n k ˈi
innards	ˈɪ n ɚ d z
inner	ˈɪ n ɚ
innocent	ˌi n ʌ s ɛ n t
ins	ˈɪ n z
insect	ˈɪ n s ˌɛ k t
insect's	ˈɪ n s ˌɛ k t s
insects	ˈɪ n s ˌɛ k t s
insert	ˈɪ n s ɚ t
inside	ˈɪ n s ˌa ɪ d
insist	ɪ n s ˈɪ s t
insisted	ɪ n s ˈɪ s t ɪ d
inspire	ɪ n s p ˈa ɪ ɚ
inspires	ɪ n s p ˈa ɪ ɚ z
inspiring	ɪ n s p ˈa ɪ ɹ ɪ ŋ
instal	ɪ n s t ˈɔ l
install	ɪ n s t ˈɔ l
installing	ɪ n s t ˈɔ l ɪ ŋ
instant	ˈɪ n s t ə n t
instantly	ˈɪ n s t ə n t l ˌi
instar	ɪ n s t ɚ
instars	ɪ n s t ɚ z
instead	ɪ n s t ˈɛ d
instincts	ˈɪ n s t ɪ ŋ k t s
instructed	ɪ n s t ɹ ˈʌ k t ɪ d
instruction	ɪ n s t ɹ ˈʌ k ʃ ə n
instructions	ɪ n s t ɹ ˈʌ k ʃ ə n z
instrument	ˈɪ n s t ɹ ə m ə n t
instruments	ˈɪ n s t ɹ ə m ə n t s
intact	ɪ n t ˈæ k t
intelligent	ɪ n t ˈɛ l ɪ d͡ʒ ə n t
intend	ɪ n t ˈɛ n d
intense	ɪ n t ˈɛ n s
interact	ˌɪ n t ɚ ˈæ k t
interacted	ˌɪ n t ɚ ˈæ k t t ɪ d
interacting	ˌɪ n t ɚ ˈæ k t ɪ ŋ
interest	ˈɪ n t ɚ ˌɛ s t
interested	ˈɪ n t ɚ ˌɛ s t ɪ d
interesting	ˈɪ n t ɚ ˌɛ s t ɪ ŋ
interfere	ˌɪ n t ɚ f ˈɪ ɹ
internal	ɪ n t ˈɚ n ə l
international	ˌɪ n t ɚ n ˈæ ʃ ə n ə l
internet	ˈɪ n t ɚ n ˌɛ t
interrupt	ˌɪ n t ɚ ɹ ɹ ˈʌ p t
interrupts	ˌɪ n t ɚ ˈʌ p t s
intertwines	ˈɪ n t ɚ t w ˌa ɪ n z
intimate	ˈɪ n t ɪ m ˌe ɪ t
intimate	ˈɪ n t ɪ m ɪ t
intimates	ˈɪ n t ɪ m ɪ t s
intimates	ˈɪ n t ɪ m ˌe ɪ t s
into	ˈɪ n t u
introduce	ˌɪ n t ɹ o ʊ d ˈu s
introductions	ɪ n t ɹ ə d ʌ k ʃ ə n z
intruders	ɪ n t ɹ ˈu d ɚ z
intuitive	ɪ n t ˈu ə t ɪ v
invade	ɪ n v ˈe ɪ d
invading	ˈi n v ˈe ɪ d ˈi ŋ
inveigh	ɪ n v ˈe ɪ
invent	ɪ n v ˈɛ n t
invention	ɪ n v ˈɛ n ʃ ə n
inventions	ˌi n v ɛ n t͡ʃ ə n z
inventory	ˌɪ n v ə n t ˈɔ ɹ i
invents	ɪ n v ˈɛ n t s
investigating	ˌɪ n v ˈɛ s t ə ɡ e ɪ t ɪ ŋ
invite	ɪ n v ˈa ɪ t
invited	ɪ n v a ɪ t ɪ d
inviting	ɪ n v ˈa ɪ t ɪ ŋ
involved	ɪ n v ˈɑ l v d
involves	ɪ n v ˈɑ l v z
involving	ɪ n v ˈɑ l v ɪ ŋ
inès	ɪ n ˈɛ z
iron	ˈa ɪ ɚ n
irra	ˈɪ ɹ ˈɑ
irrawaddy	ˈɪ ɹ ə w ˈɑ d ˈi
is	ˈɪ z
island	ˈa ɪ l ə n d
islands	ˈa ɪ l ə n d z
isn't	ɪ z ə n t
isnt	ɪ s n t
issue	ˈɪ ʃ u
issues	ˈɪ ʃ u z
it	ˈɪ t
it'll	ˈɪ t ə l
it's	ˈɪ t s
itch	ˈɪ t͡ʃ
itchy	ˈɪ t͡ʃ i
itchy-looking	ˈɪ t͡ʃ i l ˈʊ k ɪ ŋ
item	ˈa ɪ t ə m
items	ˈa ɪ t ə m z
its	ˈɪ t s
itself	ɪ t s ˈɛ l f
j	d͡ʒ ˈe ɪ
jab	d͡ʒ ˈæ b
jabbing	d͡ʒ ˈæ b ɪ ŋ
jack	d͡ʒ ˈæ k
jack's	d͡ʒ ˈæ k s
jack-o-lantern	d͡ʒ ˈæ k ˈo ʊ l ˈæ n t ɚ n
jacket	d͡ʒ ˈæ k ɪ t
jackets	d͡ʒ ˈæ k ɪ t s
jackpot	d͡ʒ ˈæ k p ˈɑ t
jacks	d͡ʒ ˈæ k s
jagged	d͡ʒ ˈæ ɡ ɪ d
jagged	d͡ʒ ˈæ ɡ d
jail	d͡ʒ ˈe ɪ l
jam	d͡ʒ ˈæ m
jan	d͡ʒ ˈæ n
jane	d͡ʒ ˈe ɪ n
jane's	d͡ʒ ˈe ɪ n z
jar	d͡ʒ ˈɑ ɹ
jars	d͡ʒ ˈɑ ɹ z
jasmine	d͡ʒ ˈæ z m ɪ n
jaunt	d͡ʒ ˈɔ n t
java	d͡ʒ ˈɑ v ə
javan	d͡ʒ ˈɑ v ə n
jaw	d͡ʒ ˈɔ
jawbone	d͡ʒ ˈɔ b ˌo ʊ n
jawbones	d͡ʒ ˈɔ b ˌo ʊ n z
jaws	d͡ʒ ˈɔ z
jay	d͡ʒ ˈe ɪ
jealous	d͡ʒ ˈɛ l ə s
jellyfish	d͡ʒ ˈɛ l i f ˌɪ ʃ
jen	d͡ʒ ˈɛ n
jerk	d͡ʒ ˈɚ k
jerry	d͡ʒ ˈɛ ɹ ɹ i
jerry's	d͡ʒ ˈɛ ɹ ɹ i z
jet	d͡ʒ ˈɛ t
jets	d͡ʒ ˈɛ t s
jewel	d͡ʒ ˈu l
jig	d͡ʒ ˈɪ ɡ
jill	d͡ʒ ˈɪ l
jill's	d͡ʒ ˈɪ l z
jim	d͡ʒ ˈɪ m
jim's	d͡ʒ ˈɪ m z
jims	d͡ʒ ˈɪ m z
jin	d͡ʒ ˈɪ n
jin's	d͡ʒ ˈɪ n z
job	d͡ʒ ˈɑ b
jobs	d͡ʒ ˈɑ b z
joey	d͡ʒ ˈo ʊ i
jog	d͡ʒ ˈɔ ɡ
jogs	d͡ʒ ˈɔ ɡ z
join	d͡ʒ ˈɔ ɪ n
joined	d͡ʒ ˈɔ ɪ n d
joining	d͡ʒ ˈɔ ɪ n ɪ ŋ
joins	d͡ʒ ˈɔ ɪ n z
jojo	d͡ʒ ˈo ʊ d͡ʒ o ʊ
joke	d͡ʒ ˈo ʊ k
joked	d͡ʒ ˈo ʊ k t
jokes	d͡ʒ ˈo ʊ k s
jolly	d͡ʒ ˈɑ l i
jolt	d͡ʒ ˈo ʊ l t
jolted	d͡ʒ ˈo ʊ l t ɪ d
jolts	d͡ʒ ˈo ʊ l t s
jones	d͡ʒ ˈo ʊ n z
jot	d͡ʒ ˈɑ t
journey	d͡ʒ ˈɚ n i
journeys	d͡ʒ ˈɚ n i z
joy	d͡ʒ ˈɔ ɪ
judge	d͡ʒ ʌ d͡ʒ
judges	d͡ʒ ˈʌ d͡ʒ ɪ z
jug	d͡ʒ ˈʌ ɡ
juggle	d͡ʒ ˈʌ ɡ ə l
juggles	d͡ʒ ˈʌ ɡ ə l z
juggling	d͡ʒ ˈʌ ɡ l ɪ ŋ
jugular	d͡ʒ ˈu ɡ j ə l ɚ
juice	d͡ʒ ˈu s
juiciest	d͡ʒ ˈu s i ɪ s t
juicy	d͡ʒ ˈu s i
jump	d͡ʒ ˈʌ m p
jumped	d͡ʒ ˈʌ m p t
jumper	d͡ʒ ˈʌ m p ɚ
jumping	d͡ʒ ˈʌ m p ɪ ŋ
jumps	d͡ʒ ˈʌ m p s
jungle	d͡ʒ ˈʌ ŋ ɡ ə l
junk	d͡ʒ ˈʌ ŋ k
jupiter	d͡ʒ ˈu p ɪ t ɚ
jurassic	d͡ʒ ʊ ɹ ˈæ s s ɪ k
just	d͡ʒ ˈʌ s t
jut	d͡ʒ ʌ t
k	k ˈe ɪ
k-n	k ˈe ɪ ˈɛ n
kaa	k ˈɑ
kaboom	k ə b ˈu m
kale	k ˈe ɪ l
kangaroo	k ˌæ ŋ ɡ ɚ ɹ ˈu
kangaroos	k ˌæ ŋ ɡ ɚ ɹ ˈu z
kapok	k ˈe ɪ p ɑ k
kara	k ˈɑ ɹ ˈɑ
kate	k ˈe ɪ t
keeling	k ˈi l ɪ ŋ
keen	k ˈi n
keep	k ˈi p
keepers	k ˈi p ɚ z
keeping	k ˈi p ɪ ŋ
keeps	k ˈi p s
kelp	k ˈɛ l p
kem	k ˈɛ m
kem's	k ˈɛ m z
ken	k ˈɛ n
kennel	k ˈɛ n ə l
kept	k ˈɛ p t
kerinci	k ɚ ˈi n t͡ʃ ˈɪ
key	k ˈi
keys	k ˈi z
khan	k ˈɑ n
khans	k h ˈæ n z
khh	k ə
kick	k ˈɪ k
kicked	k ˈɪ k t
kicking	k ˈɪ k ɪ ŋ
kicks	k ˈɪ k s
kid	k ˈɪ d
kid's	k ˈɪ d z
kidnap	k ˈɪ d n ˌæ p
kidnapped	k ˈɪ d n ˌæ p t
kids	k ˈɪ d z
kill	k ˈɪ l
killed	k ˈɪ l d
killer	k ˈɪ l ɚ
kills	k ˈɪ l z
kilogram	k ˈɪ l ə ɡ ɹ ˌæ m
kilogramme	k ˈɪ l ə ɡ ɹ ˈæ m
kilogrammes	k ˈɪ l ˈo ʊ ɡ ɹ æ m z
kilograms	k ˈɪ l ˈo ʊ ɡ ɹ æ m z
kilos	k ˈi l ˈo ʊ z
kim	k ˈɪ m
kim's	k ˈɪ m z
kina	k ˈi n ə
kind	k ˈa ɪ n d
kindly	k a ɪ n d l i
kinds	k ˈa ɪ n d z
king	k ˈɪ ŋ
kingdom	k ˈɪ ŋ d ə m
kingfisher	k ˈɪ ŋ f ˌɪ ʃ ɚ
kingfisher's	k ˈɪ ŋ f ˌɪ ʃ ɚ z
kingfishers	k ˈɪ ŋ f ˌɪ ʃ ɚ z
kings	k ˈɪ ŋ z
kip	k ˈɪ p
kiss	k ˈɪ s
kisses	k ˈɪ s ɪ z
kit	k ˈɪ t
kitchen	k ˈɪ t͡ʃ ə n
kitchen's	k ɪ t͡ʃ ə n z
kite	k ˈa ɪ t
kite's	k ˈa ɪ t s
kites	k ˈa ɪ t s
kits	k ˈɪ t s
kitten	k ˈɪ t ə n
kittens	k ˈɪ t ə n z
kitty	k ˈɪ t i
klik	k l ɪ k
knack	n ˈæ k
knead	n ˈi d
kneads	n ˈi d z
knee	n ˈi
kneel	n ˈi l
kneels	n ˈi l z
knees	n ˈi z
knelt	n ˈɛ l t
knew	n j ˈu
knife	n ˈa ɪ f
knight	n ˈa ɪ t
knight's	n ˈa ɪ t s
knighted	n ˈa ɪ t ɪ d
knights	n ˈa ɪ t s
knit	n ˈɪ t
knits	n ˈɪ t s
knitted	n ˈɪ t t ɪ d
knives	n ˈa ɪ v z
knob	n ˈɑ b
knobbly	n ˈɑ b l i
knobs	n ɔ b z
knock	n ˈɑ k
knocked	n ˈɑ k t
knocking	n ˈɑ k ɪ ŋ
knocks	k n ˈɑ k s
knot	n ˈɑ t
know	n ˈo ʊ
knowing	n ˈo ʊ ɪ ŋ
knowledge	n ˈɑ l ɪ d͡ʒ
knowledgeable	n ˈɑ l ɪ d͡ʒ ə b ə l
known	n ˈo ʊ n
knows	n ˈo ʊ z
kobi	k ˈo ʊ b i
kojo	k ˈo ʊ d͡ʒ o ʊ
kojo's	k ˈo ʊ d͡ʒ o ʊ z
kom	k ɑ m
komodo	k ə m ˈo ʊ d ˈo ʊ
kong	k ˈɔ ŋ
krill	k ɹ ˈɪ l
l	ˈɛ l
l-e	ˈɛ l ˈi
la	l ˈɑ
lab	l ˈæ b
label	l ˈe ɪ b ə l
labels	l ˈe ɪ b ə l z
labor	l ˈe ɪ b ɚ
laborers	l ˈe ɪ b ɚ ɹ ɚ z
labors	l ˈe ɪ b ɚ z
labour	l ˈe ɪ b ɚ
labourers	l ə b ˌɔ ɹ ɚ z
labours	l ˈe ɪ b ɚ z
lace	l ˈe ɪ s
laces	l ˈe ɪ s ɪ z
lachlan	l ˈæ k l ə n
lachlan's	l ˈæ k l ə n z
lachlans	l ˈæ k l ə n z
lacked	l ˈæ k t
lacy	l ˈe ɪ s i
lad	l ˈæ d
ladder	l ˈæ d ɚ
ladders	l ˈæ d ɚ z
laden	l ˈe ɪ d ə n
ladies	l ˈe ɪ d i z
lads	l ˈæ d z
lady	l ˈe ɪ d i
lady's	l ˈe ɪ d i z
ladybird	l ˈe ɪ d i b ˌɚ d
ladybirds	l ˈe ɪ d i b ˈɚ d z
ladybug	l ˈe ɪ d i b ˌʌ ɡ
ladybugs	l ˈe ɪ d i b ˌʌ ɡ z
ladys	l ˈe ɪ d i z
lagged	l ˈæ ɡ d
laid	l ˈe ɪ d
lake	l ˈe ɪ k
lakebed	l ˈe ɪ k b ˌɛ d
lakes	l ˈe ɪ k s
lakeside	l ˈe ɪ k s ˌa ɪ d
lamb's	l ˈæ m z
lamp	l ˈæ m p
lamps	l ˈæ m p s
lan	l ˈæ n
land	l ˈæ n d
landed	l ˈæ n d ɪ d
landing	l ˈæ n d ɪ ŋ
lands	l ˈæ n d z
landscape	l ˈæ n d s k ˌe ɪ p
landslide	l ˈæ n d s l ˌa ɪ d
lane	l ˈe ɪ n
lanes	l ˈe ɪ n z
language	l ˈæ ŋ ɡ w ɪ d͡ʒ
lankan	l ˈæ n k ə n
lantern	l ˈæ n t ɚ n
lanterns	l ˈæ n t ɚ n z
lap	l ˈæ p
lapis	l ˈæ p ə s
laps	l ˈæ p s
laptop	l ˈæ p t ˌɑ p
lara	l ˈɑ ɹ ɑ
large	l ˈɑ ɹ d͡ʒ
larger	l ˈɑ ɹ d͡ʒ ɚ
largest	l ˈɑ ɹ d͡ʒ ɪ s t
larva	l ˈɑ ɹ v ə
larvae	l ˈɑ ɹ v i
larval	l ˈɑ ɹ v ə l
lasagna	l ə z ˈɑ n j ə
laser	l ˈe ɪ z ɚ
last	l ˈæ s t
lasting	l ɑ s t ˌi ŋ
lasts	l ˈæ s t s
latch	l ˈæ t͡ʃ
late	l ˈe ɪ t
lately	l ˈe ɪ t l i
later	l ˈe ɪ t ɚ
latest	l ˈe ɪ t ɪ s t
laugh	l ˈæ f
laughed	l ˈæ f t
laughing	l ˈæ f ɪ ŋ
laughs	l ˈæ f s
laughter	l ˈæ f t ɚ
launch	l ˈɔ n t͡ʃ
launched	l ˈɔ n t͡ʃ t
launches	l ˈɔ n t͡ʃ ɪ z
lava	l ˈɑ v ə
law	l ˈɔ
lawn	l ˈɔ n
laws	l ˈɔ z
lawson	l ˈɔ s ə n
lay	l ˈe ɪ
layer	l ˈe ɪ ɚ
laying	l ˈe ɪ ɪ ŋ
lays	l ˈe ɪ z
laze	l ˈe ɪ z
lazed	l ˈe ɪ z d
lazuli	l ˌæ z j u l a ɪ
lazy	l ˈe ɪ z i
leaches	l ˈi t͡ʃ ɪ z
leacy	l ˈɛ ɡ ə s i
lead	l ˈi d
leader	l ˈi d ɚ
leaders	l ˈi d ɚ z
leading	l ˈi d ɪ ŋ
leads	l ˈi d z
leaf	l ˈi f
leafy	l ˈi f i
leaks	l ˈi k s
lean	l ˈi n
leaning	l ˈi n ɪ ŋ
leans	l ˈi n z
leap	l ˈi p
leaping	l i p ɪ ŋ
leaps	l ˈi p s
leapt	l ˈɛ p t
learn	l ˈɚ n
learned	l ˈɚ n d
learned	l ˈɚ n ɪ d
learning	l ˈɚ n ɪ ŋ
learns	l ˈɚ n z
learnt	l ˈɚ n t
leash	l ˈi ʃ
least	l ˈi s t
leather	l ˈɛ ð ə ɹ
leave	l ˈi v
leaves	l i v z
leaving	l ˈi v ɪ ŋ
led	l ˈɛ d
ledge	l ˈɛ d͡ʒ
left	l ˈɛ f t
leftover	l ˈɛ f t ˌo ʊ v ɚ
leg	l ˈɛ ɡ
legacy	l ˈɛ ɡ ə s i
legend	l ˈɛ d͡ʒ ə n d
legendary	l ˈɛ d͡ʒ ˈɛ n d ˈɛ ɹ i
legged	l ˈɛ ɡ d
legs	l ˈɛ ɡ z
leisure	l ˈi ʒ ɚ
lem	l ɛ m
lemon	l ˈɛ m ə n
len	l ˈɛ n
lend	l ˈɛ n d
length	l ˈɛ ŋ θ
lens	l ˈɛ n z
lent	v
leopard	l ˈɛ p ɚ d
leopards	l ɛ p ɚ d z
less	l ˈɛ s
lesser	l ˈɛ s ɚ
lesson	l ˈɛ s ə n
lessons	l ˈɛ s ə n z
let	l ˈɛ t
let's	l ˈɛ t s
lets	l ˈɛ t s
letter	l ˈɛ t ɚ
letters	l ˈɛ t ɚ z
letting	l ˈɛ t t ɪ ŋ
level	l ˈɛ v ə l
levels	l ˈɛ v ə l z
lever	l ˈɛ v ɚ
levers	l ˈɛ v ɚ z
librarian	l a ɪ b ɹ ˈɛ ɹ i ə n
libraries	l ˈa ɪ b ɹ ɪ ɹ i z
library	l ˈa ɪ b ɹ ɛ ɹ i
lick	l ˈɪ k
licking	l ˈɪ k ɪ ŋ
licks	l ˈɪ k s
lid	l ˈɪ d
lids	l ˈɪ d z
lie	l ˈa ɪ
lied	l ˈa ɪ d
lies	l ˈa ɪ z
life	l ˈa ɪ f
lifestyle	l ˈa ɪ f s t ˌa ɪ l
lift	l ˈɪ f t
lifts	l ˈɪ f t s
ligh	l ˈa ɪ t
light	l ˈa ɪ t
lighter	l ˈa ɪ t ɚ
lighthouse	l ˈa ɪ t h ˌa ʊ s
lighthouses	l ˈa ɪ t h ˌa ʊ z ɪ z
lighting	l ˈa ɪ t ɪ ŋ
lightning	l ˈa ɪ t n ɪ ŋ
lights	l ˈa ɪ t s
like	l ˈa ɪ k
liked	l ˈa ɪ k t
likely	l ˈa ɪ k l i
likes	l ˈa ɪ k s
likewise	l ˈa ɪ k w ˌa ɪ z
liking	l ˈa ɪ k ɪ ŋ
lila	l ˈi l ə
lili	l ˈɪ l i
lilly	l ˈɪ l i
lily	l ˈɪ l i
limb	l ˈɪ m
limbs	l ˈɪ m z
lime	l ˈa ɪ m
limit	l ˈɪ m ɪ t
line	l ˈa ɪ n
lined	l ˈa ɪ n d
lines	l ˈa ɪ n z
link	l ˈɪ ŋ k
linked	l ˈɪ ŋ k t
links	l ˈɪ ŋ k s
lion	l ˈa ɪ ə n
lionfish	l ˈa ɪ ə n f ɪ ʃ
lions	l ˈa ɪ ə n z
lip	l ˈɪ p
lips	l ˈɪ p s
lipstick	l ˈɪ p s t ˌɪ k
liqueur	l ɪ k ˈɚ
liquid	l ˈɪ k w ɪ d
lisa	l ˈi s ə
lisa's	l ˈi s ə z
list	l ˈɪ s t
listen	l ˈɪ s ə n
listened	l ˈɪ s ə n d
listening	l ˈɪ s n ɪ ŋ
listens	l ˈɪ s ə n z
lit	l ˈɪ t
liters	l ˈi t ɚ z
litres	l ˈi t ɚ z
litter	l ˈɪ t ɚ
litterbug	l ˈɪ t t ɚ b ə ɡ
litterbugs	l ˈɪ t t ɚ b ə ɡ z
littered	l ˈɪ t ɚ d
little	l ˈɪ t ə l
live	l ˈa ɪ v
live	l ɪ v
lived	l ˈɪ v d
lively	l ˈa ɪ v l ˈi
lives	l ˈɪ v z
lives	l ˈa ɪ v z
livestock	l ˈa ɪ v s t ˌɑ k
living	l ˈɪ v ɪ ŋ
liz	l ˈɪ z
lizard	l ˈɪ z ɚ d
lizards	l ˈɪ z ɚ d z
llama	l ˈɑ m ə
llama's	l ˈɑ m ə z
llamas	l ˈɑ m ə z
load	l ˈo ʊ d
loaded	l ˈo ʊ d ɪ d
loads	l ˈo ʊ d z
loaf	l ˈo ʊ f
loath	l ˈo ʊ θ
local	l ˈo ʊ k ə l
locate	l ˈo ʊ k ˌe ɪ t
location	l o ʊ k ˈe ɪ ʃ ə n
locations	l ˈo ʊ k ˈe ɪ ʃ ə n z
lock	l ˈɑ k
locked	l ˈɑ k t
locks	l ˈɑ k s
lodge	l ˈɑ d͡ʒ
lodged	l ˈɑ d͡ʒ d
log	l ˈɔ ɡ
loggerhead	l ˈɑ ɡ ɚ h ˌɛ d
logs	l ˈɔ ɡ z
lollies	l ˈɔ l i z
lollipop	l ˈɑ l i p ˌɑ p
lolly	l ˈɑ l l i
london	l ˈʌ n d ə n
lone	l ˈo ʊ n
lonely	l ˈo ʊ n l i
long	l ˈɔ ŋ
long-abandoned	l ˈɔ ŋ ə b ˈæ n d ə n d
long-term	l ˈɔ ŋ t ˈɚ m
longer	l ˈɔ ŋ ɡ ɚ
longest	l ˈɔ ŋ ɡ ɪ s t
longs	l ˈɔ ŋ z
loo	l ˈu
look	l ˈʊ k
lookbook	l ˈʊ k b ˌʊ k
looked	l ˈʊ k t
looking	l ˈʊ k ɪ ŋ
lookout	l ˈʊ k ˌa ʊ t
looks	l ˈʊ k s
loom	l ˈu m
loop	l ˈu p
looped	l ˈu p t
loops	l ˈu p s
loose	l ˈu s
loosen	l ˈu s ə n
loot	l ˈu t
looting	l ˈu t ɪ ŋ
lose	l ˈu z
loses	l ˈu z ɪ z
losing	l ˈu z ɪ ŋ
loss	l ˈɔ s
lost	l ˈɔ s t
lot	l ˈɑ t
lotl	l ɑ t l
lots	l ˈɑ t s
lotus	l ˈo ʊ t ə s
loud	l ˈa ʊ d
louder	l ˈa ʊ d ɚ
louding	l ˈa ʊ d ɪ ŋ
loudly	l ˈa ʊ d l i
louise	l u i z
love	l ˈʌ v
loved	l ˈʌ v d
lovely	l ˈʌ v l i
lover	l ˈʌ v ɚ
lovers	l ˈʌ v ɚ z
loves	l ˈʌ v z
low	l ˈo ʊ
lower	l ˈo ʊ ɚ
lowered	l ˈo ʊ ɚ d
lowest	l ˈo ʊ w ɪ s t
lowing	l ə ʊ ɪ ŋ
lowland	l ˈo ʊ l ˈæ n d
loyal	l ˈɔ ɪ ə l
luck	l ˈʌ k
luckily	l ˈʌ k ɪ l i
lucky	l ˈʌ k i
lucy	l ˈu s i
lug	l ˈʌ ɡ
lugged	l ˈʌ ɡ ɪ d
lukewarm	l ˈu k w ˈɔ ɹ m
lumbering	l ˈʌ m b ɚ ɹ ɪ ŋ
luminous	l ˈu m ə n ə s
lump	l ˈʌ m p
lumps	l ˈʌ m p s
lumpy	l ˈʌ m p i
lunacy	l ˈu n ə s i
lunch	l ˈʌ n t͡ʃ
lung	l ˈʌ ŋ
lungs	l ˈʌ ŋ z
lurched	l ˈɚ t͡ʃ d
lurching	l ˈɚ t͡ʃ ɪ ŋ
lure	l ʊ ɹ
lurk	l ˈɚ k
lurks	l ˈɚ k s
lush	l ˈʌ ʃ
lutungs	l ˈu t ˈʌ ŋ z
lying	l ˈa ɪ ɪ ŋ
lyn	l ˈɪ n
lyre	l ˈa ɪ ɹ
lyrebird	l ˈa ɪ ɚ b ˈɚ d
m	ˈɛ m
ma	m ˈɑ
ma's	m ˈɑ z
macaques	m ə k ˈæ k s
machine	m ə ʃ ˈi n
machines	m ə ʃ ˈi n z
mad	m ˈæ d
madagascar	m ˌæ d ə ɡ ˈæ s k ɚ
made	m ˈe ɪ d
madly	m ˈæ d l i
madness	m ˈæ d n ə s
mage	m ˈe ɪ d͡ʒ
mage's	m e ɪ d͡ʒ ə z
mages	m ˈe ɪ d͡ʒ ɪ z
magic	m ˈæ d͡ʒ ɪ k
magical	m ˈæ d͡ʒ ɪ k ə l
magician	m ə d͡ʒ ˈɪ ʃ ə n
magician's	m ə d͡ʒ ˈɪ ʃ ə n z
magnet	m ˈæ ɡ n ɪ t
magnets	m ˈæ ɡ n ə t s
magnificent	m æ ɡ n ˈɪ f ɪ s ə n t
magpie	m ˈæ ɡ p ˌa ɪ
mahakam	m ə h ˈɑ k ˈɑ m
maiden	m ˈe ɪ d ə n
maidens	m ˈe ɪ d ə n z
mail	m ˈe ɪ l
main	m ˈe ɪ n
mainland	m ˈe ɪ n l ˌæ n d
mainly	m ˈe ɪ n l i
mains	m ˈe ɪ n z
majestic	m ə d͡ʒ ˈɛ s t ɪ k
majesty	m ˈæ d͡ʒ ɪ s t i
major	m ˈe ɪ d͡ʒ ɚ
mak	m ˈæ k
make	m ˈe ɪ k
makes	m ˈe ɪ k s
makeshift	m ˈe ɪ k ʃ ˌɪ f t
makeup	m ˈe ɪ k ˌʌ p
making	m ˈe ɪ k ɪ ŋ
malayan	m ə l ˈe ɪ ə n
male	m ˈe ɪ l
males	m ˈe ɪ l z
malicious	m ə l ˈɪ ʃ ə s
mama	m ˈɑ m ə
mammal	m ˈæ m ə l
mammals	m ˈæ m ə l z
mammoth	m ˈæ m ə θ
man	m ˈæ n
man's	m ˈæ n z
man-made	m ˈæ n m ˈe ɪ d
manage	m ˈæ n ɪ d͡ʒ
managed	m ˈæ n ɪ d͡ʒ d
manages	m æ n ɪ d͡ʒ ɪ z
mane	m ˈe ɪ n
manes	m ˈe ɪ n z
mango	m ˈæ ŋ ɡ o ʊ
mangoes	m ˈæ ŋ ɡ o ʊ z
manipulate	m ə n ˈɪ p j ə l ˌe ɪ t
manners	m ˌæ n ə z
mans	m ˈæ n z
mansion	m ˈæ n ʃ ə n
manta	m ˈæ n t ə
manticore	m ˈæ n t ɪ k ˌɔ ɹ
mantle	m ˈæ n t ə l
many	m ˈɛ n i
map	m ˈæ p
maps	m ˈæ p s
mar	m ˈɑ ɹ
marble	m ˈɑ ɹ b ə l
marbles	m ˈɑ ɹ b ə l z
march	m ˈɑ ɹ t͡ʃ
marched	m ˈɑ ɹ t͡ʃ t
marches	m ˈɑ ɹ t͡ʃ ɪ z
margarine	m ˈɑ ɹ d͡ʒ ɚ ˈi n
mark	m ˈɑ ɹ k
marked	m ˈɑ ɹ k t
marker	m ˈɑ ɹ k ɚ
market	m ˈɑ ɹ k ɪ t
markets	m ˈɑ ɹ k ɪ t s
marks	m ˈɑ ɹ k s
mars	m ˈɑ ɹ z
marsh	m ˈɑ ɹ ʃ
marshes	m ˈɑ ɹ ʃ ɪ z
marvellous	m ˈɑ ɹ v ə l ə s
marvelous	m ˈɑ ɹ v ə l ə s
mas	m ˈɑ z
mask	m ˈæ s k
mason	m ˈe ɪ s ə n
mass	m ˈæ s
massive	m ˈæ s ɪ v
master	m ˈæ s t ɚ
masters	m ˈæ s t ɚ z
mat	m ˈæ t
match	m ˈæ t͡ʃ
matches	m ˈæ t͡ʃ ɪ z
mate	m ˈe ɪ t
material	m ə t ˈɪ ɹ i ə l
materials	m ə t ˈɪ ɹ i ə l z
mates	m e ɪ t s
math	m ˈæ θ
maths	m ˈæ θ s
mats	m ˈæ t s
matt	m ˈæ t
matter	m ˈæ t ɚ
matters	m ˈæ t ɚ z
mature	m ə t͡ʃ ˈʊ ɹ
maximum	m ˈæ k s ə m ə m
may	m ˈe ɪ
maybe	m ˈe ɪ b i
me	m ˈi
meager	m ˈi ɡ ɚ
meagre	m ˈi ɡ ɹ i
meal	m ˈi l
meals	m ˈi l z
mean	m ˈi n
meanest	m ˈi n ə s t
meaning	m ˈi n ɪ ŋ
means	m ˈi n z
meant	m ˈɛ n t
meantime	m ˈi n t ˌa ɪ m
meanwhile	m ˈi n w a ɪ l
measure	m ˈɛ ʒ ɚ
meat	m ˈi t
mechanic	m ɪ k ˈæ n ɪ k
mechanics	m ɪ k ˈæ n ɪ k s
medal	m ˈɛ d ə l
medals	m ˈɛ d ə l z
meddle	m ˈɛ d ə l
meddle	m ɛ d ɪ l
media	m ˈi d i ə
mediaeval	m ˈɛ d i ˌ e ɪ v ə l
mediaeval	m ɪ d ˈi v ə l
medical	m ˈɛ d ɪ k ə l
medicine	m ˈɛ d ɪ s ə n
medicines	m ˈɛ d ɪ s ə n z
medieval	m ɛ d i ˈi v ə l
medium	m ˈi d i ə m
mediums	m ˈi d i ə m z
meet	m ˈi t
meeting	m ˈi t ɪ ŋ
meetings	m ˈi t ɪ ŋ z
meets	m ˈi t s
meg	m ˈɛ ɡ
meg's	m ˈɛ ɡ z
mei	m ˈe ɪ
mel	m ˈɛ l
mel's	m ˈɛ l z
melody	m ˈɛ l ə d i
melon	m ˈɛ l ə n
melt	m ˈɛ l t
melted	m ɛ l t ə d
melts	m ɛ l t z
member	m ˈɛ m b ɚ
members	m ˈɛ m b ɚ z
memories	m ˈɛ m m ɚ ɹ i z
memory	m ˈɛ m ɚ ɹ i
men	m ˈɛ n
menacing	m ˈɛ n ə s ɪ ŋ
mend	m ˈɛ n d
mending	m ˈɛ n d ɪ ŋ
mends	m ˈɛ n d z
mental	m ˈɛ n t ə l
mention	m ɛ n ʃ n
menu	m ˈɛ n j u
meow	m i ˈa ʊ
meow's	m i ˈa ʊ z
meows	m ˈo ʊ z
mer	m ˈɛ ɹ
mercury	m ˈɚ k j ɚ ɹ i
mercy	m ˈɚ s i
mermaid	m ˈɚ m ˌe ɪ d
merry	m ˈɛ ɹ i
mess	m ˈɛ s
message	m ˈɛ s ɪ d͡ʒ
messages	m ˈɛ s ɪ d͡ʒ ɪ z
messed	m ˈɛ s t
messes	m ˈɛ s ɪ z
messy	m ˈɛ s ˈi
met	m ˈɛ t
metal	m ˈɛ t ə l
metallic	m ɪ t ˈæ l ɪ k
meter	m ˈi t ɚ
meters	m ˈi t ɚ z
method	m ˈɛ θ ə d
metre	m ˈi t ɹ
metres	m ˈi t ɹ z
mew	m j ˈu
mice	m ˈa ɪ s
michael	m ˈa ɪ k ə l
microbe	m ˈa ɪ k ɹ ˌo ʊ b
microbes	m ˈa ɪ k ɹ ˌo ʊ b z
microgravity	m ˈɪ k ɹ ə ɡ ɹ ˈæ v ɪ t i
microphone	m ˈa ɪ k ɹ o ʊ f ˌo ʊ n
microscope	m ˈa ɪ k ɹ o ʊ s k ˌo ʊ p
microscopes	m ˈa ɪ k ɹ o ʊ s k ˌo ʊ p s
mid	m ˈɪ d
mid-air	m ˈɪ d ˈɛ ɹ
midday	m ˈɪ d d ˌe ɪ
middle	m ˈɪ d ə l
midget	m ˈɪ d͡ʒ ə t
midnight	m ˈɪ d n ˌa ɪ t
mids	m ˈɪ d z
midsummer	m ˈɪ d s ˈʌ m ɚ
midway	m ˈɪ d w ˌe ɪ
midyear	m ˈɪ d j ˌɪ ɹ
might	m ˈa ɪ t
mighty	m ˈa ɪ t i
migration	m a ɪ ɡ ɹ ˈe ɪ ʃ ə n
mild	m ˈa ɪ l d
mile	m ˈa ɪ l
miles	m ˈa ɪ l z
milk	m ˈɪ l k
milked	m ˈɪ l k t
milking	m ɪ l k ɪ ŋ
milky	m ˈɪ l k i
mill	m ˈɪ l
millimeter	m ˈɪ l ɪ m ˌi t ɚ
millimeters	m ˈɪ l ɪ m ˌi t ɚ z
millimetres	m ˈɪ l ɪ m ˌi t ɚ z
milling	m ˈɪ l ɪ ŋ
million	m ˈɪ l j ə n
millions	m ˈɪ l j ə n z
mimic	m ˈɪ m ɪ k
min	m ˈɪ n
mind	m ˈa ɪ n d
mindless	m ˈa ɪ n d l ə s
minds	m ˈa ɪ n d z
mine	m ˈa ɪ n
minecart	m ˌa ɪ n k ɑ ɹ t
minecraft	m ˈa ɪ n k ɹ ˌæ f t
mined	m ˌa ɪ n d
miner	m ˈa ɪ n ˈɚ
mines	m ˈa ɪ n z
minimum	m ˈɪ n ə m ə m
mining	m ˈa ɪ n ɪ ŋ
mins	m ˈɪ n z
minus	m ˈa ɪ n ə s
minute	m ˈɪ n ɪ t
minutes	m ˈɪ n ə t s
minx	m ɪ ŋ k s
mirror	m ˈɪ ɹ ɚ
mischief	m ˈɪ s t͡ʃ ə f
mischievous	m ɪ s t͡ʃ ə f ə s
misconduct	m ɪ s k ˈɑ n d ʌ k t
misconduct	m ɪ s k ə n d ˈʌ k t
misdeed	m ˈɪ s d ˈi d
misdeeds	m ɪ s d ˈi d z
misfit	m ˈɪ s f ˌɪ t
misgiving	m ɪ s ɡ ˈɪ v ɪ ŋ
misgivings	m ɪ s ɡ ˈɪ v ɪ ŋ z
mishap	m ˈɪ s h ˌæ p
mishaps	m ˈɪ s h ˌæ p s
misheard	m ˌɪ s h ˈɚ d
miss	m ˈɪ s
missed	m ˈɪ s t
misses	m ˈɪ s ɪ z
missig	m ˈɪ s ɪ ŋ
missiles	m ɪ s a ɪ l z
missing	m ˈɪ s ɪ ŋ
mission	m ˈɪ ʃ ə n
missus	m ˈɪ s s ɪ z
mistake	m ɪ s t ˈe ɪ k
mistakes	m ɪ s t ˈe ɪ k s
mistaking	m ɪ s t ˈe ɪ k ɪ ŋ
mister	m ˈɪ s t ɚ
mistook	m ɪ s t ˈʊ k
mistreated	m ɪ s t ɹ ˈi t ə d
mite	m ˈa ɪ t
mites	m ˈa ɪ t s
mix	m ˈɪ k s
mixed	m ˈɪ k s t
mixes	m ˈɪ k s ɪ z
mixing	m ˈɪ k s ɪ ŋ
mixture	m ˈɪ k s t͡ʃ ɚ
moan	m ˈo ʊ n
moaning	m ˈo ʊ n ɪ ŋ
moat	m ˈo ʊ t
mob	m ˈɑ b
mobs	m ˈɑ b z
mode	m ˈo ʊ d
model	m ˈɑ d ə l
models	m ˈɑ d ə l z
moderate	m ˈɑ d ɚ ɹ ɪ t
moderate	m ˈɑ d ɚ ɹ ˌe ɪ t
moderates	m ˈɑ d ɚ ɹ ˌe ɪ t s
moderates	m ˈɑ d ɚ ɹ ɪ t s
modern	m ˈɑ d ɚ n
moist	m ˈɔ ɪ s t
mold	m ˈo ʊ l d
moldy	m ˈo ʊ l d i
mole	m ˈo ʊ l
molecule	m ˈɑ l ə k j ˌu l
molecules	m ˈɑ l ə k j ˌu l z
molt	m ˈo ʊ l t
molts	m ˈɔ l t s
mom	m ˈɑ m
mom's	m ˈɑ m z
moment	m ˈo ʊ m ə n t
moment's	m ˈo ʊ m ə n t s
moments	m ˈo ʊ m ə n t s
mommy	m ˈɑ m i
monacle	m ˈɑ n ə k ə l
money	m ˈʌ n i
mongoose	m ˈɑ ŋ ɡ u s
monitor	m ˈɑ n ə t ɚ
monkey	m ˈʌ ŋ k i
monkey's	m ˈʌ ŋ k i z
monkeys	m ˈʌ ŋ k i z
monocle	m ˈɑ n ə k ə l
monoculture	m ˈɑ n n ə k ˌʌ l t͡ʃ ɚ
monotone	m ˈɑ n o ʊ t ˌo ʊ n
monster	m ˈɑ n s t ɚ
monsters	m ˈɑ n s t ɚ z
monstrous	m ˈɑ n s t ɹ ə s
month	m ˈʌ n θ
months	m ˈʌ n θ s
moo	m ˈu
mood	m ˈu d
moon	m ˈu n
moons	m ˈu n z
mooooooooo	m ˈu ˌu ˌu ˌu
moored	m ˈʊ ɹ d
mooshroom	m ˈu ʃ ɹ ˈu m
mooshrooms	m u ʃ ɹ ˌu m z
mop	m ˈɑ p
mope	m ˈo ʊ p
mopes	m ˈo ʊ p z
moral	m ˈɔ ɹ ə l
morals	m ˈɔ ɹ ə l z
more	m ˈɔ ɹ
mores	m ˈɔ ɹ ˌe ɪ z
morning	m ˈɔ ɹ n ɪ ŋ
mornings	m ˈɔ ɹ n ɪ ŋ z
morph	m ˈɔ ɹ f
morsels	m ɔ ɹ s ə l z
mosquito	m ə s k ˈi t o ʊ
mosquitoes	m ə s k ˈi t o ʊ z
mosquitos	m ə s k ˈi t o ʊ z
moss	m ˈɔ s
most	m ˈo ʊ s t
mostly	m ˈo ʊ s t l i
moth	m ˈɔ θ
mother	m ˈʌ ð ɚ
mother's	m ˈʌ ð ɚ z
moths	m ˈɔ θ s
motion	m ˈo ʊ ʃ ə n
motioning	m ˈo ʊ ʃ ə n ɪ ŋ
motor	m ˈo ʊ t ɚ
mould	m ˈo ʊ l d
mouldy	m ˈo ʊ l d i
mound	m ˈa ʊ n d
mounds	m ˈa ʊ n d z
mountain	m ˈa ʊ n t ə n
mountains	m ˈa ʊ n t ə n z
mouse	m ˈa ʊ s
mouth	m ˈa ʊ θ
mouth	m ˈa ʊ ð
mouthfuls	m a ʊ θ f ʊ l z
mouths	m ˈa ʊ ð z
move	m ˈu v
moved	m ˈu v d
movement	m ˈu v m ə n t
movements	m ˈu v m ə n t s
moves	m ˈu v z
movie	m ˈu v i
movies	m ˈu v i z
moving	m ˈu v ɪ ŋ
mower	m ˈo ʊ ɚ
mowing	m ˈa ʊ ɪ ŋ
mr	m ˈɪ s t ɚ
mrs	m ˈɪ s ɪ z
much	m ˈʌ t͡ʃ
muck	m ˈʌ k
mucus	m j ˈu k ə s
mucus-laden	m j ˈu k ə s l ˈe ɪ d ə n
mud	m ˈʌ d
muddled	m ˈʌ d ə l d
muddy	m ˈʌ d i
mug	m ˈʌ ɡ
muggy	m ˈʌ ɡ i
mule	m j ˈu l
multi	m ˈʌ l t i
multi-coloured	m ˈʌ l t i k ˈʌ l ɚ d
multiple	m ˈʌ l t ɪ p ə l
mum	m ˈʌ m
mum's	m ˈʌ m z
mummy	m ˈʌ m i
mums	m ˈʌ m z
munch	m ˈʌ n t͡ʃ
munched	m ˈʌ n t͡ʃ t
munches	m ˈʌ n t͡ʃ ɪ z
munching	m ˈʌ n t͡ʃ ɪ ŋ
muscle	m ˈʌ s ə l
muscles	m ˈʌ s ə l z
muscular	m ˈʌ s k j ə l ɚ
muse	m j ˈu z
museum	m j u z ˈi ə m
mushroom	m ˈʌ ʃ ɹ u m
mushrooms	m ˈʌ ʃ ɹ u m z
music	m j ˈu z ɪ k
musician	m j u z ˈɪ ʃ ə n
must	m ˈʌ s t
musty	m ˈʌ s t i
muttered	m ˈʌ t ɚ d
mutters	m ʌ t ə z
mutton	m ʌ t ə n
my	m ˈa ɪ
myanmar	m ˈi ə n m ˈɑ ɹ
myself	m a ɪ s ˈɛ l f
mysterious	m ɪ s t ˈɪ ɹ i ə s
mystery	m ˈɪ s t ɚ ɹ i
myth	m ˈɪ θ
mythology	m ɪ θ ˈɑ l ə d͡ʒ i
myths	m ˈɪ θ s
n	ˈɛ n
n-g	ˈɛ n d͡ʒ ˈi
n-k	ˈɛ n k ˈe ɪ
nab	n ˈæ b
nabbed	n ˈæ b d
nabs	n ˈæ b z
nag	n ˈæ ɡ
nah	n ˈɑ
nail	n ˈe ɪ l
nails	n ˈe ɪ l z
naive	n ˌa ɪ ˈi v
nakita	n ˈæ k ɪ t ə
name	n ˈe ɪ m
named	n ˈe ɪ m d
names	n ˈe ɪ m z
nan	n ˈæ n
nap	n ˈæ p
naps	n ˈæ p s
narrow	n ˈɛ ɹ o ʊ
narrowed	n ˈɛ ɹ o ʊ d
narwhal	n ˈɑ ɹ w ə l
narwhals	n ˈɑ ɹ w ə l z
nastiest	n ˈæ s t i ɪ s t
nasty	n ˈæ s t i
national	n æ ʃ ə n l
nations	n ˈe ɪ ʃ ə n z
native	n ˈe ɪ t ɪ v
natural	n ˈæ t͡ʃ ɚ ə l
nature	n ˈe ɪ t͡ʃ ɚ
naught	n ˈɔ t
naughty	n ˈɔ t i
nausea	n ˈɔ z i ə
nauseous	n ˈɔ ʃ ə s
navigate	n ˈæ v ə ɡ ˌe ɪ t
navigating	n ˈæ v ə ɡ ˌe ɪ t ɪ ŋ
nay	n ˈe ɪ
near	n ˈɪ ɹ
nearby	n ˈɪ ɹ b ˈa ɪ
nearest	n ˈɪ ɹ ɪ s t
nearly	n ˈɪ ɹ l i
neat	n ˈi t
neatly	n ˈi t l ˈi
neck	n ˈɛ k
necks	n ˈɛ k s
necktie	n ˈɛ k t ˌa ɪ
nectar	n ˈɛ k t ɚ
ned	n ɛ d
ned's	n ɛ d z
need	n ˈi d
needed	n ˈi d ɪ d
needing	n ˈi d ɪ ŋ
needles	n ˈi d l z
needless	n ˈi d l ə s
needs	n ˈi d z
neglected	n ɪ ɡ l ˈɛ k t ɪ d
neigh	n ˈe ɪ
neighbor	n ˈe ɪ b ɚ
neighborhood	n ˈe ɪ b ɚ h ˌʊ d
neighboring	n ˈe ɪ b ɚ ɪ ŋ
neighbors	n ˈe ɪ b ɚ z
neighbour	n ˈe ɪ b ɚ
neighbourhood	n ˈe ɪ b ɚ h ˌʊ d
neighbouring	n e ɪ b ɚ i ŋ
neighbours	n ˈe ɪ b ɚ z
neither	n ˈi ð ɚ
neon	n ˈi ɑ n
nepal	n ɪ p ˈɔ l
neptune	n ˈɛ p t u n
nervous	n ˈɚ v ə s
nervously	n ˈɚ v ə s l i
nervy	n ˈɚ v i
nest	n ˈɛ s t
nesting	n ˈɛ s t ɪ ŋ
nests	n ˈɛ s t s
net	n ˈɛ t
nether	n ˈɛ ð ɚ
netherite	n ˈɛ ð ɚ ˌa ɪ t
nets	n ˈɛ t s
never	n ˈɛ v ɚ
new	n j ˈu
news	n j ˈu z
newspaper	n ˈu z p ˌe ɪ p ɚ
newspapers	n ˈu z p ˌe ɪ p ɚ z
newt	n ˈu t
next	n ˈɛ k s t
nib	n ˈɪ b
nib's	n ˈɪ b z
nibble	n ˈɪ b ə l
nibbling	n ˈɪ b l ɪ ŋ
nice	n ˈa ɪ s
nicely	n ˈa ɪ s l i
nicked	n ˈɪ k t
nicks	n i k s
nidhogg	n ˈɪ d h ˌɔ ɡ
night	n ˈa ɪ t
night's	n ˈa ɪ t s
nightfall	n ˈa ɪ t f ˌɔ l
nightly	n ˈa ɪ t l i
nightmare	n ˈa ɪ t m ˌɛ ɹ
nights	n ˈa ɪ t s
nighttime	n ˈa ɪ t t ˌa ɪ m
nimbly	n ˈɪ m b l i
nine	n ˈa ɪ n
nineteen	n ˈa ɪ n t ˈi n
nineties	n ˈa ɪ n t i z
ninety	n ˈa ɪ n t i
nip	n ˈɪ p
nip's	n ˈɪ p s
nips	n ˈɪ p s
nit	n i t
nitwit	n ˈɪ t w ɪ t
nng	n ŋ ɡ
nnk	n ŋ k
nnn	n n
no	n ˈo ʊ
noble	n ˈo ʊ b ə l
nobody	n ˈo ʊ b ˌɑ d i
nod	n ˈɑ d
nodded	n ˈɑ d d ɪ d
nodding	n ˈɑ d d ɪ ŋ
nods	n ˈɑ d z
noise	n ˈɔ ɪ z
noises	n ˈɔ ɪ z ɪ z
noisy	n ˈɔ ɪ z i
non	n ˈɑ n
non-fiction	n ˈɑ n f ˈɪ k ʃ ə n
none	n ˈʌ n
nones	n ˈo ʊ n z
nonhuman	n ɑ n h j ˈu m ə n
nonsense	n ˈɑ n s ɛ n s
nonstop	n ˌɑ n s t ˈɑ p
noodle	n ˈu d ə l
noodles	n ˈu d ə l z
nook	n ˈʊ k
noon	n ˈu n
nope	n ˈo ʊ p
nor	n ˈɔ ɹ
normal	n ˈɔ ɹ m ə l
norse	n ˈɔ ɹ s
nose	n ˈo ʊ z
noses	n ˈo ʊ z ɪ z
nostril	n ˈɑ s t ɹ ɪ l
nostrils	n ˈɑ s t ɹ ə l z
not	n ˈɑ t
note	n ˈo ʊ t
notepad	n ˈo ʊ t p ˌæ d
notes	n o ʊ t s
nothing	n ˈʌ θ ɪ ŋ
notice	n ˈo ʊ t ɪ s
noticed	n ˈo ʊ t ɪ s t
notices	n ˈo ʊ t ˈɪ s ə z
noun	n ˈa ʊ n
novel	n ˈɑ v ə l
novels	n ˈɑ v ə l z
november	n o ʊ v ˈɛ m b ɚ
now	n ˈa ʊ
nowhere	n ˈo ʊ w ˌɛ ɹ
nowheres	n ˈɔ f ɚ z
noxious	n ˈɑ k ʃ ə s
ntil	ʌ n t ˈɪ l
nudge	n ˈʌ d͡ʒ
nudged	n ˈʌ d͡ʒ d
number	n ˈʌ m b ɚ
numbers	n ʌ m b ɚ z
nurse	n ˈɚ s
nut	n ˈʌ t
nutrient	n ˈu t ɹ i ə n t
nutrients	n ˈu t ɹ i ə n t s
nuts	n ˈʌ t s
nymph	n ˈɪ m f
o	ˈo ʊ
o'clock	o ʊ k l ˈɑ k
o-a	ˈo ʊ ˈe ɪ
o-i	ˈo ʊ ˈa ɪ
o-o	ˈo ʊ ˈo ʊ
o-u	ˈo ʊ w j ˈu
o-u-g-h	ˈo ʊ w j ˈu d͡ʒ ˈi ˈe ɪ t͡ʃ
o-w	ˈo ʊ d ˈʌ b ə l j ˌu
o-y	ˈo ʊ w ˈa ɪ
oak	ˈo ʊ k
oath	ˈo ʊ θ
obey	o ʊ b ˈe ɪ
object	ˈɑ b d͡ʒ ɛ k t
object	ə b d͡ʒ ˈɛ k t
objected	ə b d͡ʒ ˈɛ k t ɪ d
objects	ə b d͡ʒ ˈɛ k t s
objects	ˈɑ b d͡ʒ ɛ k t s
obligation	ˌɑ b l ə ɡ ˈe ɪ ʃ ə n
obliged	ə b l ˈa ɪ d͡ʒ d
obnoxiously	ˈɑ b n ˈɑ k s i ˈɔ s l i
observing	ə b z ˈɚ v ɪ ŋ
obsidian	ə b s ˈɪ d i ə n
obtained	ˈɑ b t ˈe ɪ n d
obvious	ˈɑ b v i ə s
occasion	ɔ k ˈe ɪ ʒ ə n
occasions	ɔ k ˈe ɪ ʒ ə n z
occupant	ˈɑ k j ə p ə n t
occupants	ˈɑ k j ə p ə n t s
occupation	ˌɑ k j ə p ˈe ɪ ʃ ə n
occur	ə k ˈɚ
occurred	ə k ˈɚ d
occurs	ə k ˈɚ z
ocean	ˈo ʊ ʃ ə n
oceans	ˈo ʊ ʃ ə n z
ocelot	ɑ s ə l ɑ t
ocelots	ɑ s ə l ɑ t z
octopus	ˈɑ k t ə p ˌʊ s
octopuses	ˈɑ k t ə p ə s ɪ z
odd	ˈɑ d
odds	ˈɑ d z
of	ə v
off	ˈɔ f
offer	ˈɔ f ɚ
offered	ˈɔ f f ɚ d
offering	ˈɔ f ɚ ɹ ɪ ŋ
offers	ˈɔ f ɚ z
office	ˈɔ f ɪ s
often	ˈɔ f t ə n
oftens	ˈɔ f t ə n z
oh	ˈo ʊ
ohh	ˈo ʊ
oi	ˈɔ ɪ
oil	ˈɔ ɪ l
oink	ˈɔ ɪ n k
oinking	ˈɔ ɪ ŋ k ɪ ŋ
ok	ˈo ʊ k ˈe ɪ
okay	ˌo ʊ k ˈe ɪ
old	ˈo ʊ l d
older	ˈo ʊ l d ɚ
oldest	o ʊ l d ɪ s t
omen	ˈo ʊ m ə n
ominous	ˈɑ m ɪ n ə s
omit	o ʊ m ˈɪ t
omnivores	ˈɑ m n ˈɪ v ˈɔ ɹ z
on	ˈɔ n
once	w ˈʌ n s
one	w ˈʌ n
one's	w ˈʌ n z
one-legged	w ˈʌ n l ˈɛ ɡ ɡ d
ones	w ˈʌ n z
onion	ˈʌ n j ə n
only	ˈo ʊ n l i
ons	ˈɑ n z
onslaught	ˈɔ n s l ˌɔ ɹ t
onto	ˈɔ n t u
oo	ˈʊ
ood	w ˈʊ d
oomph	ˈu m f
ooo	ˈu
oops	ˈu p s
open	ˈo ʊ p ə n
opened	ˈo ʊ p ə n d
opening	ˈo ʊ p ə n ɪ ŋ
opens	ˈo ʊ p ə n z
operation	ˌɑ p ɚ ɹ ˈe ɪ ʃ ə n
opinion	ə p ˈɪ n j ə n
opossum	o ʊ p ˈɑ s ə m
opportunity	ˌɑ p ɚ t ˈu n ɪ t i
opposable	ə p p ˈo ʊ z ə b ə l
opposing	ə p ˈo ʊ z ɪ ŋ
opposite	ˈɑ p ə z ɪ t
option	ˈɑ p ʃ ə n
optional	ˈɑ p ʃ ə n ə l
options	ˈɑ p ʃ ə n z
or	ˈɔ ɹ
orange	ˈɔ ɹ ɪ n d͡ʒ
orangutan	ˈɑ ɹ ˈæ ŋ ˈu t ˈæ n
orangutans	ˈɑ ɹ ˈæ ŋ ˈu t ˈæ n z
orb	ˈɔ ɹ b
orbit	ˈɔ ɹ b ɪ t
orbs	ˈɔ ɹ b z
orcas	ˈɔ ɹ k ə z
orchids	ˈɔ ɹ k ɪ d z
order	ˈɔ ɹ d ɚ
orders	ˈɔ ɹ d ɚ z
ore	ˈɔ ɹ
organ	ˈɔ ɹ ɡ ə n
organisations	ˈɑ ɹ ɡ ə n ˈa ɪ z ˈe ɪ ʃ ə n z
organise	ˈɔ ɹ ɡ ə n a ɪ s
organisms	ˈɔ ɹ ɡ ə n ˌɪ z ə m z
organizations	ˈɑ ɹ ɡ ə n ˈa ɪ z ˈe ɪ ʃ ə n z
organize	ˈɔ ɹ ɡ ə n a ɪ z
organs	ˈɔ ɹ ɡ ə n z
originate	ɚ ɹ ˈɪ d͡ʒ ə n ˌe ɪ t
originated	ɚ ɹ ˈɪ d͡ʒ ə n ˌe ɪ t ɪ d
originates	ɚ ɹ ˈɪ d͡ʒ ə n ˌe ɪ t s
ornaments	ˈɔ ɹ n ə m ə n t s
other	ˈʌ ð ɚ
other's	ˈʌ ð ɚ z
others	ˈʌ ð ɚ z
otherwise	ˈʌ ð ɚ w ˌa ɪ z
otter	ˈɑ t ɚ
otters	ˈɑ t ɚ z
ouch	ˈa ʊ t͡ʃ
ought	ˈɔ t
ounces	ˈa ʊ n s ɪ z
our	ˈa ʊ ɚ
ours	ˈa ʊ ɚ z
ourself	a ʊ ɚ s ˈɛ l f
ourselves	a ʊ ɚ s ɛ l v z
out	ˈa ʊ t
outer	ˈa ʊ t ɚ
outfit	ˈa ʊ t f ˌɪ t
outfits	ˌa ʊ t f i t s
outline	ˈa ʊ t l ˌa ɪ n
outmatched	ˈa ʊ t m ˈæ t͡ʃ t
outraged	ˈa ʊ t ɹ ˌe ɪ d͡ʒ d
outrun	a ʊ t ɹ ˈʌ n
outs	ˈa ʊ t s
outside	a ʊ t s ˈa ɪ d
outsmarted	ˈa ʊ t s m ˌɑ ɹ t ɪ d
outstanding	ˌa ʊ t s t ˈæ n d ɪ ŋ
outstandings	ˈa ʊ t s t ˈæ n d ɪ ŋ z
outweighs	ˈa ʊ t w ˌe ɪ z
oval	ˈo ʊ v ə l
oven	ˈʌ v ə n
over	ˈo ʊ v ɚ
overdrive	ˈo ʊ v ɚ d ɹ ˌa ɪ v
overhanging	ˈo ʊ v ɚ h ˌæ ŋ ɪ ŋ
overhead	ˌo ʊ v ɚ h ˈɛ d
overnight	ˈo ʊ v ɚ n ˈa ɪ t
overturn	ˈo ʊ v ɚ t ˌɚ n
overturns	ˈo ʊ v ɚ t ˌɚ n z
ow	ˈa ʊ
owe	ˈo ʊ
owed	ˈo ʊ d
owl	ˈa ʊ l
owls	ˈa ʊ l z
own	ˈo ʊ n
owner	ˈo ʊ n ɚ
ownership	ˈo ʊ n ɚ ʃ ˌɪ p
owns	ˈo ʊ n z
oww	ˈa ʊ
oxygen	ˈɑ k s s ɪ d͡ʒ ə n
p-h	p ˈi ˈe ɪ t͡ʃ
pa	p ˈɑ
pa's	p ˈɑ z
pace	p ˈe ɪ s
paces	p ˈe ɪ s ə z
pacing	p ˈe ɪ s ɪ ŋ
pack	p ˈæ k
packed	p ˈæ k t
packet	p ˈæ k ɪ t
packets	p ˈæ k ɪ t s
packs	p ˈæ k s
pad	p ˈæ d
padded	p ˈæ d ɪ d
paddock	p ˈæ d ə k
pademelon	p ˈe ɪ d ɪ m ə l ə n
pads	p ˈæ d z
page	p ˈe ɪ d͡ʒ
pages	p ˈe ɪ d͡ʒ ɪ z
paid	p ˈe ɪ d
pail	p ˈe ɪ l
pails	p ˈe ɪ l z
pain	p ˈe ɪ n
pained	p ˈe ɪ n d
paint	p ˈe ɪ n t
paintbrush	p ˈe ɪ n t b ɹ ˌʌ ʃ
painted	p ˈe ɪ n t ɪ d
painter	p ˈe ɪ n t ɚ
painters	p ˈe ɪ n t ɚ z
painting	p ˈe ɪ n t ɪ ŋ
paintings	p ˈe ɪ n t ɪ ŋ z
paints	p ˈe ɪ n t s
pair	p ˈɛ ɹ
pairs	p ˈɛ ɹ z
pal	p ˈæ l
palace	p ˈæ l ɪ s
pale	p ˈe ɪ l
pales	p ˈe ɪ l z
palm	p ˈɑ m
pals	p ˈæ l z
pam	p ˈæ m
pan	p ˈæ n
panda	p ˈæ n d ə
pandas	p ˈæ n d ə z
pang	p ˈæ ŋ
pangolin	p ˈæ ŋ ɡ ˈo ʊ l ə n
pangs	p ˈæ ŋ z
panha	p ˈæ n h ə
panic	p ˈæ n ɪ k
panicked	p ˈæ n ɪ k t
panicking	p ˈæ n ɪ k ɪ ŋ
pans	p ˈæ n z
pant	p ˈæ n t
panthers	p ˈæ n θ ɚ z
panting	p ˈæ n t ɪ ŋ
pants	p ˈæ n t s
paper	p ˈe ɪ p ɚ
papercraft	p ˈe ɪ p ɚ k ɹ ˌæ f t
papers	p ˈe ɪ p ɚ z
papillon	p ˈæ p ˈɪ l l ə n
papua	p ˈæ p ˈu ə
parade	p ɚ ɹ ˈe ɪ d
paradise	p ˈɛ ɹ ə d ˌa ɪ s
parakeet	p ˈɛ ɹ ə k ˌi t
paramedic	p ˌɛ ɹ ə m ˈɛ d ɪ k
paramedics	p ˌɛ ɹ ə m ˈɛ d ɪ k s
parcel	p ˈɑ ɹ s ə l
parcels	p ˈɑ ɹ s ə l z
parchment	p ˈɑ ɹ t͡ʃ m ə n t
parent	p ˈɛ ɹ ə n t
parents	p ˈɛ ɹ ə n t s
park	p ˈɑ ɹ k
parking	p ˈɑ ɹ k ɪ ŋ
parks	p ˈɑ ɹ k s
parrot	p ˈɛ ɹ ə t
parrots	p ˈɛ ɹ ə t s
part	p ˈɑ ɹ t
partheno	p ˈɑ ɹ θ ə n ˈo ʊ
parthenogenesis	p ˈɑ ɹ θ ə n ˈo ʊ d͡ʒ ɛ n ə s ə s
participant	p ɑ ɹ t ˈɪ s ə p ə n t
participants	p ɑ ɹ t ˈɪ s ɪ p ə n t s
particular	p ɚ t ˈɪ k j ə l ɚ
particularly	p ɚ t ˈɪ k j ə l ɚ l i
parts	p ˈɑ ɹ t s
party	p ˈɑ ɹ t i
pas	p ˈɑ z
pass	p ˈæ s
passage	p ˈæ s ɪ d͡ʒ
passed	p ˈæ s t
passes	p ˈæ s ɪ z
passing	p ˈɑ s ˌi ŋ
passion	p ˈæ ʃ ə n
passive	p ˈæ s ɪ v
passport	p ˈæ s p ˌɔ ɹ t
past	p ˈæ s t
paste	p ˈe ɪ s t
pasting	p ˈe ɪ s t ɪ ŋ
pasty	p ˈæ s t i
pat	p ˈæ t
patch	p ˈæ t͡ʃ
patched	p ˈæ t͡ʃ t
patches	p ˈæ t͡ʃ ɪ z
patchy	p ˈæ t͡ʃ i
path	p ˈæ θ
paths	p ˈæ θ s
patient	p ˈe ɪ ʃ ə n t
patiently	p ˈe ɪ ʃ ə n t l i
patients	p ˈe ɪ ʃ ə n t s
patrol	p ə t ɹ ˈo ʊ l
patrolling	p ə t ɹ ˈo ʊ l i ŋ
pats	p ˈæ t s
patted	p ˈæ t ə d
patter	p ˈæ t ɚ
pattern	p ˈæ t ɚ n
patterns	p ˈæ t ɚ n z
paul	p ˈɔ l
paul's	p ˈɔ l z
pauper	p ˈɔ p ɚ
pause	p ˈɔ z
paving	p ˈe ɪ v ɪ ŋ
paw	p ˈɔ
pawpaw	p ˈɔ p ˌɔ
paws	p ˈɔ z
pay	p ˈe ɪ
paying	p ˈe ɪ ɪ ŋ
payment	p ˈe ɪ m ə n t
pays	p ˈe ɪ z
pea	p ˈi
peace	p ˈi s
peaceful	p ˈi s f ə l
peacefully	p ˈi s f ə l i
peacock	p ˈi k ˌɑ k
peacocks	p ˌi k ɑ k s
peafowl	p ˈi f ˌa ʊ l
peahens	p ˈi h ə n z
peak	p ˈi k
pearl	p ˈɚ l
pearls	p ˈɚ l z
peck	p ˈɛ k
pecked	p ˈɛ k t
pecking	p ˈɛ k ɪ ŋ
pecks	p ˈɛ k s
pee	p ˈi
peek	p ˈi k
peeking	p ˈi k ɪ ŋ
peeks	p ˌi k s
peel	p ˈi l
peeling	p ˈi l ɪ ŋ
peep	p ˈi p
peer	p ˈɪ ɹ
peered	p ˈɪ ɹ d
peerless	p ˈɪ ɹ l ə s
peers	p ˈɪ ɹ z
peg	p ˈɛ ɡ
pellet	p ˈɛ l ɪ t
pellets	p ˈɛ l ɪ t s
pelt	p ˈɛ l t
pelting	p ˈɛ l t ɪ ŋ
pelts	p ˈɛ l t s
pen	p ˈɛ n
pencil	p ˈɛ n s ə l
pencils	p ˈɛ n s ə l z
penguins	p ˈɛ ŋ ɡ w ə n z
pens	p ˈɛ n z
people	p ˈi p ə l
people's	p ˈi p ə l z
peoples	p ˈi p ə l z
pep	p ˈɛ p
pep's	p ˌɛ p s
pepper	p ˈɛ p ɚ
per	p ˈɚ
perceived	p ɚ s ˈi v d
perceiving	p ɚ s ˈi v ɪ ŋ
percentage	p ɚ s ˈɛ n t ɪ d͡ʒ
perch	p ˈɚ t͡ʃ
perfect	p ˈɚ f ɛ k t
perfectly	p ˈɚ f ə k t l i
perform	p ɚ f ˈɔ ɹ m
perfume	p ɚ f j ˈu m
perhaps	p ɚ h ˈæ p s
peril	p ˈɛ ɹ ɹ ə l
perk	p ˈɚ k
perks	p ˈɚ k s
permission	p ɚ m ˈɪ ʃ ə n
permissions	p ɚ m ˈɪ ʃ ə n z
persian	p ˈɚ ʒ ə n
persistent	p ɚ s ˈɪ s t ə n t
person	p ˈɚ s ə n
personal	p ˈɚ s ə n ə l
personality	p ˌɚ s ə n ˈæ l ɪ t i
personals	p ˈɚ s ɪ n ɪ l z
persons	p ˈɚ s ə n z
persuasion	p ɚ s w ˈe ɪ ʒ ə n
pesky	p ˈɛ s k i
pest	p ˈɛ s t
pester	p ˈɛ s t ɚ
pests	p ˈɛ s t s
pet	p ˈɛ t
pet's	p ˈɛ t s
petal	p ˈɛ t ə l
petals	p ˈɛ t ə l z
peter's	p ˈi t ɚ z
petri	p ˈɛ t ɹ i
pets	p ˈɛ t s
phantom	f æ n t ə m
phantoms	f æ n t ə m z
phase	f ˈe ɪ z
phases	f ˈe ɪ z ɪ z
pheasant	f ˈɛ z ə n t
pheasant's	f ˈɛ z ə n t s
pheasants	f ɛ z ə n t s
phew	f j ˈu
phobias	f ˈo ʊ b i ə z
phone	f ˈo ʊ n
phonics	f o ʊ n ɪ k s
phony	f ˈo ʊ n i
photo	f ˈo ʊ t o ʊ
photograph	f ˈo ʊ t ə ɡ ɹ ˌæ f
photographs	f ˈo ʊ t ə ɡ ɹ ˌæ f s
photos	f ˈo ʊ t o ʊ z
physical	f ˈɪ z ɪ k ə l
pic	p ˈɪ k
pick	p ˈɪ k
pickaxe	p ˈɪ k ˈæ k s
pickaxes	p ˈɪ k ˈæ k s ɪ z
picked	p ˈɪ k t
picking	p ˈɪ k ɪ ŋ
picks	p ˈɪ k s
picnic	p ˈɪ k n ˌɪ k
picture	p ˈɪ k t͡ʃ ɚ
pictures	p ˈɪ k t͡ʃ ɚ z
pie	p ˈa ɪ
piece	p ˈi s
pieces	p ˈi s ɪ z
pies	p a ɪ z
pig	p ˈɪ ɡ
pigeon	p ˈɪ d͡ʒ ɪ n
pigeons	p ˈɪ d͡ʒ ɪ n z
piggy	p ˈɪ ɡ ɡ i
piggyback	p ˈɪ ɡ i b ˌæ k
piglet	p ˈɪ ɡ l ɪ t
pigment	p ˈɪ ɡ m ə n t
pigs	p ˈɪ ɡ z
pigtail	p ˈɪ ɡ t ˌe ɪ l
pigtail's	p ˈɪ ɡ t ˈe ɪ l z
pigtails	p ˈɪ ɡ t ˌe ɪ l z
pile	p ˈa ɪ l
piles	p ˈa ɪ l z
piling	p ˈa ɪ l ɪ ŋ
pillager	p ˈɪ l ɪ d͡ʒ ɚ
pillager's	p ˈɪ l ɪ d͡ʒ ɚ z
pillagers	p ˈɪ l ɪ d͡ʒ ɚ z
pillow	p ˈɪ l o ʊ
pillows	p ˈɪ l o ʊ z
pilot	p ˈa ɪ l ə t
pin	p ˈɪ n
pinch	p ˈɪ n t͡ʃ
pinches	p ˈɪ n t͡ʃ ə z
pineapple	p ˈa ɪ n ˌæ p ə l
pink	p ˈɪ ŋ k
pinkie	p ˈɪ n k ˈi
pinpoint	p ˈɪ n p ˌɔ ɪ n t
pins	p ˈɪ n z
pip	p ˈɪ p
pip's	p ˈɪ p s
pipe	p ˈa ɪ p
piped	p ˈa ɪ p t
pipes	p ˈa ɪ p s
pistons	p ˈɪ s t ə n s
pit	p ˈɪ t
pitch	p ˈɪ t͡ʃ
pitched	p ɪ t͡ʃ d
pitches	p ˈɪ t͡ʃ ɪ z
pitchfork	p ˈɪ t͡ʃ f ˌɔ ɹ k
pitchforks	p ˈɪ t͡ʃ f ˌɔ ɹ k s
pits	p ˈɪ t s
pixie	p ˈɪ k s i
pixies	p ˈɪ k s i z
pizza	p ˈi t s ə
placate	p l ˈe ɪ k e ɪ t
placates	p l ˈæ k ˌe ɪ t s
place	p l ˈe ɪ s
placed	p l ˈe ɪ s t
places	p l ˈe ɪ s ɪ z
plain	p l ˈe ɪ n
plains	p l ˈe ɪ n z
plan	p l ˈæ n
plane	p l ˈe ɪ n
planes	p l ˈe ɪ n z
planet	p l ˈæ n ə t
planet's	p l ˈæ n ə t s
planets	p l ˈæ n ə t s
plank	p l ˈæ ŋ k
planks	p l ˈæ ŋ k s
planned	p l ˈæ n d
planning	p l ˈæ n ɪ ŋ
plans	p l ˈæ n z
plant	p l ˈæ n t
plant-eating	p l ˈæ n t ˈi t ɪ ŋ
planted	p l ˈæ n t ɪ d
planter	p l ˈæ n t ɚ
planting	p l æ n t ˈɪ ŋ
plants	p l ˈæ n t s
plastic	p l ˈæ s t ɪ k
plastics	p l ˈæ s t ɪ k s
plate	p l ˈe ɪ t
plates	p l ˈe ɪ t s
platform	p l ˈæ t f ˌɔ ɹ m
play	p l ˈe ɪ
played	p l ˈe ɪ d
players	p l ˈe ɪ ɚ z
playful	p l ˈe ɪ f ə l
playground	p l ˈe ɪ ɡ ɹ ˌa ʊ n d
playing	p l ˈe ɪ ɪ ŋ
plays	p l ˈe ɪ z
pleasant	p l ˈɛ z ə n t
please	p l ˈi z
pleased	p l ˈi z d
pleasure	p l ˈɛ ʒ ɚ
plenty	p l ˈɛ n t i
plight	p l ˈa ɪ t
plodded	p l ɑ d ə d
plonk	p l ˈɑ ŋ k
plop	p l ˈɑ p
plops	p l ˈɑ p s
plot	p l ˈɑ t
plots	p l ˈɑ t s
plough	p l ˈa ʊ
ploy	p l ˈɔ ɪ
pluck	p l ˈʌ k
plucked	p l ˈʌ k t
plucking	p l ˈʌ k ɪ ŋ
plucks	p l ˈʌ k s
plug	p l ˈʌ ɡ
plugs	p l ˈʌ ɡ z
plump	p l ˈʌ m p
plumps	p l ˈʌ m p s
plural	p l ˈʊ ɹ ə l
plural	p l ˈʊ ɹ ə l
plurals	p l ˈʊ ɹ ə l z
plus	p l ˈʌ s
pluto	p l ˈu t o ʊ
pluto's	p l ˈu t o ʊ z
pocket	p ˈɑ k ə t
pockets	p ˈɑ k ə t s
pod	p ˈɑ d
podcasts	p ˈɑ d k ˌæ s t s
pods	p ˈɑ d z
point	p ˈɔ ɪ n t
pointed	p ˈɔ ɪ n t ɪ d
pointing	p ˈɔ ɪ n t ɪ ŋ
points	p ˈɔ ɪ n t s
poison	p ˈɔ ɪ z ə n
poisonous	p ˈɔ ɪ z ə n ə s
poke	p ˈo ʊ k
poked	p ˈo ʊ k t
pokey	p ˈo ʊ k ˈi
poking	p ˈo ʊ k ɪ ŋ
polar	p ˈo ʊ l ɚ
police	p ə l ˈi s
policeman	p ə l ˈi s m ə n
polished	p ˈɑ l ɪ ʃ t
politely	p ə l ˈa ɪ t l i
politest	p ə l a ɪ t ɪ s t
pollen	p ˈɑ l ə n
pollinate	p ˈɑ l ə n ˌe ɪ t
pollinating	p ˈɑ l ɪ n ˌe ɪ t ɪ ŋ
polluted	p ə l ˈu t ɪ d
pollution	p ə l ˈu ʃ ə n
pond	p ˈɑ n d
ponds	p ˈɑ n d z
pong	p ˈɔ ŋ
pontificate	p ɑ n t ˈɪ f ɪ k ˌe ɪ t
pontificate	p ɑ n t ˈɪ f ɪ k ɪ t
pontificates	p ɑ n t ˈɪ f ɪ k ˌe ɪ t s
pontificates	p ɑ n t ˈɪ f ɪ k ɪ t s
poo	p ˈu
poodle	p ˈu d ə l
pool	p ˈu l
pools	p ˈu l z
poop	p ˈu p
pooped	p ˈu p t
poops	p ˈu p s
poor	p ˈʊ ɹ
pop	p ˈɑ p
popped	p ˈɑ p t
pops	p ˈɑ p s
popular	p ˈɑ p j ə l ɚ
porch	p ˈɔ ɹ t͡ʃ
porcupine	p ˈɔ ɹ k j ə p ˌa ɪ n
pork	p ˈɔ ɹ k
porkchops	p ˈɔ k t͡ʃ ɑ p s
portal	p ɔ t l
portals	p ˈɔ t ə l z
portion	p ˈɔ ɹ ʃ ə n
portions	p ˈɔ ɹ ʃ ə n z
pose	p ˈo ʊ z
posing	p ˈo ʊ z ɪ ŋ
position	p ə z ˈɪ ʃ ə n
positioned	p ə z ˈɪ ʃ ə n d
positive	p ˈɑ z ɪ t ɪ v
possible	p ˈɑ s ə b ə l
possibly	p ˈɑ s ə b l i
possum	p ˈɑ s ə m
post	p ˈo ʊ s t
poster	p ˈo ʊ s t ɚ
posts	p ˈo ʊ s t s
pot	p ˈɑ t
potato	p ə t ˈe ɪ t o ʊ
potatoes	p ə t ˈe ɪ t o ʊ z
potion	p ˈo ʊ ʃ ə n
potions	p ˌo ʊ ʃ ə n z
pots	p ˈɑ t s
potted	p ˌɑ t ə d
pouch	p ˈa ʊ t͡ʃ
pounds	p ˈa ʊ n d z
pour	p ˈɔ ɹ
poured	p ˈɔ ɹ d
pouring	p ˈɔ ɹ ɪ ŋ
pours	p ɔ ɹ z
pout	p ˈa ʊ t
powder	p a ʊ d ə
power	p ˈa ʊ ɚ
powered	p a ʊ w ə ɹ d
powered	p a ʊ w ə ɹ d
powerful	p ˈa ʊ ɚ f ə l
practice	p ɹ ˈæ k t ɪ s
practiced	p ɹ ˈæ k t ɪ s t
practicing	p ɹ ˈæ k t ɪ s ɪ ŋ
practise	p ɹ ˈæ k t ɪ s
practising	p ɹ ˈæ k t ɪ s ɪ ŋ
praise	p ɹ ˈe ɪ z
praised	p ɹ ˈe ɪ z d
praises	p ɹ ˈe ɪ z ɪ z
prank	p ɹ ˈæ ŋ k
pranks	p ɹ ˈæ ŋ k s
prayers	p ɹ ˈɛ ɹ z
preceded	p ɹ ɪ s ˈi d ɪ d
precious	p ɹ ˈɛ ʃ ə s
precipitation	p ɹ ɪ s ˌɪ p ɪ t ˈe ɪ ʃ ə n
precision	p ɹ i s ˈɪ ʒ ə n
predator	p ɹ ˈɛ d ə t ɚ
predators	p ɹ ˈɛ d ə t ɚ z
predicate	p ɹ ˈɛ d ɪ k ɪ t
predicate	p ɹ ˈɛ d ɪ k ˌe ɪ t
predicates	p ɹ ˈɛ d ɪ k ɪ t s
predicates	p ɹ ˈɛ d ɪ k ˌe ɪ t s
predict	p ɹ ɪ d ˈɪ k t
preen	p ɹ ˈi n
preens	p ɹ ˈi n z
prefer	p ɹ ɪ f ˈɚ
preferred	p ɹ ɪ f ˈɚ d
preferring	p ɹ ə f ɛ ɹ ɪ ŋ
prefixes	p ɹ ˈi f ɪ k s ə z
pregnant	p ɹ ˈɛ ɡ n ə n t
preheat	p ɹ i h ˈi t
preheats	p ɹ ˈi h ˈi t s
premium	p ɹ ˈi m i ə m
premiums	p ɹ ˈi m i ə m z
prepare	p ɹ i p ˈɛ ɹ
prepared	p ɹ i p ˈɛ ɹ d
preparing	p ɚ p ˈɛ ɹ ɪ ŋ
preschool	p ɹ i s k u l
presence	p ɹ ˈɛ z ə n s
present	p ɹ ˈɛ z ə n t
present	p ɹ ɪ z ˈɛ n t
presents	p ɹ ˈɛ z ə n t s
presents	p ɹ ɪ z ˈɛ n t s
presents	p ɹ ɪ z ˈɛ n t s
preserved	p ɹ ɪ z ˈɚ v d
press	p ɹ ˈɛ s
pressure	p ɹ ˈɛ ʃ ɚ
pretend	p ɹ i t ˈɛ n d
pretended	p ɹ i t ˈɛ n d ɪ d
pretty	p ɹ ˈɪ t i
prevent	p ɹ ɪ v ˈɛ n t
prey	p ɹ ˈe ɪ
preys	p ɹ ˈe ɪ z
pricked	p ɹ ˈɪ k t
prickly	p ɹ ˈɪ k l i
pricks	p ɹ ɪ k s
pride	p ɹ ˈa ɪ d
primary	p ɹ ˈa ɪ m ˌɛ ɹ i
primates	p ɹ ˈa ɪ m ˈe ɪ t z
prime	p ɹ ˈa ɪ m
prince	p ɹ ˈɪ n s
princess	p ɹ ˈɪ n s ɛ s
princess's	p ɹ ˈɪ n s ɛ s ɪ z
print	p ɹ ˈɪ n t
prints	p ɹ ˈɪ n t s
prison	p ɹ ˈɪ z ə n
prisoner	p ɹ ˈɪ z ə n ɚ
prisoners	p ɹ ˈɪ z ə n ɚ z
privacy	p ɹ ˈa ɪ v ə s i
prize	p ɹ ˈa ɪ z
prized	p ɹ ˈa ɪ z d
prizes	p ɹ ˈa ɪ z ɪ z
pro	p ɹ ˈo ʊ
probably	p ɹ ˈɑ b ə b l i
problem	p ɹ ˈɑ b l ə m
problems	p ɹ ˈɑ b l ə m z
proboscis	p ɹ o ʊ b ˈɑ s ə s
proceed	p ɹ o ʊ s ˈi d z
proceeds	p ɹ o ʊ s ˈi d z
process	p ɹ ˈɑ s ˌɛ s
prod	p ɹ ˈɑ d
produce	p ɹ ˈo ʊ d u s
produce	p ɹ ə d ˈu s
produced	p ɹ ə d ˈu s t
producing	p ɹ ə d ˈu s ɪ ŋ
product	p ɹ ˈɑ d ʌ k t
products	p ɹ ˈɑ d ʌ k t s
profession	p ɹ ə f ˈɛ ʃ ə n
professions	p ɹ ə f ɛ ʃ ə n z
profile	p ɹ ˈo ʊ f ˌa ɪ l
profiles	p ɹ ˈo ʊ f ˌa ɪ l z
program	p ɹ ˈo ʊ ɡ ɹ ˌæ m
programmes	p ɹ ˈɑ ɡ ɹ ˈæ m z
programs	p ɹ ˈo ʊ ɡ ɹ ˌæ m z
progress	p ɹ ˈɑ ɡ ɹ ɛ s
progress	p ɹ ə ɡ ɹ ˈɛ s
progress	p ɹ ə ɡ ɹ ˈɛ s
progresses	p ɹ ˈɑ ɡ ɹ ɛ s ɪ z
progresses	p ɹ ə ɡ ɹ ˈɛ s ɪ z
project	p ɹ ə d͡ʒ ˈɛ k t
project	p ɹ ˈɑ d͡ʒ ɛ k t
project	p ɹ ˈɑ d͡ʒ ɛ k t
projected	p ɹ ə d͡ʒ ˈɛ k t ɪ d
projectiles	p ɹ ˌo ʊ d͡ʒ ɛ k t ˈa ɪ l z
projects	p ɹ ˈɑ d͡ʒ ɛ k t s
projects	p ɹ ə d͡ʒ ˈɛ k t s
promise	p ɹ ˈɑ m ə s
promised	p ɹ ˈɑ m ə s t
promises	p ɹ ˈɑ m ə s ɪ z
promising	p ɹ ˈɑ m ə s ɪ ŋ
promptly	p ɹ ˈɑ m p t l i
proof	p ɹ ˈu f
proofs	p ɹ ˈu f s
prop	p ɹ ˈɑ p
propels	p ɹ ə p ˈɛ l z
proper	p ɹ ˈɑ p ɚ
properly	p ɹ ˈɑ p ɚ l i
property	p ɹ ˈɑ p ɚ t i
props	p ɹ ˈɑ p s
pros	p ɹ ˈo ʊ z
prospect	p ɹ ˈɔ s p ɛ k t
prospect	p ɹ ə s p ˈɛ k t
prospects	p ɹ ˈɔ s p ɛ k t s
prospects	p ɹ ə s p ˈɛ k t s
protect	p ɹ ə t ˈɛ k t
protected	p ɹ ˈo ʊ t ɛ k t ə d
protecting	p ɹ ə t ˈɛ k t ɪ ŋ
protection	p ɹ ə t ˈɛ k ʃ ə n
protects	p ɹ ə t ˈɛ k t s
protest	p ɹ ˈo ʊ t ɛ s t
protest	p ɹ ə t ˈɛ s t
protests	p ɹ ˈo ʊ t ɛ s t s
protests	p ɹ ə t ˈɛ s t s
proud	p ɹ ˈa ʊ d
proudly	p ɹ ˈa ʊ d l i
prove	p ɹ ˈu v
provide	p ɹ ə v ˈa ɪ d
provides	p ɹ ə v ˈa ɪ d z
providing	p ɹ ə v ˈa ɪ d ɪ ŋ
prowled	p ɹ ˈa ʊ l d
pry	p ɹ ˈa ɪ
public	p ˈʌ b l ɪ k
puddle	p ˈʌ d ə l
puddles	p ˈʌ d ə l z
puff	p ˈʌ f
puffed	p ˈʌ f t
pufferfish	p ˈʌ f ɚ f ɪ ʃ
puffs	p ˈʌ f s
puffy	p ˈʌ f i
pug	p ˈʌ ɡ
pugs	p ˈʌ ɡ z
puk	p ˈʌ k
puke	p j ˈu k
puking	p j ˈu k ɪ ŋ
pull	p ˈʊ l
pulled	p ˈʊ l d
pulling	p ˈʊ l ɪ ŋ
pulls	p ˈʊ l z
pump	p ˈʌ m p
pumping	p ˈʌ m p ɪ ŋ
pumpkin	p ˈʌ m p k ɪ n
pumpkins	p ˈʌ m p k ə n z
pumps	p ˈʌ m p s
punch	p ˈʌ n t͡ʃ
punching	p ˈʌ n t͡ʃ ɪ ŋ
punished	p ˈʌ n ɪ ʃ t
punishment	p ˈʌ n ɪ ʃ m ə n t
punt	p ˈʌ n t
puny	p j ˈu n i
pup	p ˈʌ p
pup's	p ˈʌ p s
pupil	p j ˈu p ə l
pupils	p j ˈu p ə l z
puppet	p ˈʌ p ɪ t
puppets	p ˈʌ p ɪ t s
puppy	p ˈʌ p i
puppy's	p ˈʌ p p i z
pups	p ˈʌ p s
purchase	p ˈɚ t͡ʃ ə s
purebred	p j ˈʊ ɹ b ɹ ˈɛ d
purple	p ˈɚ p ə l
purpose	p ˈɚ p ə s
purposes	p ˈɚ p ə s ɪ z
purr	p ˈɚ
pursed	p ˈɚ s t
pursuit	p ɹ s ˈu t
push	p ˈʊ ʃ
pushed	p ˈʊ ʃ t
pushes	p ˈʊ ʃ ɪ z
pushing	p ˈu ʃ ˈɪ ŋ
puss	p ˈʊ s
pussy	p ˈʊ s i
put	p ˈʊ t
puts	p ˈʊ t s
putting	p ˈʊ t ɪ ŋ
puzzled	p ˈʌ z ə l d
pyramid	p ˈɪ ɹ ə m ɪ d
pythons	p ˈa ɪ θ ə n z
quaking	k w ˈe ɪ k ɪ ŋ
qualities	k w ˈɑ l ə t i z
quality	k w ˈɑ l ə t i
quarts	k w ˈɔ ɹ t s
quartz	k w ˈɔ ɹ t s
queasy	k w ˈi z i
queen	k w ˈi n
queen's	k w ˈi n z
queer	k w ˈɪ ɹ
quench	k w ɛ n t͡ʃ
quest	k w ˈɛ s t
question	k w ˈɛ s t͡ʃ ə n
questions	k w ˈɛ s t͡ʃ ə n z
quiche	k ˈi ʃ
quick	k w ˈɪ k
quicker	k w ˈɪ k k ɚ
quickly	k w ˈɪ k l i
quiet	k w ˈa ɪ ə t
quieter	k w ˈa ɪ ə t ˈɚ
quietly	k w ˈa ɪ ə t l i
quietness	k w ˈa ɪ ə t n ə s
quigley	k w ˈɪ ɡ l i
quigley's	k w ˈɪ ɡ l i z
quigleys	k w ˈɪ ɡ l i z
quigleys	k w ˈɪ ɡ l i z
quill	k w ˈɪ l
quills	k w ˈɪ l z
quilt	k w ˈɪ l t
quilts	k w ˈɪ l t s
quirk	k w ˈɚ k
quirks	k w ˈɚ k s
quirky	k w ˈɚ k i
quit	k w ˈɪ t
quite	k w ˈa ɪ t
quits	k w ˈɪ t s
quiz	k w ˈɪ z
rabbit	ɹ ˈæ b ɪ t
rabbits	ɹ ˈæ b ɪ t s
race	ɹ ˈe ɪ s
raced	ɹ ˈe ɪ s t
racer	ɹ ˈe ɪ s ɚ
races	ɹ ˈe ɪ s ɪ z
racing	ɹ ˈe ɪ s ɪ ŋ
racket	ɹ ˈæ k ɪ t
radar	ɹ ˈe ɪ d ˌɑ ɹ
radio	ɹ ˈe ɪ d i o ʊ
raf	ɹ ˈæ f
rafa	ɹ ˈæ f ə
rafa's	ɹ ˈæ f ə z
rafflesia	ɹ æ f l ˈi ʒ ə
raft	ɹ ˈæ f t
rag	ɹ ˈæ ɡ
rage	ɹ ˈe ɪ d͡ʒ
ragged	ɹ ˈæ ɡ d
ragged	ɹ ˈæ ɡ ɪ d
raging	ɹ ˈe ɪ d͡ʒ ɪ ŋ
ragnarok	ɹ ˈæ ɡ n ˈɑ ɹ ə k
ragnaroks	ɹ ˈæ ɡ n ˈɑ ɹ ɹ ɔ k s
rags	ɹ ˈæ ɡ z
raid	ɹ ˈe ɪ d
raided	ɹ ˈe ɪ d ɛ d
rail	ɹ e ɪ l
rails	ɹ ˈe ɪ l z
rain	ɹ ˈe ɪ n
rainbow	ɹ ˈe ɪ n b o ʊ
rainbow-coloured	ɹ ˈe ɪ n b o ʊ k ˈʌ l ɚ d
rainbows	ɹ ˈe ɪ n b o ʊ z
raindrop	ɹ ˈe ɪ n d ɹ ˌɑ p
raindrops	ɹ ˈe ɪ n d ɹ ˌɑ p s
rained	ɹ ˈe ɪ n d
rainforest	ɹ ˈe ɪ n f ˌɔ ɹ ɪ s t
rainforests	ɹ ˈe ɪ n f ˈɑ ɹ ə s t s
raining	ɹ ˈe ɪ n ɪ ŋ
rains	ɹ ˈe ɪ n z
rainy	ɹ ˈe ɪ n i
raise	ɹ ˈe ɪ z
raised	ɹ ˈe ɪ z d
raising	ɹ ˈe ɪ z ɪ ŋ
rake	ɹ ˈe ɪ k
rakes	ɹ ˈe ɪ k s
ramen	ɹ ˈɑ m ə n
ramp	ɹ ˈæ m p
rampage	ɹ ˈæ m p ˌe ɪ d͡ʒ
ran	ɹ ˈæ n
ranch	ɹ ˈæ n t͡ʃ
random	ɹ ˈæ n d ə m
rang	ɹ ˈæ ŋ
range	ɹ ˈe ɪ n d͡ʒ
rank	ɹ ˈæ ŋ k
rare	ɹ ˈɛ ɹ
rarely	ɹ ˈæ ɹ l ˌi
rash	ɹ ˈæ ʃ
rat	ɹ ˈæ t
rate	ɹ ˈe ɪ t
rather	ɹ ˈæ ð ɚ
ration	ɹ ˈæ ʃ ə n
rats	ɹ ˈæ t s
rattle	ɹ ˈæ t ə l
rattles	ɹ ˈæ t ə l z
ravager	ɹ ˈæ v ə ɡ ɚ
ravenous	ɹ æ v ə n ə s
raving	ɹ ˈe ɪ v ɪ ŋ
raw	ɹ ˈɑ
ray	ɹ ˈe ɪ
ray's	ɹ ˈe ɪ z
rays	ɹ ˈe ɪ z
re	ɹ ˈi
re-read	ɹ ˈi ɹ ˈi d
reach	ɹ ˈi t͡ʃ
reached	ɹ ˈi t͡ʃ t
reaches	ɹ ˈi t͡ʃ ɪ z
reaching	ɹ ˈi t͡ʃ ɪ ŋ
react	ɹ i ˈæ k t
reaction	ɹ i æ k ʃ ə n
reactions	ɹ i ˈæ k ʃ ə n z
reacts	ɹ i ˈæ k t s
read	ɹ ˈɛ d
read	ɹ ˈi d
reader	ɹ ˈi d ɚ
readers	ɹ ˈi d ɚ z
readies	ɹ ˈɛ d i z
reading	ɹ ˈi d ɪ ŋ
reads	ɹ ˈi d z
ready	ɹ ˈɛ d i
real	ɹ ˈi ə l
realigned	ɹ i ə l ˈa ɪ n d
realise	ɹ ˈi ə l ˌa ɪ z
realised	ɹ ˈi ə l ˌa ɪ z d
realises	ɹ ˈi ə l ˌa ɪ z ɪ z
reality	ɹ i ˈæ l ə t i
realize	ɹ ˈi ə l ˌa ɪ z
realized	ɹ ˈi ə l ˌa ɪ z d
realizes	ɹ ˈi ə l ˌa ɪ z ə z
really	ɹ ˈɪ l i
reared	ɹ ˈɪ ɹ d
reason	ɹ ˈi z ə n
rebel	ɹ ˈɛ b ə l
rebel	ɹ ˈɛ b ə l
rebel	ɹ ɪ b ˈɛ l
rebels	ɹ ˈɛ b ə l z
rebels	ɹ ɪ b ˈɛ l z
rebuild	ɹ i b ˈɪ l d
recall	ɹ ɪ k ˈɔ l
recall	ɹ ˈi k ˌɔ l
recalls	ɹ ɪ k ˈɔ l z
recalls	ɹ ˈi k ˌɔ l z
receipt	ɹ ɪ s ˈi t
receipts	ɹ ɪ s ˈi t s
receive	ɹ ɪ s ˈi v
received	ɹ ɪ s ˈi v d
receives	ɹ ɪ s ˈi v z
recent	ɹ ˈi s ə n t
recited	ɹ ɪ s ˈa ɪ t ɪ d
reckless	ɹ ˈɛ k l ə s
recognise	ɹ ˈɛ k ə ɡ n ˌa ɪ z
recognised	ɹ ˈɛ k ə ɡ n ˌa ɪ z d
recognises	ɹ ˈɛ k ə ɡ n ˌa ɪ z ɪ z
recognising	ɹ ˈɛ k ə ɡ n ˌa ɪ z ɪ ŋ
recognition	ɹ ˌɛ k ə ɡ n ˈɪ ʃ ə n
recognitions	ɹ ˈɛ k ə ɡ n ˈɪ ʃ ə n z
recognize	ɹ ˈɛ k ə ɡ n ˌa ɪ z
recognized	ɹ ˈɛ k ə ɡ n ˌa ɪ z d
recognizes	ɹ ˈɛ k ə ɡ n ˌa ɪ z ɪ z
recognizing	ɹ ˈɛ k ə ɡ n ˌa ɪ z ɪ ŋ
record	ɹ ɪ k ˈɔ ɹ d
record	ɹ ˈɛ k ɚ d
records	ɹ ˈɛ k ɚ d z
records	ɹ ɪ k ˈɔ ɹ d z
recount	ɹ ˌi k ˈa ʊ n t
recount	ɹ ɪ k ˈa ʊ n t
recounts	ɹ ɪ k ˈa ʊ n t s
recounts	ɹ ˌi k ˈa ʊ n t s
recruit	ɹ ɪ k ɹ ˈu t
recruits	ɹ ɪ k ɹ ˈu t s
rectangle	ɹ ˈɛ k t æ ŋ ɡ ə l
red	ɹ ˈɛ d
reddish	ɹ ˈɛ d ɪ ʃ
redoes	ɹ ˈi d ˈu z
redstone	ɹ ˈɛ d s t ˈo ʊ n
reduce	ɹ ɪ d j u s
reduced	ɹ ɪ d ˈu s t
redy	ɹ ˈɛ d i
reed	ɹ ˈi d
reeds	ɹ ˈi d z
reef	ɹ ˈi f
reefs	ɹ ˈi f s
reek	ɹ ˈi k
reeks	ɹ ˈi k s
reel	ɹ ˈi l
reeled	ɹ ˈi l d
reels	ɹ ˈi l z
referee	ɹ ˌɛ f ɚ ˈi
reference	ɹ ˈɛ f ɚ ɹ ə n s
refine	ɹ ɪ f ˈa ɪ n
reflected	ɹ ɪ f l ˈɛ k t ɪ d
reflection	ɹ ɪ f l ˈɛ k ʃ ə n
refuge	ɹ ˈɛ f j u d͡ʒ
refund	ɹ ˈi f ˌʌ n d
refund	ɹ ɪ f ˈʌ n d
refunds	ɹ ˈi f ˌʌ n d z
refunds	ɹ ɪ f ˈʌ n d z
refuse	ɹ ˈɛ f j ˌu z
refuse	ɹ ɪ f j ˈu z
refused	ɹ ɪ f j ˈu z d
refuses	ɹ ɪ f j ˈu z ɪ z
regain	ɹ ɪ ɡ ˈe ɪ n
regard	ɹ ɪ ɡ ˈɑ ɹ d
region	ɹ ˈi d͡ʒ ə n
regional	ɹ i d͡ʒ ə n ə l
register	ɹ ˈɛ d͡ʒ ɪ s t ɚ
registration	ɹ ˌɛ d͡ʒ ɪ s t ɹ ˈe ɪ ʃ ə n
regret	ɹ ɪ ɡ ɹ ˈɛ t
regular	ɹ ˈɛ ɡ j ə l ɚ
rehearsal	ɹ ɪ h ˈɚ s ə l
reign	ɹ ˈe ɪ n
rein	ɹ ˈe ɪ n
reinforcements	ɹ ˌi ɪ n f ˈɔ ɹ s m ə n t s
reject	ɹ ˈi d͡ʒ ɛ k t
reject	ɹ ɪ d͡ʒ ˈɛ k t
rejects	ɹ ɪ d͡ʒ ˈɛ k t s
rejects	ɹ ˈi d͡ʒ ɛ k t s
related	ɹ ɪ l ˈe ɪ t ɪ d
relationship	ɹ i l ˈe ɪ ʃ ə n ʃ ˌɪ p
relatives	ɹ ˈɛ l ɪ t ɪ v z
relax	ɹ i l ˈæ k s
relaxed	ɹ ə l ˌæ k s d
release	ɹ i l ˈi s
released	ɹ i l ˈi s t
releasing	ɹ i l ˈi s ɪ ŋ
relief	ɹ ɪ l ˈi f
relieve	ɹ ɪ l ˈi v
relieved	ɹ ɪ l ˈi v d
rely	ɹ ɪ l ˈa ɪ
relying	ɹ ˈi l ˈa ɪ ˌi ŋ
remain	ɹ ɪ m ˈe ɪ n
remained	ɹ ɪ m ˈe ɪ n d
remains	ɹ ɪ m ˈe ɪ n z
remarkable	ɹ ɪ m ˈɑ ɹ k ə b ə l
remarkables	ɹ ɪ m ˈɑ ɹ k ə b ə l z
remember	ɹ ɪ m ˈɛ m b ɚ
remembered	ɹ ə m ˈɛ m b ɚ d
remembering	ɹ ɪ m ˈɛ m b ɚ ɹ ɪ ŋ
remembers	ɹ ɪ m ˈɛ m b ɚ z
remind	ɹ i m ˈa ɪ n d
reminded	ɹ i m ˈa ɪ n d ɪ d
remote	ɹ ɪ m ˈo ʊ t
remove	ɹ i m ˈu v
removes	ɹ i m ˈu v z
ren	ɹ ˈɛ n
rendition	ɹ ɛ n d ˈɪ ʃ ə n
renditions	ɹ ɛ n d ˈɪ ʃ ə n z
renovate	ɹ ˈɛ n ə v ˌe ɪ t
rent	ɹ ˈɛ n t
repair	ɹ ɪ p ˈɛ ɹ
repeat	ɹ ɪ p ˈi t
repeating	ɹ ɪ p ˈi t ɪ ŋ
repeats	ɹ ɪ p ˈi t s
replace	ɹ ˌi p l ˈe ɪ s
replaced	ɹ ə p l ˈe ɪ s d
replied	ɹ ɪ p l ˈa ɪ d
replies	ɹ ɪ p l ˈa ɪ z
reply	ɹ ɪ p l ˈa ɪ
report	ɹ ɪ p ˈɔ ɹ t
reported	ɹ ɪ p ˈɔ ɹ t ɪ d
reporter	ɹ ɪ p ˈɔ ɹ t ɚ
represent	ɹ ˌɛ p ɹ ɪ z ˈɛ n t
represented	ɹ ˌɛ p ɹ ɪ z ˈɛ n t ɪ d
represents	ɹ ˌɛ p ɹ ɪ z ˈɛ n t s
reptile	ɹ ˈɛ p t a ɪ l
reptiles	ɹ ˈɛ p t a ɪ l z
request	ɹ ɪ k w ˈɛ s t
requires	ɹ i k w ˈa ɪ ɚ z
reread	ɹ ˌi ɹ ˈi d
rescue	ɹ ˈɛ s k j u
research	ɹ i s ˈɚ t͡ʃ
researching	ɹ i s ˈɚ t͡ʃ ɪ ŋ
reset	ɹ i s ˈɛ t
resident	ɹ ˈɛ z ɪ d ə n t
residents	ɹ ˈɛ z ɪ d ə n t s
resigned	ɹ ɪ z ˈa ɪ n d
resist	ɹ ɪ z ˈɪ s t
resource	ɹ ˈi s ɔ ɹ s
resources	ɹ ɪ z ɔ s ə z
respawn	ɹ ˌi s p ˈa ʊ n
respond	ɹ ɪ s p ˈɑ n d
responded	ɹ ɪ s p ˈɑ n d ɪ d
response	ɹ ɪ s p ˈɑ n s
responsible	ɹ i s p ˈɑ n s ɪ b ə l
rest	ɹ ˈɛ s t
rested	ɹ ˈɛ s t ɪ d
resting	ɹ ˈɛ s t ɪ ŋ
restless	ɹ ˈɛ s t l ə s
restraining	ɹ i s t ɹ ˈe ɪ n ɪ ŋ
rests	ɹ ˈɛ s t s
result	ɹ ɪ z ˈʌ l t
results	ɹ ɪ z ˈʌ l t s
resume	ɹ ɪ z ˈu m
resume	ɹ ˈɛ z ə m ˌe ɪ
retreat	ɹ i t ɹ ˈi t
retrieve	ɹ ɪ t ɹ ˈi v
retriever	ɹ i t ɹ ˈi v ɚ
return	ɹ ɪ t ˈɚ n
returned	ɹ ɪ t ˈɚ n d
returns	ɹ ɪ t ˈɚ n z
reused	ɹ i j u s d
reveal	ɹ ɪ v ˈi l
revealed	ɹ ɪ v ˈi l d
revel	ɹ ˈɛ v ə l
revels	ɹ ˈɛ v ə l z
revenge	ɹ i v ˈɛ n d͡ʒ
reward	ɹ ɪ w ˈɔ ɹ d
rewards	ɹ ɪ w ˈɔ ɹ d z
rex	ɹ ˈɛ k s
rhino	ɹ ˈa ɪ n o ʊ
ribbit	ɹ i b ə t
ribbon	ɹ ˈɪ b ə n
ribbons	ɹ ˈɪ b ə n z
rice	ɹ ˈa ɪ s
rich	ɹ ˈɪ t͡ʃ
riches	ɹ ɪ t͡ʃ ɪ z
rid	ɹ ˈɪ d
ridden	ɹ ˈɪ d ə n
ride	ɹ ˈa ɪ d
rider	ɹ ˈa ɪ d ə
rides	ɹ ˈa ɪ d z
ridge	ɹ ˈɪ d͡ʒ
riding	ɹ ˈa ɪ d ɪ ŋ
rifka	ɹ ˈɪ f k ə
rifkas	ɹ ˈɪ f k ə s
rifki	ɹ ˈɪ f k i
rift	ɹ ˈɪ f t
rifts	ɹ ˈɪ f t s
rig	ɹ ˈɪ ɡ
right	ɹ ˈa ɪ t
rigid	ɹ ˈɪ d͡ʒ ɪ d
rim	ɹ ˈɪ m
rima	ɹ ˈi m ʌ
rin	ɹ ˈɪ n
ring	ɹ ˈɪ ŋ
ringing	ɹ ˈɪ ŋ ɪ ŋ
ringneck	ɹ ˈɪ ŋ n ˌɛ k
rings	ɹ ˈɪ ŋ z
riot	ɹ ˈa ɪ ə t
rip	ɹ ˈɪ p
ripe	ɹ ˈa ɪ p
ripest	ɹ ˈa ɪ p ˈɛ s t
ripped	ɹ ˈɪ p t
rise	ɹ ˈa ɪ z
risen	ɹ ˈɪ z ə n
rises	ɹ ˈa ɪ z ɪ z
rising	ɹ ˈa ɪ z ɪ ŋ
risk	ɹ ˈɪ s k
risking	ɹ ˈɪ s k ɪ ŋ
risky	ɹ ˈɪ s k i
rivalry	ɹ ˈa ɪ v ə l ɹ i
river	ɹ ˈɪ v ɚ
riverbank	ɹ ˈɪ v ɚ b ˌæ ŋ k
rivers	ɹ ˈɪ v ɚ z
riza	ɹ ˈi z ə
rizas	ɹ ˈa ɪ z ə z
ro	ɹ ˈo ʊ
road	ɹ ˈo ʊ d
roads	ɹ ˈo ʊ d z
roadworks	ɹ ˈo ʊ d w ˌɚ k s
roam	ɹ ˈo ʊ m
roamed	ɹ ˈo ʊ m d
roaming	ɹ ˈo ʊ m ɪ ŋ
roams	ɹ ˈo ʊ m z
roar	ɹ ˈɔ ɹ
roared	ɹ ˈɔ ɹ d
roaring	ɹ ˈɔ ɹ ɪ ŋ
roars	ɹ ˈɔ ɹ z
roast	ɹ ˈo ʊ s t
roasted	ɹ ˈo ʊ s t ɪ d
roasts	ɹ ˈo ʊ s t s
rob	ɹ ˈɑ b
robot	ɹ ˈo ʊ b ˌɑ t
robots	ɹ ˈo ʊ b ˌɑ t s
rock	ɹ ˈɑ k
rocket	ɹ ˈɑ k ə t
rockets	ɹ ˈɑ k ə t s
rocks	ɹ ˈɑ k s
rockstar	ɹ ˈɑ k s t ˌɑ ɹ
rocky	ɹ ˈɑ k i
rod	ɹ ˈɑ d
rode	ɹ ˈo ʊ d
rods	ɹ ˈɑ d z
role	ɹ ˈo ʊ l
roles	ɹ ˈo ʊ l z
roll	ɹ ˈo ʊ l
rolled	ɹ ˈo ʊ l d
roller	ɹ ˈo ʊ l ɚ
rolling	ɹ ˈo ʊ l ɪ ŋ
rolls	ɹ ˈo ʊ l z
roof	ɹ ˈu f
room	ɹ ˈu m
rooms	ɹ ˈu m z
rooster	ɹ ˈu s t ɚ
rooster's	ɹ ˈu s t ɚ z
roosters	ɹ ˈu s t ɚ z
root	ɹ ˈu t
roots	ɹ ˈu t s
rooves	ɹ ˈu v z
rope	ɹ ˈo ʊ p
ropes	ɹ ˈo ʊ p s
rose	ɹ ˈo ʊ z
roses	ɹ ˈo ʊ z ɪ z
rosettes	ɹ o ʊ z ˈɛ t s
rot	ɹ ˈɑ t
rotate	ɹ ˈo ʊ t ˌe ɪ t
rotates	ɹ ˈo ʊ t ˌe ɪ t s
rotted	ɹ ˈɑ t ɪ d
rotten	ɹ ˈɑ t ə n
rotting	ɹ ˈɑ t ɪ ŋ
rough	ɹ ˈʌ f
roughly	ɹ ˈʌ f l i
round	ɹ ˈa ʊ n d
rounded	ɹ ˈa ʊ n d ɪ d
rounds	ɹ ˈa ʊ n d z
roused	ɹ ˈa ʊ z d
routine	ɹ u t ˈi n
row	ɹ ˈo ʊ
rowed	ɹ ˈo ʊ d
rowing	ɹ ˈo ʊ ɪ ŋ
rows	ɹ ˈo ʊ z
royal	ɹ ˈɔ ɪ ə l
rrr	ɹ ˈʌ
rub	ɹ ˈʌ b
rubber	ɹ ˈʌ b ɚ
rubbers	ɹ ˈʌ b ɚ z
rubbing	ɹ ˈʌ b ɪ ŋ
rubbish	ɹ ˈʌ b ɪ ʃ
rube	ɹ u b
rubs	ɹ ˈʌ b z
ruby	ɹ ˈu b i
rude	ɹ ˈu d
rug	ɹ ˈʌ ɡ
ruin	ɹ ˈu ɪ n
ruined	ɹ u ɪ n d
ruins	ɹ ˈu ɪ n z
rule	ɹ ˈu l
ruled	ɹ ˈu l d
ruler	ɹ ˈu l ɚ
rules	ɹ ˈu l z
rumbly	ɹ ˈʌ m b l i
rump	ɹ ˈʌ m p
run	ɹ ˈʌ n
runaway	ɹ ˈʌ n ə w ˌe ɪ
running	ɹ ˈʌ n ɪ ŋ
runs	ɹ ˈʌ n z
rural	ɹ ˈʊ ɹ ə l
rusa	ɹ ˈu s ˈɑ
rush	ɹ ˈʌ ʃ
rushed	ɹ ˈʌ ʃ t
rushes	ɹ ˈʌ ʃ ɪ z
rushing	ɹ ˈʌ ʃ ɪ ŋ
russell	ɹ ˈʌ s ə l
rust	ɹ ˈʌ s t
rusted	ɹ ˈʌ s t ɪ d
rustle	ɹ ˈʌ s ə l
rustling	ɹ ˈʌ s ə l ɪ ŋ
rye	ɹ ˈa ɪ
s	ˈɛ s
s-h	ˈɛ s ˈe ɪ t͡ʃ
s-i	ˈɛ s ˈa ɪ
sac	s ˈæ k
sack	s ˈæ k
sacks	s ˈæ k s
sacrificial	s ˌæ k ɹ ə f ˈɪ ʃ ə l
sacs	s ˈæ k s
sad	s ˈæ d
sadden	s ˈæ d ə n
saddens	s ˈæ d ə n z
saddle	s ˈæ d ə l
sadly	s ˈæ d l i
sadness	s ˈæ d n ə s
safe	s ˈe ɪ f
safely	s ˈe ɪ f l i
safer	s ˈe ɪ f ɚ
safety	s ˈe ɪ f t i
sagacity	s ˈæ ɡ ə s ɪ t i
said	s ˈɛ d
sail	s ˈe ɪ l
sailed	s ˈe ɪ l d
sailor	s ˈe ɪ l ɚ
sailors	s ˈe ɪ l ɚ z
sails	s ˈe ɪ l z
saint	s ˈe ɪ n t
salad	s ˈæ l ə d
sale	s ˈe ɪ l
salesman	s ˈe ɪ l z m ə n
salmon	s ˈæ m ə n
salt	s ˈɔ l t
salty	s ˈɔ l t i
sam	s ˈæ m
sam's	s ˌæ m z
sambar	s ˈæ m b ˈɑ ɹ
same	s ˈe ɪ m
sample	s ˈæ m p ə l
samples	s ˈæ m p ə l z
sanctuary	s ˈæ ŋ k t͡ʃ u ˌɛ ɹ i
sand	s ˈæ n d
sandbar	s ˈæ n d b ˌɑ ɹ
sands	s ˈæ n d z
sandy	s ˈæ n d i
sang	s ˈæ ŋ
sank	s ˈæ ŋ k
sap	s ˈæ p
saplings	s æ p l ˈɪ ŋ z
sara	s ˈɛ ɹ ə
sat	s ˈæ t
satisfied	s ˈæ t ɪ s f ˌa ɪ d
satisfy	s ˈæ t ɪ s f ˌa ɪ
saturday	s ˈæ t ɚ d ˌe ɪ
saturn	s ˈæ t ɚ n
sauce	s ˈɔ s
savage	s ˈæ v ɪ d͡ʒ
savagely	s ˈæ v ɪ d͡ʒ l i
save	s ˈe ɪ v
saved	s ˈe ɪ v d
saves	s ˈe ɪ v z
saving	s ˈe ɪ v ɪ ŋ
saw	s ˈɔ
say	s ˈe ɪ
saying	s ˈe ɪ ɪ ŋ
says	s ɛ z
scale	s k ˈe ɪ l
scales	s k ˈe ɪ l z
scaly	s k ə l i
scamper	s k ˈæ m p ɚ
scampering	s k ˈæ m p ɚ ɹ ɪ ŋ
scan	s k ˈæ n
scanned	s k ˈæ n d
scans	s k ˈæ n z
scare	s k ˈɛ ɹ
scarecrow	s k ˈɛ ɹ k ɹ o ʊ
scared	s k ˈɛ ɹ d
scares	s k ˈɛ ɹ z
scarf	s k ˈɑ ɹ f
scaring	s k ˈe ɪ ɹ i ŋ
scars	s k ɑ ɹ z
scarves	s k ˈɑ ɹ v z
scary	s k ˈɛ ɹ ɹ i
scatter	s k ˈæ t ɚ
scattered	s k ˈæ t ɚ d
scattering	s k ˈæ t ɚ ɹ ɪ ŋ
scatterings	s k ˈæ t ɚ ɹ ɪ ŋ z
scatters	s k ˈæ t ɚ z
scene	s ˈi n
scenes	s ˈi n z
scenic	s ˈi n ɪ k
scent	s ˈɛ n t
scheme	s k ˈi m
school	s k ˈu l
school's	s k ˈu l z
schools	s k ˈu l z
science	s ˈa ɪ ə n s
scientific	s ˌa ɪ ə n t ˈɪ f ɪ k
scientist	s ˈa ɪ ə n t ɪ s t
scientists	s ˈa ɪ ə n t ə s t s
scissors	s ˈɪ z ɚ z
scoff	s k ˈɔ f
scoffs	s k ˈɔ f s
scolding	s k ˈo ʊ l d ɪ ŋ
scoop	s k ˈu p
scooped	s k ˈu p t
scooping	s k ˈu p ɪ ŋ
scoops	s k ˈu p s
scoot	s k ˈu t
scooted	s k ˈu t d
scooter	s k ˈu t ɚ
scoots	s k ˈu t s
scope	s k ˈo ʊ p
scopes	s k ˈo ʊ p s
scorched	s k ˈɔ ɹ t͡ʃ t
score	s k ˈɔ ɹ
scores	s k ɔ ɹ z
scorned	s k ˈɔ ɹ n d
scorpion	s k ˈɔ ɹ p i ə n
scorpions	s k ˈɔ ɹ p i ə n z
scottish	s k ˈɑ t ɪ ʃ
scout	s k ˈa ʊ t
scowled	s k ˈa ʊ l d
scowling	s k ˈa ʊ l ɪ ŋ
scrap	s k ɹ ˈæ p
scrape	s k ɹ ˈe ɪ p
scrapes	s k ɹ ˈe ɪ p s
scraps	s k ɹ ˈæ p s
scratch	s k ɹ ˈæ t͡ʃ
scratched	s k ɹ ˈæ t͡ʃ t
scratches	s k ɹ ˈæ t͡ʃ ɪ z
scratching	s k ɹ ˈæ t͡ʃ ɪ ŋ
scratchings	s k ɹ ˈæ t͡ʃ ɪ ŋ z
scream	s k ɹ ˈi m
screamed	s k ɹ ˈi m d
screaming	s k ɹ ˈi m ɪ ŋ
screams	s k ɹ ˈi m z
screech	s k ɹ ˈi t͡ʃ
screen	s k ɹ ˈi n
screens	s k ɹ ˈi n z
screw	s k ɹ ˈu
screws	s k ɹ ˈu z
scribble	s k ɹ ɪ b l
scribbling	s k ɹ ɪ b l ˌi ŋ
scroll	s k ɹ ˈo ʊ l
scrub	s k ɹ ˈʌ b
scrubby	s k ɹ ˈʌ b b i
scrubfowl	s k ɹ ˈʌ b f ˈa ʊ l
scrubs	s k ɹ ˈʌ b z
scuffling	s k ˈʌ f ə l ɪ ŋ
sculpt	s k ʌ l p t
scurry	s k ˈɚ ɹ i
scuttle	s k ˈʌ t ə l
scuttles	s k ˈʌ t l z
sd	ˈɛ s d ˈi
sea	s ˈi
seabed	s ˈi b ˌɛ d
seahorses	s ˈi h ˈɑ s ɪ z
seal	s ˈi l
seam	s ˈi m
search	s ˈɚ t͡ʃ
searched	s ˈɚ t͡ʃ t
searches	s ˈɚ t͡ʃ ɪ z
searching	s ˈɚ t͡ʃ ɪ ŋ
seas	s ˈi z
seaside	s ˈi s ˈa ɪ d
season	s ˈi z ə n
seat	s ˈi t
seated	s ˈi t ɪ d
seats	s ˈi t s
seawater	s ˈi w ˌɔ t ɚ
seaweed	s ˈi w ˌi d
seblat	s ə b l ˈæ t
second	s ˈɛ k ə n d
secondary	s ˈɛ k ə n d ˌɛ ɹ i
secondly	s ˈɛ k ə n d l i
seconds	s ˈɛ k ə n d z
secret	s ˈi k ɹ ɪ t
secrete	s ɪ k ɹ ˈi t
section	s ˈɛ k ʃ ə n
sections	s ˈɛ k ʃ ə n z
secure	s ɪ k j ˈʊ ɹ
security	s ɪ k j ˈʊ ɹ ɪ t i
see	s ˈi
seed	s ˈi d
seedling	s ˈi d l ɪ ŋ
seedlings	s ˈi d l ɪ ŋ z
seedpods	s ˈi d p ˌɑ d z
seeds	s ˈi d z
seeing	s ˈi ɪ ŋ
seek	s ˈi k
seeking	s ˈi k ɪ ŋ
seem	s ˈi m
seemed	s ˈi m d
seems	s ˈi m z
seen	s ˈi n
sees	s ˈi z
segment	s ˌɛ ɡ m ˈɛ n t
segment	s ˈɛ ɡ m ə n t
segments	s ˌɛ ɡ m ˈɛ n t s
segments	s ˈɛ ɡ m ə n t s
seismic	s ˈa ɪ z m ɪ k
seize	s ˈi z
seized	s ˈi z d
seldom	s ˈɛ l d ə m
select	s ə l ˈɛ k t
selected	s ə l ɛ k t ə d
selects	s ə l ˈɛ k t s
self	s ˈɛ l f
self-awareness	s ɛ l f ə w ˈe ɪ ɹ n ə s
selfish	s ˈɛ l f ɪ ʃ
sell	s ˈɛ l
selling	s ˈɛ l ɪ ŋ
sen	s ˈɛ n
sen's	s ˈɛ n z
send	s ˈɛ n d
sending	s ˈɛ n d ɪ ŋ
sends	s ˈɛ n d z
sense	s ˈɛ n s
senses	s ˈɛ n s ə z
sensitive	s ˈɛ n s ɪ t ɪ v
sent	s ˈɛ n t
separate	s ˈɛ p ɚ ɹ ɪ t
separate	s ˈɛ p ɚ ɹ ˌe ɪ t
separate	s ˈɛ p ɚ ɹ ˌe ɪ t
separates	s ˈɛ p ɚ ɹ ˌe ɪ t s
separates	s ˈɛ p ɚ ɹ ɪ t s
serpent	s ˈɚ p ə n t
serpents	s ˈɚ p ə n t s
serrated	s ˈɛ ɹ ˌe ɪ t ɪ d
serve	s ˈɚ v
server	s ˈɚ v ɚ
serves	s ɚ v z
service	s ˈɚ v ɪ s
session	s ˈɛ ʃ ə n
set	s ˈɛ t
sets	s ˈɛ t s
setting	s ˈɛ t ɪ ŋ
settings	s ˈɛ t ɪ ŋ z
settle	s ˈɛ t ə l
settled	s ˈɛ t ə l d
settles	s ˈɛ t ə l z
setup	s ˈɛ t ˌʌ p
setups	s ˈɛ t ˌʌ p s
seven	s ˈɛ v ə n
seventeen	s ˈɛ v ə n t ˈi n
several	s ˈɛ v ɚ ɹ ə l
sewer	s ˈu w ɚ
sewing	s ˈo ʊ ɪ ŋ
sewn	s ˈo ʊ n
sh	ʃ
shabby	ʃ ˈæ b i
shack	ʃ ˈæ k
shade	ʃ ˈe ɪ d
shades	ʃ ˈe ɪ d z
shadow	ʃ ˈæ d o ʊ
shadows	ʃ ˈæ d o ʊ z
shadowy	ʃ ˈæ d o ʊ i
shaft	ʃ ˈæ f t
shaggy	ʃ ˈæ ɡ i
shake	ʃ ˈe ɪ k
shakes	ʃ ˈe ɪ k s
shaking	ʃ ˈe ɪ k ɪ ŋ
shall	ʃ ˈæ l
shallow	ʃ ˈæ l o ʊ
shallows	ʃ ˈæ l o ʊ z
shame	ʃ ˈe ɪ m
shape	ʃ ˈe ɪ p
shaped	ʃ ˈe ɪ p t
shapes	ʃ ˈe ɪ p s
shapeshifter	ʃ ˈe ɪ p ʃ ɪ f t ɚ
shapeshifters	ʃ ˈe ɪ p ʃ ɪ f t ɚ z
share	ʃ ˈɛ ɹ
shared	ʃ ˈɛ ɹ d
shares	ʃ ˈɛ ɹ z
sharing	ʃ ˈɛ ɹ ɪ ŋ
shark	ʃ ˈɑ ɹ k
sharks	ʃ ˈɑ ɹ k s
sharp	ʃ ˈɑ ɹ p
sharper	ʃ ˌɑ p ɹ
sharpest	ʃ ˈɑ ɹ p ə s t
sharpness	ʃ ˈɑ ɹ p n ə s
sharps	ʃ ˈɑ ɹ p s
shawl	ʃ ˈɔ l
shawn	ʃ ˈɔ n
shawns	ʃ ˈɔ n z
she	ʃ ˈi
she'd	ʃ ˈi d
she'll	ʃ ˈi l
she's	ʃ ˈi z
shears	ʃ ˈi ɹ z
shed	ʃ ˈɛ d
sheds	ʃ ˈɛ d z
sheep	ʃ ˈi p
sheepish	ʃ ˈi p ɪ ʃ
sheer	ʃ ˈɪ ɹ
sheet	ʃ ˈi t
sheets	ʃ ˈi t s
shelf	ʃ ˈɛ l f
shell	ʃ ˈɛ l
shells	ʃ ˈɛ l z
shelter	ʃ ˈɛ l t ɚ
shelves	ʃ ˈɛ l v z
shepherd	ʃ ˈɛ p ɚ d
shes	ʃ i z
shh	ʃ
shield	ʃ ˈi l d
shields	ʃ ˈi l d z
shies	ʃ ˈa ɪ z
shift	ʃ ˈɪ f t
shifts	ʃ ˈɪ f t s
shilling	ʃ ˈɪ l l ɪ ŋ
shine	ʃ ˈa ɪ n
shines	ʃ ˈa ɪ n z
shining	ʃ ˈa ɪ n ɪ ŋ
shiny	ʃ ˈa ɪ n i
ship	ʃ ˈɪ p
shipment	ʃ ˈɪ p m ə n t
shipping	ʃ ˈɪ p ɪ ŋ
ships	ʃ ˈɪ p s
shire	ʃ ˈa ɪ ɚ
shirt	ʃ ˈɚ t
shirts	ʃ ˈɚ t s
shiver	ʃ ˈɪ v ɚ
shock	ʃ ˈɑ k
shocked	ʃ ˈɑ k t
shocking	ʃ ˈɑ k ɪ ŋ
shoe	ʃ ˈu
shoemaker	ʃ ˈu m ˌe ɪ k ɚ
shoes	ʃ ˈu z
shone	ʃ ˈo ʊ n
shoo	ʃ ˈu
shook	ʃ ˈʊ k
shoot	ʃ ˈu t
shooting	ʃ ˈu t ɪ ŋ
shoots	ʃ ˈu t s
shop	ʃ ˈɑ p
shopkeeper	ʃ ˈɑ p k ˌi p ɚ
shopkeeper's	ʃ ˈɑ p k ˌi p ɚ z
shopkeepers	ʃ ˈɑ p k ˌi p ɚ z
shopping	ʃ ˈɑ p ɪ ŋ
shops	ʃ ˈɑ p s
shore	ʃ ˈɔ ɹ
short	ʃ ˈɔ ɹ t
shortages	ʃ ˈɔ ɹ t ɪ d͡ʒ ɪ z
shorter	ʃ ˈɔ ɹ t ə ɹ
shorts	ʃ ˈɔ ɹ t s
shot	ʃ ˈɑ t
should	ʃ ˈʊ d
shoulder	ʃ ˈo ʊ l d ɚ
shoulders	ʃ ˈo ʊ l d ɚ z
shouldn't	ʃ ˈʊ d ə n t
shouldnt	ʃ ˈa ʊ l d n t
shout	ʃ ˈa ʊ t
shouted	ʃ ˈa ʊ t ɪ d
shouting	ʃ ˈa ʊ t ˈɪ ŋ
shouts	ʃ ˈa ʊ t s
shove	ʃ ˈʌ v
shovel	ʃ ˈʌ v ə l
shoves	ʃ ˈɑ v z
shoving	ʃ ˈʌ v ɪ ŋ
show	ʃ ˈo ʊ
showed	ʃ ˈo ʊ d
shower	ʃ ˈa ʊ ɚ
showing	ʃ ˈo ʊ ɪ ŋ
shown	ʃ ˈo ʊ n
shows	ʃ ˈo ʊ z
shriek	ʃ ɹ ˈi k
shrieked	ʃ ɹ ˈi k t
shrieking	ʃ ɹ ˈi k ɪ ŋ
shrieks	ʃ ɹ ˈi k s
shrimp	ʃ ɹ ˈɪ m p
shrink	ʃ ɹ ˈɪ ŋ k
shrinks	ʃ ɹ ˈɪ ŋ k s
shrub	ʃ ɹ ˈʌ b
shrubs	ʃ ɹ ˈʌ b z
shrugged	t͡ʃ ɹ ʌ ɡ d
shrugs	ʃ ɹ ʌ ɡ z
shrunk	ʃ ɹ ˈʌ ŋ k
shrunken	ʃ ɹ ʌ n k ˈɛ n
shudder	ʃ ʌ d ʌ
shuffle	ˈʃ ʌ f ə l
shut	ʃ ˈʌ t
shuteye	ʃ ˈʌ t a ɪ
shuts	ʃ ˈʌ t s
shutting	ʃ ˈʌ t ɪ ŋ
shy	ʃ ˈa ɪ
siamese	s ˌa ɪ ə m ˈi z
siberian	s ˈa ɪ b ˈi ɹ i ə n
sick	s ˈɪ k
sickly	s ˈɪ k l i
sickness	s ˈɪ k n ə s
side	s ˈa ɪ d
side-by-side	s ˈa ɪ d b ˈa ɪ s ˈa ɪ d
sides	s ˈa ɪ d z
sideways	s ˈa ɪ d w ˌe ɪ z
sigh	s ˈa ɪ
sighed	s ˈa ɪ d
sighs	s ˈa ɪ z
sight	s ˈa ɪ t
sights	s ˈa ɪ t s
sign	s ˈa ɪ n
signal	s ˈɪ ɡ n ə l
signals	s ˈɪ ɡ n l z
signed	s ˈa ɪ n d
signs	s ˈa ɪ n z
silence	s ˈa ɪ l ə n s
silent	s ˈa ɪ l ə n t
silk	s ˈɪ l k
silky	s ˈɪ l k i
sill	s ˈɪ l
silly	s ˈɪ l i
silo	s ˈa ɪ l o ʊ
silver	s ˈɪ l v ɚ
silverfish	s ˈɪ l v ɚ f ɪ ʃ
similar	s ˈɪ m ɪ l ɚ
similarities	s ɪ m ɪ l ˈɛ ɹ ə t i z
similarity	s ˌɪ m ɪ l ˈɛ ɹ ə t i
simple	s ˈɪ m p ə l
simply	s ˈɪ m p l i
since	s ˈɪ n s
sincere	s ɪ n s ˈɪ ɹ
sing	s ˈɪ ŋ
singer	s ˈɪ ŋ ɡ ɚ
singers	s ˈɪ ŋ ɡ ɚ z
singing	s ˈɪ ŋ ɪ ŋ
single	s ˈɪ ŋ ɡ ə l
singles	s ˈɪ ŋ ɡ ə l z
sings	s ˈɪ ŋ z
sink	s ˈɪ ŋ k
sinking	s ˈɪ ŋ k ɪ ŋ
sinks	s ˈɪ ŋ k s
sinner	s ˈɪ n ɚ
sip	s ˈɪ p
sir	s ˈɚ
siren	s ˈa ɪ ɹ ə n
sirish	s ˈɪ ɹ ɪ ʃ
sis	s ˈɪ s
sister	s ˈɪ s t ɚ
sister's	s ˈɪ s t ɚ z
sisters	s ɪ s t ɚ z
sit	s ˈɪ t
sit's	s ˈɪ t s
sitar	s ɪ t ˈɑ ɹ
site	s ˈa ɪ t
sites	s a ɪ t s
sits	s ˈɪ t s
sitting	s ˈɪ t ɪ ŋ
situation	s ˌɪ t͡ʃ u e ɪ ʃ ə n
six	s ˈɪ k s
sixth	s ˈɪ k s θ
sixty	s ˈɪ k s t i
size	s ˈa ɪ z
sized	s ˈa ɪ z d
sizes	s ˈa ɪ z ɪ z
skateboard	s k ˈe ɪ t b ˌɔ ɹ d
skates	s k ˈe ɪ t s
skel	s k ˈɛ l
skel's	s k ɛ l z
skel's	s k ɛ l z
skeleton	s k ˈɛ l ə t ə n
skeletons	s k ˈɛ l ə t ə n z
sketch	s k ˈɛ t͡ʃ
sketches	s k ˈɛ t͡ʃ ɪ z
sketching	s k ˈɛ t͡ʃ ɪ ŋ
ski	s k ˈi
skies	s k ˈa ɪ z
skill	s k ˈɪ l
skills	s k ˈɪ l z
skin	s k ˈɪ n
skin's	s k ˈɪ n z
skink	s k ˈɪ ŋ k
skink's	s k ˈɪ ŋ k s
skinks	s k ɪ n k s
skinny	s k ˈɪ n i
skins	s k ˈɪ n z
skip	s k ˈɪ p
skirt	s k ˈɚ t
skittish	s k ˈɪ t ɪ ʃ
skull	s k ˈʌ l
skulls	s k ˈʌ l z
skunk	s k ˈʌ ŋ k
skunks	s k ˈʌ ŋ k s
sky	s k ˈa ɪ
skyline	s k ˈa ɪ l ˌa ɪ n
slabs	s l ˈæ b z
slack	s l ˈæ k
slain	s l ˈe ɪ n
slam	s l ˈæ m
slap	s l ˈæ p
slash	s l ˈæ ʃ
slashed	s l ˈæ ʃ t
slashes	s l ˈæ ʃ ɛ z
slaughter	s l ˈɔ t ɚ
slave	s l ˈe ɪ v
slavic	s l ˈɑ v ɪ k
slay	s l ˈe ɪ
slayed	s l ˈe ɪ d
slays	s l ˈe ɪ z
slee	s l ˈi p
sleek	s l ˈi k
sleep	s l ˈi p
sleeping	s l ˈi p ɪ ŋ
sleeps	s l ˈi p s
sleepy	s l ˈi p i
sleigh	s l ˈe ɪ
slender	s l ˈɛ n d ɚ
slept	s l ˈɛ p t
slice	s l ˈa ɪ s
slid	s l ˈɪ d
slide	s l ˈa ɪ d
slides	s l a ɪ d z
sliding	s l ˈa ɪ d ɪ ŋ
slightly	s l ˈa ɪ t l i
slim	s l ˈɪ m
slime	s l ˈa ɪ m
slimes	s l ˈa ɪ m z
sling	s l ˈɪ ŋ
slings	s l ˈɪ ŋ z
slingshot	s l ˈɪ ŋ ʃ ˌɑ t
slink	s l ˈɪ ŋ k
slinking	s l ˈɪ n k ˈi ŋ
slinks	s l ˈɪ ŋ k s
slip	s l ˈɪ p
slipped	s l ˈɪ p t
slipper	s l ˈɪ p ɚ
slippers	s l ˈɪ p ɚ z
slippery	s l ˈɪ p ɚ ɹ i
slipping	s l ɪ p ɪ ŋ
slips	s l ˈɪ p s
slit	s l ˈɪ t
slither	s l ˈɪ ð ɚ
slithering	s l ˈɪ ð ɚ ɹ ɪ ŋ
slithers	s l ˈɪ ð ɚ z
slits	s l ˈɪ t s
slop	s l ˈɑ p
slope	s l ˈo ʊ p
slot	s l ˈɑ t
sloth	s l ˈo ʊ θ
slow	s l ˈo ʊ
slow-moving	s l ˈo ʊ m ˈu v ɪ ŋ
slower	s l ˈo ʊ ɚ
slowly	s l ˈo ʊ l i
slows	s l ˈo ʊ z
sludge	s l ˈʌ d͡ʒ
slunk	s l ˈʌ ŋ k
slurp	s l ˈɚ p
smack	s m ˈæ k
smacks	s m ˈæ k s
small	s m ˈɔ l
smaller	s m ˈɔ l ɚ
smallest	s m ˈɔ l ə s t
smalls	s m ˈɔ l z
smart	s m ˈɑ ɹ t
smarter	s m ˈɑ ɹ t ɚ
smartest	s m ˈɑ ɹ t ə s t
smash	s m ˈæ ʃ
smashed	s m ˈæ ʃ t
smashed-in	s m ˈæ ʃ t ˈɪ n
smashes	s m ˈæ ʃ ɪ z
smell	s m ˈɛ l
smelled	s m ˈɛ l d
smelling	s m ˈɛ l ˈɪ ŋ
smells	s m ˈɛ l z
smelly	s m ˈɛ l i
smelt	s m ɛ l t
smile	s m ˈa ɪ l
smiled	s m ˈa ɪ l d
smiles	s m ˈa ɪ l z
smiling	s m ˈa ɪ l ɪ ŋ
smirk	s m ˈɚ k
smirking	s m ˈɚ k ɪ ŋ
smirks	s m ˈɚ k s
smith	s m ˈɪ θ
smog	s m ˈɑ ɡ
smoggy	s m ˈɔ ɡ i
smoke	s m ˈo ʊ k
smoldering	s m ˈo ʊ l d ɚ ɹ ɪ ŋ
smooshing	s m ʊ ʃ ˈi ŋ
smooth	s m ˈu ð
smoothed	s m ˈu ð d
smoothly	s m ˈu ð l i
smooths	s m ˈu ð z
smouldering	s m ˈa ʊ l d ɚ ɹ ɪ ŋ
smug	s m ˈʌ ɡ
snack	s n ˈæ k
snacked	s n ˈæ k t
snacking	s n ˈæ k ɪ ŋ
snacks	s n ˈæ k s
snag	s n ˈæ ɡ
snagged	s n ˈæ ɡ d
snail	s n ˈe ɪ l
snails	s n ˈe ɪ l z
snake	s n ˈe ɪ k
snakes	s n ˈe ɪ k s
snap	s n ˈæ p
snap's	s n ˈæ p s
snapped	s n ˈæ p t
snaps	s n ˈæ p s
snarl	s n ˈɑ ɹ l
snarled	s n ˈɑ ɹ ə l d
snarls	s n ˈɑ ɹ l z
snatch	s n ˈæ t͡ʃ
snatched	s n ˈæ t͡ʃ t
snatches	s n ˈæ t͡ʃ ɪ z
sneak	s n ˈi k
sneaker	s n ˈi k ɚ
sneakers	s n ˈi k ɚ z
sneaks	s n ˈi k s
sneaky	s n ˈi k i
sneer	s n ˈɪ ɹ
sneeze	s n ˈi z
sneezed	s n ˈi z d
sneezes	s n ˈi z ɪ z
sneezing	s n ˌi z i ŋ
sniff	s n ˈɪ f
sniffed	s n ˈɪ f t
sniffing	s n ˈɪ f ɪ ŋ
sniffling	s n ˈɪ f l ɪ ŋ
sniffs	s n ˈɪ f s
snip	s n ˈɪ p
snipped	s n ˈɪ p t
snoop	s n ˈu p
snooze	s n ˈu z
snoring	s n ˈɔ ɹ ɪ ŋ
snort	s n ˈɔ ɹ t
snorts	s n ˈɔ ɹ t s
snot	s n ˈɑ t
snout	s n ˈa ʊ t
snouts	s n ˈa ʊ t s
snow	s n ˈo ʊ
snowflake	s n ˈo ʊ f l ˌe ɪ k
snowflakes	s n ˈo ʊ f l ˌe ɪ k s
snowman	s n o ʊ m ˌæ n
snows	s n ˈo ʊ z
snowy	s n ˈo ʊ i
snuck	s n ˈʌ k
snuffed	s n ˈʌ f t
snug	s n ˈʌ ɡ
snuggle	s n ˈʌ ɡ ə l
so	s ˈo ʊ
soak	s ˈo ʊ k
soaked	s ˈo ʊ k t
soaks	s ˈo ʊ k s
soap	s ˈo ʊ p
soaps	s ˈo ʊ p s
soapy	s ˈo ʊ p i
soar	s ˈɔ ɹ
soared	s ˈɔ d
soars	s ˈɔ ɹ z
sob	s ˈɑ b
soccer	s ˈɑ k ɚ
social	s ˈo ʊ ʃ ə l
society	s ə s ˈa ɪ ə t i
sock	s ˈɑ k
sock's	s ˈɑ k s
socks	s ˈɑ k s
soft	s ˈɔ f t
soften	s ˈɔ f ə n
softest	s ˈɔ f t ɪ s t
softly	s ˈɔ f t l i
soil	s ˈɔ ɪ l
solar	s ˈo ʊ l ɚ
sold	s ˈo ʊ l d
soldier	s ˈo ʊ l d͡ʒ ɚ
soldiers	s ˈo ʊ l d͡ʒ ɚ z
solemnly	s ˈɑ l ə m l i
solid	s ˈɑ l ɪ d
solution	s ə l ˈu ʃ ə n
solve	s ˈɑ l v
solved	s ˈɑ l v d
solves	s ˈɑ l v z
some	s ˈʌ m
somebody	s ˈʌ m b ˌɑ d i
somehow	s ˈʌ m h ˌa ʊ
someone	s ˈʌ m w ˌʌ n
someone's	s ˈʌ m w ˈʌ n z
something	s ˈʌ m θ ɪ ŋ
sometime	s ˈʌ m t ˌa ɪ m
sometimes	s ˈʌ m t ˌa ɪ m z
somewhere	s ˈʌ m w ˌɛ ɹ
somewheres	s ˈʌ m w ˌɛ ɹ z
son	s ˈʌ n
song	s ˈɔ ŋ
songs	s ˈɔ ŋ z
sons	s ˈʌ n z
sook	s ˈʊ k
soon	s ˈu n
sooner	s ˈu n ɚ
soot	s ˈʊ t
soothe	s ˈu ð
soothes	s ˈu ð z
soothsayer	s ˌu θ s ˈe ɪ ɚ
sore	s ˈɔ ɹ
sorrow	s ˈɑ ɹ o ʊ
sorry	s ˈɑ ɹ i
sort	s ˈɔ ɹ t
sorted	s ˈɔ ɹ t ɪ d
sorts	s ˈɔ ɹ t s
sos	ˈɛ s ˈo ʊ ˈɛ s
sought	s ˈɔ t
soul	s ˈo ʊ l
souls	s ˈo ʊ l z
sound	s ˈa ʊ n d
sounded	s ˈa ʊ n d ɪ d
sounding	s ˈa ʊ n d ɪ ŋ
sounds	s ˈa ʊ n d z
soup	s ˈu p
sour	s ˈa ʊ ɚ
source	s ˈɔ ɹ s
sources	s ˈɔ ɹ s ɪ z
south	s ˈa ʊ θ
southeast	s ˌa ʊ θ ˈi s t
sovereign	s ˈɑ v ɹ ə n
sow	s ˈo ʊ
sowed	s ˈo ʊ d
space	s p ˈe ɪ s
spaces	s p ˈe ɪ s ɪ z
spade	s p ˈe ɪ d
spades	s p ˈe ɪ d z
spare	s p ˈɛ ɹ
sparkly	s p ˈɑ ɹ k l i
sparks	s p ɑ ɹ k s
sparky	s p ˈɑ ɹ k ˈi
sparrow	s p ˈɛ ɹ ɹ o ʊ
spat	s p ˈæ t
spawn	s p ɔ n
spawned	s p ˈɔ n d
spawner	s p ˈɔ n ˈɚ
spawning	s p ɔ n i ŋ
spawns	s p ɔ n z
speak	s p ˈi k
speaking	s p ˈi k ɪ ŋ
speaks	s p ˈi k s
special	s p ˈɛ ʃ ə l
species	s p ˈi ʃ i z
specific	s p ɪ s ˈɪ f ɪ k
spectacle	s p ˈɛ k t ə k ə l
spectacles	s p ˈɛ k t ə k ə l z
speculating	s p ˈɛ k j ə l ˌe ɪ t ɪ ŋ
speech	s p ˈi t͡ʃ
speeches	s p ˈi t͡ʃ ə z
speed	s p ˈi d
speeding	s p ˈi d ɪ ŋ
speeds	s p ˈi d z
spell	s p ˈɛ l
spells	s p ˈɛ l z
spencer	s p ˈɛ n s ɚ
spend	s p ˈɛ n d
spending	s p ˈɛ n d ɪ ŋ
spends	s p ˈɛ n d z
spent	s p ˈɛ n t
spew	s p j ˈu
spewed	s p j ˈu d
spews	s p j ˈu z
spheres	s f ˈi ɹ z
spice	s p ˈa ɪ s
spicy	s p ˈa ɪ s i
spider	s p ˈa ɪ d ɚ
spider's	s p ˈa ɪ d ɚ z
spiders	s p ˈa ɪ d ɚ z
spied	s p ˈa ɪ d
spies	s p ˈa ɪ z
spike	s p ˈa ɪ k
spiked	s p ˈa ɪ k t
spikes	s p ˈa ɪ k s
spikey	s p ˈa ɪ k i
spiking	s p ˈa ɪ k ɪ ŋ
spiky	s p ˈa ɪ k ˈi
spill	s p ˈɪ l
spilled	s p ˈɪ l d
spills	s p ˈɪ l z
spilt	s p ˈɪ l t
spin	s p ˈɪ n
spinach	s p ˈɪ n ə t͡ʃ
spine	s p ˈa ɪ n
spines	s p ˈa ɪ n z
spinning	s p ˈɪ n ɪ ŋ
spins	s p ˈɪ n z
spirit	s p ˈɪ ɹ ɪ t
spit	s p ˈɪ t
spits	s p ˈɪ t s
splash	s p l ˈæ ʃ
splashed	s p l ˈæ ʃ t
splashes	s p l ˈæ ʃ ɪ z
splashing	s p l ˈæ ʃ ɪ ŋ
splat	s p l ˈæ t
splinter	s p l ˈɪ n t ɚ
splish	s p l ɪ ʃ
split	s p l ˈɪ t
splits	s p l ˈɪ t s
spluttering	s p l ˈʌ t t ɚ ɪ ŋ
spoil	s p ˈɔ ɪ l
spoiled	s p ˈɔ ɪ l d
spoils	s p ˈɔ ɪ l z
spoke	s p ˈo ʊ k
spoken	s p ˈo ʊ k ə n
spook	s p ˈu k
spooked	s p ˈu k t
spooks	s p ˈu k s
spooky	s p ˈu k i
spool	s p ˈu l
spoon	s p ˈu n
sport	s p ˈɔ ɹ t
sporting	s p ˈɔ ɹ t ɪ ŋ
sports	s p ˈɔ ɹ t s
spot	s p ˈɑ t
spotless	s p ˈɑ t l ə s
spots	s p ˈɑ t s
spotted	s p ˈɑ t ɪ d
spotty	s p ˈɑ t ˈi
spout	s p ˈa ʊ t
sprain	s p ɹ ˈe ɪ n
sprang	s p ɹ ˈæ ŋ
sprawl	s p ɹ ˈɔ l
spray	s p ɹ ˈe ɪ
sprayed	s p ɹ ˈe ɪ d
sprays	s p ɹ ˈe ɪ z
spread	s p ɹ ˈɛ d
spreading	s p ɹ ˈɛ d ɪ ŋ
spreads	s p ɹ ˈɛ d z
spring	s p ɹ ˈɪ ŋ
springs	s p ɹ ˈɪ ŋ z
sprinkle	s p ɹ ˈɪ ŋ k ə l
sprinkles	s p ɹ ɪ n k l z
sprint	s p ɹ ˈɪ n t
sprinting	s p ɹ ˈɪ n t ɪ ŋ
sprints	s p ɹ ˈɪ n t s
sprite	s p ɹ ˈa ɪ t
sprout	s p ɹ ˈa ʊ t
sprouted	s p ɹ ˈa ʊ t ɪ d
sprouts	s p ɹ a ʊ t s
spun	s p ˈʌ n
spurted	s p ˈɚ t ɪ d
spy	s p ˈa ɪ
squad	s k w ˈɑ d
square	s k w ˈe ɪ ɹ
squash	s k w ˈɑ ʃ
squashed	s k w ˈɑ ʃ t
squat	s k w ˈɑ t
squawk	s k w ˈɔ k
squawking	s k w ˈɔ k ɪ ŋ
squeak	s k w ˈi k
squeaks	s k w ˈi k s
squeal	s k w ˈi l
squeals	s k w ˈi l z
squeamish	s k w ˈi m ɪ ʃ
squeeze	s k w ˈi z
squeezed	s k w ˈi z d
squeezes	s k w ˈi z ɪ z
squelch	s k w ˈɛ l t͡ʃ
squelches	s k w ˈɛ l t͡ʃ ɪ z
squid	s k w ˈɪ d
squids	s k w ˈɪ d z
squiggles	s k w ˈɪ ɡ ə l z
squiggly	s k w ˈɪ ɡ l i
squire	s k w ˈa ɪ ɚ
squirming	s k w ˈɚ m ɪ ŋ
squirrel	s k w ˈɚ ɹ ə l
squirrels	s k w ˈɚ ə l z
squirt	s k w ə ɹ t
squished	s k w ˈɪ ʃ t
sri	ʃ ɹ ə
sss	s s
stable	s t ˈe ɪ b ə l
stack	s t ˈæ k
stacked	s t ˈæ k t
stacks	s t ˈæ k s
staff	s t ˈæ f
stag	s t ˈæ ɡ
stage	s t ˈe ɪ d͡ʒ
stages	s t ˈe ɪ d͡ʒ ɪ z
stags	s t ˈæ ɡ z
stair	s t ˈɛ ɹ
staircase	s t ˈɛ ɹ k ˌe ɪ s
staircases	s t ˈɛ ɹ k ˌe ɪ s ɪ z
stairs	s t ˈɛ ɹ z
stake	s t ˈe ɪ k
stakes	s t ˈe ɪ k s
stalk	s t ˈɔ k
stalked	s t ˈɔ k t
stalking	s t ˈɔ k ɪ ŋ
stalks	s t ˈɔ k s
stall	s t ˈɔ l
stalls	s t ˈɔ l z
stamen	s t ˈe ɪ m ə n
stamens	s t ˈe ɪ m ə n z
stammered	s t ˈæ m ɚ d
stamp	s t ˈæ m p
stamps	s t ˈæ m p s
stand	s t ˈæ n d
standards	s t æ n d ə d z
standing	s t ˈæ n d ɪ ŋ
stands	s t ˈæ n d z
stapler	s t ˈe ɪ p l ɚ
star	s t ˈɑ ɹ
star's	s t ˈɑ ɹ z
stare	s t ˈɛ ɹ
stared	s t ˈe ɪ ɹ d
stares	s t ˈɛ ɹ z
starfang	s t ˈɑ ɹ f ˈæ ŋ
starfang's	s t ˈɑ ɹ f ˈæ ŋ z
staring	s t ˈɛ ɹ ɪ ŋ
starling	s t ˈɑ ɹ l ɪ ŋ
starred	s t ˈɑ ɹ d
starry	s t ˈɑ ɹ i
stars	s t ˈɑ ɹ z
start	s t ˈɑ ɹ t
started	s t ˈɑ ɹ t ɪ d
starting	s t ˈɑ ɹ t ɪ ŋ
startled	s t ˈɑ ɹ t ə l d
starts	s t ˈɑ ɹ t s
starving	s t ˈɑ ɹ v ɪ ŋ
state	s t ˈe ɪ t
station	s t ˈe ɪ ʃ ə n
statue	s t ˈæ t͡ʃ ˌu
statues	s t ˈæ t͡ʃ ˌu z
stay	s t ˈe ɪ
stayed	s t ˈe ɪ d
staying	s t ˈe ɪ ɪ ŋ
stays	s t ˈe ɪ z
steady	s t ˈɛ d i
steak	s t ˈe ɪ k
steal	s t ˈi l
stealing	s t ˈi l ɪ ŋ
steals	s t ˈi l z
stealthy	s t ɛ l θ ˈi
steam	s t ˈi m
steaming	s t ˈi m ɪ ŋ
steel	s t ˈi l
steels	s t ˈi l z
steep	s t ˈi p
steer	s t ˈɪ ɹ
stein	s t ˈa ɪ n
stem	s t ˈɛ m
stems	s t ˈɛ m z
stench	s t ˈɛ n t͡ʃ
step	s t ˈɛ p
stepped	s t ˈɛ p t
stepping	s t ɛ p ˌi ŋ
steps	s t ˈɛ p s
stern	s t ˈɚ n
steve	s t ˈi v
stew	s t ˈu
stews	s t ˈu z
stick	s t ˈɪ k
stickers	s t ˈɪ k ɚ z
sticking	s t ˈɪ k ɪ ŋ
sticks	s t ˈɪ k s
sticky	s t ˈɪ k i
stifled	s t ˈa ɪ f ə l d
still	s t ˈɪ l
stilt	s t ˈɪ l t
stilts	s t ˈɪ l t s
sting	s t ˈɪ ŋ
stings	s t ˈɪ ŋ z
stink	s t ˈɪ ŋ k
stinking	s t ˈɪ ŋ k ɪ ŋ
stinks	s t ˈɪ ŋ k s
stinky	s t ˈɪ ŋ k i
stir	s t ˈɚ
stitch	s t ˈɪ t͡ʃ
stitches	s t ˈɪ t͡ʃ ɪ z
stock	s t ˈɑ k
stocked	s t ˈɑ k t
stocks	s t ˈɑ k s
stocky	s t ˈɑ k ˈi
stole	s t ˈo ʊ l
stolen	s t ˈo ʊ l ə n
stomach	s t ˈʌ m ə k
stomp	s t ˈɑ m p
stomped	s t ˈɑ m p t
stone	s t ˈo ʊ n
stones	s t ˈo ʊ n z
stood	s t ˈʊ d
stool	s t ˈu l
stop	s t ˈɑ p
stopped	s t ˈɑ p t
stopping	s t ˈɑ p p ɪ ŋ
stops	s t ˈɑ p s
storage	s t ˈɔ ɹ ɪ d͡ʒ
store	s t ˈɔ ɹ
stores	s t ˈɔ ɹ z
stories	s t ˈɔ ɹ i z
storm	s t ˈɔ ɹ m
storms	s t ˈɔ ɹ m z
story	s t ˈɔ ɹ i
stove	s t ˈo ʊ v
stovetop	s t o ʊ v t ˈɑ p
straight	s t ɹ ˈe ɪ t
strain	s t ɹ ˈe ɪ n
strange	s t ɹ ˈe ɪ n d͡ʒ
strangely	s t ɹ ˈe ɪ n d͡ʒ l i
stranger	s t ɹ ˈe ɪ n d͡ʒ ə
strangler	s t ɹ ˈæ ŋ ɡ l ɚ
strap	s t ɹ ˈæ p
strapped	s t ɹ ˈæ p t
straps	s t ɹ ˈæ p s
straw	s t ɹ ˈɔ
strawberry	s t ɹ ˈɔ b ˌɛ ɹ ɹ i
stray	s t ɹ ˈe ɪ
strays	s t ɹ ˈe ɪ z
streak	s t ɹ ˈi k
streaks	s t ɹ ˈi k s
stream	s t ɹ ˈi m
streams	s t ɹ ˈi m z
street	s t ɹ ˈi t
streets	s t ɹ ˈi t s
strength	s t ɹ ˈɛ ŋ θ
strengths	s t ɹ ˈɛ ŋ θ s
stress	s t ɹ ˈɛ s
stressed	s t ɹ ˈɛ s t
stretch	s t ɹ ˈɛ t͡ʃ
stretched	s t ɹ ˈɛ t͡ʃ t
stretcher	s t ɹ ˈɛ t͡ʃ ɚ
stretches	s t ɹ ˈɛ t͡ʃ ɪ z
stretching	s t ɹ ˈɛ t͡ʃ ɪ ŋ
stricken	s t ɹ ˈɪ k ə n
strict	s t ɹ ˈɪ k t
strider	s t ɹ ˈa ɪ d ɚ
striders	s t ɹ ˌa ɪ d ə z
strides	s t ɹ a ɪ d z
strife	s t ɹ a ɪ f
strike	s t ɹ ˈa ɪ k
strikes	s t ɹ ˈa ɪ k s
string	s t ɹ ˈɪ ŋ
stringing	s t ɹ ˈi ŋ ˈi ŋ
strings	s t ɹ ˈɪ ŋ z
strip	s t ɹ ˈɪ p
stripe	s t ɹ ˈa ɪ p
striped	s t ɹ ˈa ɪ p d
stripes	s t ɹ ˈa ɪ p s
stripey	s t ɹ ˈa ɪ p i
strips	s t ɹ ˈɪ p s
stroke	s t ɹ ˈo ʊ k
stroll	s t ɹ ˈo ʊ l
strolled	s t ɹ ˈo ʊ l d
strong	s t ɹ ˈɔ ŋ
stronger	s t ɹ ˈɔ ŋ ɡ ɚ
stronger	s t ɹ ɔ ŋ ɡ ˈɚ
strongest	s t ɹ ˈɔ ŋ ɡ ɪ s t
struck	s t ɹ ˈʌ k
structure	s t ɹ ˈʌ k t͡ʃ ɚ
struggle	s t ɹ ˈʌ ɡ ə l
struggled	s t ɹ ˈʌ ɡ ə l d
struggles	s t ɹ ˈʌ ɡ ə l z
struggling	s t ɹ ˈʌ ɡ l ɪ ŋ
strut	s t ɹ ˈʌ t
struts	s t ɹ ˈʌ t s
stub	s t ˈʌ b
stubborn	s t ˈʌ b ɚ n
stuck	s t ˈʌ k
student	s t ˈu d ə n t
students	s t ˈu d ə n t s
studied	s t ˈʌ d i d
studies	s t ˈʌ d i z
study	s t ˈʌ d i
stuff	s t ˈʌ f
stuffed	s t ˈʌ f t
stumbled	s t ˈʌ m b ə l d
stumbles	s t ʌ m b ə l z
stump	s t ˈʌ m p
stumps	s t ˈʌ m p s
stung	s t ˈʌ ŋ
stunk	s t ˈʌ ŋ k
stunned	s t ˈʌ n d
stunning	s t ˈʌ n ɪ ŋ
stunt	s t ˈʌ n t
stupid	s t ˈu p ɪ d
sturdy	s t ə d i
sty	s t ˈa ɪ
style	s t ˈa ɪ l
styles	s t ˈa ɪ l z
su	s ˈu
subdued	s ʌ b d ˈu d
subject	s ˈʌ b d͡ʒ ɪ k t
subject	s ə b d͡ʒ ˈɛ k t
subjects	s ˈʌ b d͡ʒ ɪ k t s
subjects	s ə b d͡ʒ ˈɛ k t s
subordinate	s ə b ˈɔ ɹ d ə n ˌe ɪ t
subordinate	s ə b ˈɔ ɹ d ə n ɪ t
subordinates	s ə b ˈɔ ɹ d ə n ˌe ɪ t s
subordinates	s ə b ˈɔ ɹ d ə n ɪ t s
subscribe	s ə b s k ɹ ˈa ɪ b
subscribes	s ə b s k ɹ ˈa ɪ b z
subscription	s ə b s k ɹ ˈɪ p ʃ ə n
subscriptions	s ə b s k ɹ ˈɪ p ʃ ə n z
substance	s ˈʌ b s t ə n s
substances	s ˈʌ b s t ə n s ɪ z
substantial	s ʌ b s t ˈæ n ʃ ə l
subtle	s ˈʌ t ə l
success	s ə k s ˈɛ s
successful	s ə k s ˈɛ s f ə l
such	s ˈʌ t͡ʃ
suck	s ˈʌ k
sucked	s ˈʌ k t
sucker	s ˈʌ k ɚ
suckers	s ˈʌ k ɚ z
sucks	s ˈʌ k s
sudden	s ˈʌ d ə n
suddenly	s ˈʌ d ə n l i
suet	s ˈu t
suffer	s ˈʌ f ɚ
suffered	s ˈʌ f ɚ d
sufficient	s ə f ɪ ʃ ə n t
suffixes	s ˈʌ f ɪ k s ɪ z
sugar	ʃ ˈʊ ɡ ɚ
suggest	s ə d͡ʒ ˈɛ s t
suggested	s ə d͡ʒ ˈɛ s t ɪ d
suggests	s ə d͡ʒ ˈɛ s t s
suit	s ˈu t
suitcase	s ˈu t k ˌe ɪ s
suited	s u t ɪ d
suits	s ˈu t s
sulk	s ˈʌ l k
sulks	s ˈʌ l k s
sum	s ˈʌ m
sumatra	s ˈu m ˈɑ t͡ʃ ɹ ˈɑ
sumatran	s ˈu m ˈɑ t͡ʃ ɹ ə n
summer	s ˈʌ m ɚ
summertime	s ˈʌ m ɚ t ˌa ɪ m
sums	s ˈʌ m z
sun	s ˈʌ n
sunbathing	s ˈʌ n b ˌe ɪ ð ɪ ŋ
sunburnt	s ˈʌ n b ɚ n t
sunda	s ˈʌ n d ə
sunflowers	s ʌ n f l a ʊ ə ɹ
sunk	s ˈʌ ŋ k
sunlight	s ˈʌ n l ˈa ɪ t
sunny	s ˈʌ n i
sunrise	s ˈʌ n ɹ ˌa ɪ z
suns	s ˈʌ n z
sunscreen	s ˈʌ n s k ɹ ˌi n
sunset	s ˈʌ n s ˈɛ t
sunsets	s ˈʌ n s ˌɛ t s
super	s ˈu p ɚ
superpower	s ˌu p ɚ p ˈa ʊ ɚ
supper	s ˈʌ p ɚ
supplement	s ˈʌ p p l ə m ə n t
supplement	s ˌʌ p p l ə m ˈɛ n t
supplements	s ˈʌ p p l ə m ˈɛ n t s
supplements	s ˈʌ p p l ə m ə n t s
supplies	s ə p l ˈa ɪ z
supply	s ə p l ˈa ɪ
support	s ə p ˈɔ ɹ t
supports	s ə p ˈɔ ɹ t s
suppose	s ə p ˈo ʊ z
supposed	s ə p ˈo ʊ z d
sure	ʃ ˈʊ ɹ
surely	ʃ ˈʊ ɹ l i
sures	ʃ ˈʊ ɹ z
surface	s ˈɚ f ɪ s
surfacing	s ə ɹ f ə s ˈɪ ŋ
surprise	s ə p ɹ ˈa ɪ z
surprised	s ə p ɹ ˈa ɪ z d
surprises	s ə p ɹ ˈa ɪ z ɪ z
surprising	s ə p ɹ ˈa ɪ z ɪ ŋ
surrendered	s ɚ ˈɛ n d ɚ d
surrounded	s ɚ ɹ ˈa ʊ n d ə d
survey	s ɚ v ˈe ɪ
survival	s ɚ v a ɪ v ə l
survive	s ɚ v ˈa ɪ v
survived	s ɚ v ˈa ɪ v d
sushi	s ˈu ʃ i
susi	s ˈu s i
suspect	s ˈʌ s p ˌɛ k t
suspect	s ə s p ˈɛ k t
suspects	s ˈʌ s p ˌɛ k t s
suspects	s ə s p ˈɛ k t s
suspicious	s ə s p ˈɪ ʃ ə s
susy	s ˈu z i
swallow	s w ˈɑ l o ʊ
swallowed	s w ˈɑ l o ʊ d
swallowing	s w ˈɑ l o ʊ ɪ ŋ
swallows	s w ˈɑ l o ʊ z
swam	s w ˈæ m
swamp	s w ˈɑ m p
swamps	s w ˈɑ m p s
swampy	s w ˈɑ m p ˈi
swan	s w ˈɑ n
swans	s w ˈɑ n z
swap	s w ˈɑ p
swapped	s w ˈɑ p t
swaps	s w ˈɑ p s
swarm	s w ˈɔ ɹ m
swat	s w ˈɑ t
swatters	s w ˈɑ t t ɚ z
sway	s w ˈe ɪ
sways	s w ˈe ɪ z
swears	s w ˈɛ ɹ z
sweep	s w ˈi p
sweeps	s w ˈi p s
sweet	s w ˈi t
sweets	s w ˈi t s
swell	s w ˈɛ l
swells	s w ˈɛ l z
sweltering	s w ˈɛ l t ɚ ɹ ɪ ŋ
swept	s w ˈɛ p t
swift	s w ˈɪ f t
swiftly	s w ˈɪ f t l i
swim	s w ˈɪ m
swimmer	s w ˈɪ m ɚ
swimmers	s w ˈɪ m m ɚ z
swimming	s w ˈɪ m ɪ ŋ
swims	s w ˈɪ m z
swing	s w ˈɪ ŋ
swinging	s w ˈɪ ŋ ɪ ŋ
swings	s w ˈɪ ŋ z
swipe	s w ˈa ɪ p
swipes	s w ˈa ɪ p s
swirl	s w ˈɚ l
swirls	s w ˈɚ l z
swish	s w ˈɪ ʃ
swished	s w ˈɪ ʃ d
switch	s w ˈɪ t͡ʃ
switches	s w ˈɪ t͡ʃ ɪ z
swoop	s w ˈu p
swooped	s w ˈu p t
swooping	s w ˈu p ɪ ŋ
swoops	s w ˈu p s
sword	s ˈɔ ɹ d
swords	s ˈɔ ɹ d s
swordsman	s w ˈɔ ɹ d z m ə n
swore	s w ˈɔ ɹ
swung	s w ˈʌ ŋ
syllable	s ˈɪ l ə b ə l
syllable	s ˈɪ l ə b ə l
syllables	s ˈɪ l ə b ə l z
symbol	s ˈɪ m b ə l
symbols	s ˈɪ m b ə l z
syndicate	s ˈɪ n d ɪ k ɪ t
syndicate	s ˈɪ n d ɪ k ˌe ɪ t
syndicates	s ˈɪ n d ɪ k ˌe ɪ t s
syndicates	s ˈɪ n d ɪ k ɪ t s
system	s ˈɪ s t ə m
systems	s ˈɪ s t ə m z
t	t ˈi
t-h	t ˈi ˈe ɪ t͡ʃ
t-i	t ˈi ˈa ɪ
t-rex	t ˈi ɹ ˈɛ k s
table	t ˈe ɪ b ə l
tables	t ˈe ɪ b ə l z
tablet	t æ b l ɛ t
tack	t ˈæ k
tackle	t ˈæ k ə l
tackled	t ˈæ k ə l d
tackles	t ˈæ k ə l z
tactic	t æ k t ɪ k
tad	t ˈæ d
tads	t ˈæ d z
tag	t ˈæ ɡ
tags	t ˈæ ɡ z
tail	t ˈe ɪ l
tails	t ˈe ɪ l z
take	t ˈe ɪ k
taken	t ˈe ɪ k ə n
takes	t ˈe ɪ k s
taking	t ˈe ɪ k ɪ ŋ
takings	t ˈe ɪ k ɪ ŋ z
tal	t ˈɑ l
tal's	t ˈæ l z
talas	t a l a s
talas	t a l a s
tale	t ˈe ɪ l
talent	t ˈæ l ə n t
talents	t ˈæ l ə n t s
tales	t ˈe ɪ l z
talk	t ˈɔ k
talked	t ˈɔ k t
talking	t ˈɔ k ɪ ŋ
talks	t ˈɔ k s
tall	t ˈɔ l
taller	t ˈɔ l ɚ
tallest	t ˈɔ l ə s t
tallish	t ˈæ l ɪ ʃ
talon	t ˈæ l ə n
talons	t ˈæ l ə n z
tame	t ˈe ɪ m
tamed	t ˈe ɪ m d
tames	t ˈe ɪ m z
taming	t ˈe ɪ m i ŋ
tang	t ˈæ ŋ
tangle	t ˈæ ŋ ɡ ə l
tangled	t ˈæ ŋ ɡ ə l d
tank	t ˈæ ŋ k
tanks	t ˈæ ŋ k s
tap	t ˈæ p
tape	t ˈe ɪ p
tapioca	t ˈe ɪ p i o ʊ k ə
tapped	t ˈæ p t
tapping	t ˈæ p ɪ ŋ
taps	t ˈæ p s
tar	t ˈɑ ɹ
target	t ˈɑ ɹ ɡ ə t
targets	t ɑ ɡ ə t s
task	t ˈæ s k
tasks	t ˈæ s k s
taste	t ˈe ɪ s t
tasted	t ˈe ɪ s t ə d
tastes	t ˈe ɪ s t s
tasting	t ˈe ɪ s t ɪ ŋ
tasty	t ˈe ɪ s t i
taught	t ˈɔ t
taunt	t ˈɔ n t
taunted	t ˈɔ n t ɪ d
tax	t ˈæ k s
taxes	t ˈæ k s ɪ z
taxi	t ˈæ k s i
taxing	t ˈæ k s ɪ ŋ
tea	t ˈi
teach	t ˈi t͡ʃ
teacher	t ˈi t͡ʃ ɚ
teacher's	t ˈi t͡ʃ ɚ z
teachers	t ˈi t͡ʃ ɚ z
teaches	t ˈi t͡ʃ ɪ z
teacup	t ˈi k ˌʌ p
team	t ˈi m
team's	t ˈi m z
teams	t ˈi m z
tear	t ˈɛ ɹ
tearing	t ˈɛ ɹ ɪ ŋ
tears	t ˈɪ ɹ z
tease	t ˈi z
teases	t ˈi z ə z
technician	t ɛ k n ˈɪ ʃ ə n
technician's	t ɛ k n ˈɪ ʃ ə n z
technique	t ɛ k n ˈi k
technology	t ɛ k n ˈɑ l ə d͡ʒ i
ted	t ˈɛ d
ted's	t ˈɛ d z
teddy	t ˈɛ d i
teen	t ˈi n
teens	t ˈi n z
teeth	t ˈi θ
telematics	t ɛ l ə m ˈæ t ɪ k s
television	t ˈɛ l ə v ˌɪ ʒ ə n
tell	t ˈɛ l
telling	t ˈɛ l ɪ ŋ
tells	t ˈɛ l z
ten	t ˈɛ n
tend	t ˈɛ n d
tender	t ˈɛ n d ɚ
tends	t ɛ n d z
tension	t ˈɛ n ʃ ə n
tent	t ˈɛ n t
tenth	t ˈɛ n θ
tents	t ˈɛ n t s
term	t ˈɚ m
termite	t ˈɚ m a ɪ t
terms	t ˈɚ m z
terracotta	t ˈɛ ɹ ʌ k ɑ t ʌ
terrible	t ˈɛ ɹ ɪ b ə l
terribly	t ˈɛ ɹ ɪ b l i
terrier	t ˈɛ ɹ i ɚ
terrific	t ɚ ˈɪ f ɪ k
terrified	t ˈɛ ɹ ɪ f ˈa ɪ d
territory	t ˈɛ ɹ ɪ t ˌɔ ɹ i
terror	t ˈɛ ɹ ɚ
terrorises	t ˈɛ ɹ ɹ ɚ ˌa ɪ z ɪ z
terrorize	t ˈɛ ɹ ɚ ɹ ˌa ɪ z
terrorizes	t ˈɛ ɹ ɹ ɚ ˌa ɪ z ɪ z
test	t ˈɛ s t
tests	t ˈɛ s t s
text	t ˈɛ k s t
than	ð ə n
thank	θ ˈæ ŋ k
thanked	θ ˈæ ŋ k t
thankful	θ ˈæ ŋ k f ə l
thanks	θ ˈæ ŋ k s
thas	ð ˈæ t
that	ð ˈæ t
that's	ð ˈæ t s
thats	ð ˈæ t s
the	ð ə
their	ð ˈɛ ɹ
theirs	ð ˈɛ ɹ z
them	ð ˈɛ m
themes	θ i m z
themselves	ð ə m s ˈɛ l v z
then	ð ˈɛ n
theories	θ ˈi ɚ ɹ i z
theory	θ ˈi ɚ ɹ i
therapod	θ ˈɛ ɹ ə p ə d
there	ð ˈɛ ɹ
there's	ð ˈɛ ɹ z
theropod	θ ˈɛ ɹ ə p ə d
these	ð ˈi z
theses	θ ˈi s i z
they	ð e ɪ
they'd	ð ˈe ɪ d
they're	ð ˈɛ ɹ
theyd	ð ˈe ɪ d
theyre	ð ˈɛ ɹ
thick	θ ˈɪ k
thief	θ ˈi f
thieves	θ ˈi v z
thieving	θ ˈi v ɪ ŋ
thin	θ ˈɪ n
thing	θ ˈɪ ŋ
things	θ ˈɪ ŋ z
think	θ ˈɪ ŋ k
thinking	θ ˈɪ ŋ k ɪ ŋ
thinks	θ ˈɪ ŋ k s
thins	θ ˈɪ n z
third	θ ˈɚ d
thirsty	θ ˈɚ s t i
thirteen	θ ˈɚ t ˈi n
thirteenth	θ ˈɚ t ˈi n θ
this	ð ˈɪ s
thorn	θ ˈɔ ɹ n
thorns	θ ˈɔ ɹ n z
those	ð ˈo ʊ z
though	ð ˈo ʊ
thought	θ ˈɔ t
thoughts	θ ˈɔ t s
thousand	θ ˈa ʊ z ə n d
thousands	θ ˈa ʊ z ə n d z
thrash	θ ɹ ˈæ ʃ
thrashes	θ ɹ ˈæ ʃ ɪ z
thread	θ ɹ ˈɛ d
threat	θ ɹ ˈɛ t
threaten	θ ɹ ˈɛ t ə n
threatened	θ ɹ ˈɛ t ə n d
threats	θ ɹ ˈɛ t s
three	θ ɹ ˈi
threw	θ ɹ ˈu
thrill	θ ɹ ˈɪ l
thrilled	θ ɹ ˈɪ l d
thrilling	θ ɹ ˈɪ l ɪ ŋ
thrive	θ ɹ ˈa ɪ v
thrives	ð ɹ ˌa ɪ v z
thriving	ð ɹ ˈa ɪ v ˌi ŋ
throat	θ ɹ ˈo ʊ t
throng	θ ɹ ˈɔ ŋ
through	θ ɹ ˈu
throuhg	θ ɹ ˈu
throw	θ ɹ ˈo ʊ
throwing	θ ɹ ˈo ʊ ɪ ŋ
thrown	θ ɹ ˈo ʊ n
throws	θ ɹ ˈo ʊ z
thud	θ ˈʌ d
thumb	θ ˈʌ m
thumbs	θ ˈʌ m z
thump	θ ˈʌ m p
thumps	θ ˈʌ m p s
thunder	θ ˈʌ n d ɚ
thunk	θ ˈʌ ŋ k
tick	t ˈɪ k
ticket	t ˈɪ k ɪ t
ticking	t ˈɪ k ˈɪ ŋ
tickle	t ˈɪ k ə l
tickle	t ɪ k ə l
tickly	t ˈɪ k l i
ticks	t ˈɪ k s
tidal	t ˈa ɪ d ə l
tide	t ˈa ɪ d
tidies	t a ɪ d ˌi z
tidy	t ˈa ɪ d i
tie	t ˈa ɪ
tied	t ˈa ɪ d
tiers	t ˈɪ ɹ z
ties	t ˈa ɪ z
tiger	t ˈa ɪ ɡ ɚ
tiger's	t ˈa ɪ ɡ ɚ z
tigers	t ˈa ɪ ɡ ɚ z
tight	t ˈa ɪ t
tightly	t ˈa ɪ t l i
tights	t ˈa ɪ t s
tik	t ɪ k
til	t ˈɪ l
tiles	t ˈa ɪ l z
till	t ˈɪ l
tilt	t ˈɪ l t
tilted	t ˈɪ l t ɪ d
tim	t ˈɪ m
tim's	t ˈɪ m z
time	t ˈa ɪ m
times	t ˈa ɪ m z
timewise	t ˈa ɪ m w ˌa ɪ z
tin	t ˈɪ n
tina	t ˈi n ə
tina's	t ˈi n ə z
ting	t ˈɪ ŋ
tins	t ˈɪ n z
tiny	t ˈa ɪ n i
tip	t ˈɪ p
tip's	t ˌi p s
tipped	t ˈɪ p t
tips	t ˈɪ p s
tiptoe	t ˈɪ p t o ʊ
tire	t ˈa ɪ ɚ
tired	t ˈa ɪ ɚ d
tires	t ˈa ɪ ɚ z
title	t ˈa ɪ t ə l
tnt	t ˈi ə n t ˈi
to	t u
toad	t ˈo ʊ d
toadpocalypse	t ˈo ʊ d p ə k ə l ˈɪ p s
toads	t ˈo ʊ d z
toast	t ˈo ʊ s t
tock	t ˈɑ k
today	t ə d ˈe ɪ
toe	t ˈo ʊ
toes	t ˈo ʊ z
together	t ə ɡ ˈɛ ð ɚ
toil	t ˈɔ ɪ l
toiled	t ˈɔ ɪ l d
toilet	t ˈɔ ɪ l ɪ t
toils	t ˈɔ ɪ l z
token	t ˈo ʊ k ə n
told	t ˈo ʊ l d
tom	t ˈɑ m
tom's	t ˈɑ m z
toman	t ˈo ʊ m ə n
toman's	t o ʊ m ə n z
tomans	t o ʊ m ə n z
tomb	t ˈu m
tomorrow	t ə m ˈɑ ɹ o ʊ
toms	t ˈɑ m z
tone	t ˈo ʊ n
tones	t ˈo ʊ n z
tongue	t ˈʌ ŋ
tongues	t ˈʌ ŋ z
tonight	t ʌ n ˈa ɪ t
too	t ˈu
took	t ˈʊ k
tool	t ˈu l
tools	t ˈu l z
tooth	t ˈu θ
top	t ˈɑ p
topic	t ˈɑ p ɪ k
tops	t ˈɑ p s
torch	t ˈɔ ɹ t͡ʃ
torches	t ˈɔ ɹ t͡ʃ ɪ z
torn	t ˈɔ ɹ n
torture	t ˈɔ ɹ t͡ʃ ɚ
toss	t ˈɔ s
tossed	t ˈɔ s d
tosses	t ˈɔ s ɪ z
total	t ˈo ʊ t ə l
totally	t ˈo ʊ t ə l i
touch	t ˈʌ t͡ʃ
touched	t ˈʌ t͡ʃ t
touches	t ˈʌ t͡ʃ ɪ z
touching	t ˈʌ t͡ʃ ɪ ŋ
tough	t ˈʌ f
tougher	t ʌ f ɚ
tour	t ˈʊ ɹ
tourist	t ˈʊ ɹ ɪ s t
tourists	t ˈʊ ɹ ɹ ɪ s t s
tow	t ˈo ʊ
toward	t ə w ˈɔ ɹ d
towards	t ə w ˈɔ ɹ d z
towel	t ˈa ʊ ə l
towels	t ˈa ʊ ə l z
tower	t ˈa ʊ ɚ
town	t ˈa ʊ n
towns	t ˈa ʊ n z
townsfolk	t ˈa ʊ n z f ˌo ʊ k
township	t ˈa ʊ n ʃ ɪ p
toxic	t ˈɑ k s ɪ k
toxin	t ˈɑ k s ə n
toxins	t ˈɑ k s ə n z
toy	t ˈɔ ɪ
toys	t ˈɔ ɪ z
trace	t ɹ ˈe ɪ s
track	t ɹ ˈæ k
tracked	t ɹ ˈæ k t
tracker	t ɹ ˈæ k ɚ
trackers	t ɹ ˈæ k ɚ z
tracking	t ɹ ˈæ k ɪ ŋ
tracks	t ɹ ˈæ k s
trade	t ɹ ˈe ɪ d
traded	t ɹ ˈe ɪ d ɪ d
trader	t ɹ ˈe ɪ d ɚ
trades	t ɹ ˈe ɪ d z
trading	t ɹ ˈe ɪ d ɪ ŋ
traditionally	t ɹ ə d ˈɪ ʃ ə n ə l i
traffic	t ɹ ˈæ f ɪ k
tragic	t ɹ ˈæ d͡ʒ ɪ k
trail	t ɹ ˈe ɪ l
trailed	t ɹ ˈe ɪ l d
trailing	t ɹ e ɪ l i ŋ
train	t ɹ ˈe ɪ n
trained	t ɹ ˈe ɪ n d
training	t ɹ ˈe ɪ n ɪ ŋ
trains	t ɹ ˈe ɪ n z
traits	t ɹ ˈe ɪ t s
transaction	t ɹ ˌæ n z ˌæ k t t͡ʃ n
transfer	t ɹ ˈæ n s f ɚ
transform	t ɹ æ n s f ˈɔ ɹ m
transformed	t ɹ æ n s f ˈɔ ɹ m d
transforming	t ɹ æ n s f ˈɔ ɹ m ɪ ŋ
transit	t ɹ ˈæ n z ɪ t
transmit	t ɹ æ n z m ˈɪ t
transmits	t ɹ æ n z m ˈɪ t s
transport	t ɹ ˈæ n s p ɔ ɹ t
transported	t ɹ ˈæ n z p ˈo ʊ ɹ t ə d
trap	t ɹ ˈæ p
trapped	t ɹ ˈæ p t
traps	t ɹ ˈæ p s
trash	t ɹ ˈæ ʃ
travel	t ɹ ˈæ v ə l
traveled	t ɹ ˈæ v ə l d
travelers	t ɹ ˈæ v ə l ɚ z
traveling	t ɹ ˈæ v ə l ɪ ŋ
travelled	t ɹ ˈæ v ə l d
travellers	t ɹ ˌæ v ə l ə z
travelling	t ɹ ˈæ v ə l ɪ ŋ
travels	t ɹ ˈæ v ə l z
tray	t ɹ ˈe ɪ
tread	t ɹ ˈɛ d
treads	t ɹ ˈɛ d z
treasure	t ɹ ˈɛ ʒ ɚ
treasures	t ɹ ˈɛ ʒ ɚ z
treasury	t ɹ ˈɛ ʒ ɚ i
treat	t ɹ ˈi t
treated	t ɹ ˈi t ɪ d
treating	t ɹ ˈi t ɪ ŋ
treatment	t ɹ ˈi t m ə n t
treats	t ɹ ˈi t s
tree	t ɹ ˈi
tree's	t ɹ ˈi z
trees	t ɹ ˈi z
treetop	t ɹ ˈi t ˌɔ p
treetops	t ɹ ˈi t ˌɔ p s
trek	t ɹ ˈɛ k
trekked	t ɹ ˈɛ k t
trekking	t ɹ ˈɛ k ɪ ŋ
treks	t ɹ ˈɛ k s
tremendous	t ɹ ɪ m ˈɛ n d ə s
trench	t ɹ ˈɛ n t͡ʃ
trial	t ɹ ˈa ɪ ə l
trials	t ɹ ˈa ɪ ə l z
trick	t ɹ ˈɪ k
tricked	t ɹ ˈɪ k t
trickery	t ɹ ˈɪ k ɚ ɹ i
tricks	t ɹ ˈɪ k s
tricky	t ɹ ˈɪ k i
trident	t ɹ ˈa ɪ d ə n t
tridents	t ɹ ˈa ɪ d ə n t s
tried	t ɹ ˈa ɪ d
tries	t ɹ a ɪ z
triggered	t ɹ ˈɪ ɡ ˈɚ d
trim	t ɹ ˈɪ m
trims	t ɹ ˈɪ m z
trio	t ɹ ˈi o ʊ
trip	t ɹ ˈɪ p
tripping	t ɹ ˈɪ p ɪ ŋ
trips	t ɹ ˈɪ p s
triumph	t ɹ ˈa ɪ ə m f
troll	t ɹ ˈo ʊ l
troll's	t ɹ ˈo ʊ l z
trolls	t ɹ ˈo ʊ l z
troop	t ɹ ˈu p
trophies	t ɹ ˈo ʊ f i z
trophy	t ɹ ˈo ʊ f i
tropical	t ɹ ˈɑ p ɪ k ə l
trot	t ɹ ˈɑ t
trots	t ɹ ˈɑ t s
trotted	t ɹ ɑ t ə d
trouble	t ɹ ˈʌ b ə l
troubles	t ɹ ˈʌ b ə l z
troublesome	t ɹ ˈʌ b ə l s ə m
trough	t ɹ ˈɔ f
trowel	t ɹ ˈa ʊ ə l
truck	t ɹ ˈʌ k
trucks	t ɹ ˈʌ k s
trudge	t ɹ ˈʌ d͡ʒ
trudges	t ɹ ˈʌ d͡ʒ ɪ z
true	t ɹ ˈu
truffle	t ɹ ˈʌ f ə l
truly	t ɹ ˈu l i
trumpet	t ɹ ˈʌ m p ə t
trunk	t ɹ ˈʌ ŋ k
trunks	t ɹ ˈʌ ŋ k s
trust	t ɹ ˈʌ s t
truth	t ɹ ˈu θ
try	t ɹ ˈa ɪ
trying	t ɹ ˈa ɪ ɪ ŋ
tub	t ˈʌ b
tube	t ˈu b
tubes	t j u b z
tubs	t ˈʌ b z
tuck	t ˈʌ k
tucked	t ˈʌ k t
tucks	t ˈʌ k s
tug	t ˈʌ ɡ
tugged	t ʌ ɡ d
tugs	t ˈʌ ɡ z
tum	t ˈʌ m
tumbles	t ˈʌ m b ə l z
tumbling	t ʌ m b ə l ɪ ŋ
tummy	t ˈʌ m i
tune	t ˈu n
tunes	t j u n z
tunnel	t ˈʌ n ə l
tunnels	t ˈʌ n ə l z
tup	t ˈʌ p
turf	t ˈɚ f
turn	t ˈɚ n
turned	t ˈɚ n d
turning	t ˈɚ n ɪ ŋ
turns	t ˈɚ n z
turtle	t ˈɚ t ə l
turtles	t ˈɚ t ə l z
tusk	t ˈʌ s k
tusks	t ˈʌ s k s
tutorial	t u t ˈɔ ɹ i ə l
tv	t ˈi v ˈi
twang	t w ˈɑ ŋ
twelve	t w ˈɛ l v
twenty	t w ˈɛ n t i
twenty-one	t w ˈɛ n t i w ˈʌ n
twenty-ones	t w ˈɛ n t i w ˈʌ n z
twice	t w ˈa ɪ s
twig	t w ˈɪ ɡ
twigs	t w ˈɪ ɡ z
twine	t w ˈa ɪ n
twinkle	t w ˈɪ ŋ k ə l
twinkles	t w ˈɪ ŋ k ə l z
twirl	t w ˈɚ l
twirls	t w ˈɚ l z
twist	t w ˈɪ s t
twists	t w ˈɪ s t s
twitching	t w ˈɪ t͡ʃ ɪ ŋ
two	t ˈu
two-legged	t ˈu l ˈɛ ɡ d
type	t ˈa ɪ p
types	t ˈa ɪ p s
typhoon	t a ɪ f u n
tyre	t ˈa ɪ ɚ
tyres	t ˈa ɪ ɚ z
u	j ˈu
u-i	j ˈu ˈa ɪ
ugh	ˈʌ ɡ
ugly	ˈʌ ɡ l i
uh	ˈʌ
uhh	ˈʌ
uhl	ə l
uhs	ə z
um	ˈʌ m
umbrella	ˈʌ m b ɹ ˌɛ l ə
umbrella-shaped	ˈʌ m b ɹ ˌɛ l ə ʃ ˈe ɪ p t
un	ˈʌ n
unable	ʌ n ˈe ɪ b ə l
unaware	ˌʌ n ə w ˈɛ ɹ
unawares	ˌʌ n ə w ˈɛ ɹ z
unbreakable	ʌ n b ɹ ˈa ɪ k ʌ b l
unbreaking	ʌ n b ɹ ˌe ɪ k ɪ ŋ
uncertain	ʌ n s ˈɚ t ə n
uncharted	ʌ n t͡ʃ ˈɑ ɹ t ɪ d
uncle	ˈʌ ŋ k ə l
uncomfortable	ʌ ŋ k ˈʌ m f ɚ t t ə b ə l
under	ˈʌ n d ɚ
undercover	ˌʌ n d ɚ k ˈʌ v ɚ
underestimate	ˌʌ n d ɚ ˈɛ s t ɪ m ˌe ɪ t
underestimate	ˌʌ n d ɚ ˈɛ s t ɪ m ɪ t
underestimates	ˌʌ n d ɚ ˈɛ s t ɪ m ˌe ɪ t s
underestimates	ˌʌ n d ɚ ˈɛ s t ɪ m ɪ t s
underground	ˈʌ n d ɚ ɡ ɹ ˌa ʊ n d
undergrowth	ˈʌ n d ɚ ɡ ɹ ˌo ʊ θ
underneath	ˌʌ n d ɚ n ˈi θ
underserved	ʌ n d ɹ s e ɪ v d
underside	ˈʌ n d ɚ s ˌa ɪ d
understand	ˌʌ n d ɚ s t ˈæ n d
understanding	ˌʌ n d ɚ s t ˈæ n d ɪ ŋ
understatement	ˈʌ n d ɚ s t ˌe ɪ t m ə n t
understood	ˌʌ n d ɚ s t ˈʊ d
undertake	ˈʌ n d ɚ t ˌe ɪ k
underwater	ˈʌ n d ɚ w ˌɔ t ɚ
undone	ʌ n d ˈʌ n
unease	ʌ n ˈi z
uneasy	ʌ n ˈi z i
unexpected	ˌʌ n ɪ k s p ˈɛ k t ɪ d
unfair	ʌ n f ˈɛ ɹ
unfastened	ʌ n f ˈæ s t ə n d
unfit	ʌ n f ˈɪ t
unfold	ʌ n f ˈo ʊ l d
unfortunately	ʌ n f ˈɔ ɹ t͡ʃ ə n ɪ t l i
unguarded	ʌ ŋ ɡ ˈɑ ɹ d ɪ d
unhappy	ʌ n h ˈæ p i
unicorn	j ˈu n ɪ k ˌɔ ɹ n
unicorns	j ˈu n ɪ k ˌɔ ɹ n z
uniform	j ˈu n ə f ˌɔ ɹ m
unique	j u n ˈi k
unit	j ˈu n ɪ t
united	j u n ˈa ɪ t ɪ d
university	j ˌu n ə v ˈɚ s ə t i
unkempt	ʌ ŋ k ˈɛ m p t
unknown	ʌ n n ˈo ʊ n
unless	ʌ n l ˈɛ s
unlike	ʌ n l ˈa ɪ k
unlock	ʌ n l ˈɑ k
unlocked	ʌ n l ˈɑ k t
unlocks	ʌ n l ə k s
unluckily	ʌ n l ˈʌ k ə l i
unlucky	ʌ n l ʌ k i
unmistakable	ˌʌ n m ɪ s t ˈe ɪ k ə b ə l
unmistakably	ˌʌ n m ɪ s t ˈe ɪ k ə b l i
unrolls	ˈʌ n ɹ ˈo ʊ l z
unsafe	ʌ n s ˈe ɪ f
unspoiled	ʌ n s p ˈɔ ɪ l d
unsure	ʌ n ʃ ˈʊ ɹ
unsuspecting	ʌ n s ə s p ˈɛ k t i ŋ
until	ʌ n t ˈɪ l
untl	ʌ n t ˈɪ l
unusual	ʌ n j ˈu ʒ u ə l
unwanted	ʌ n w ˈɔ n t ɪ d
unwell	ʌ n w ˈɛ l
unwind	ʌ n w ˈa ɪ n d
unwise	ʌ n w ˈa ɪ z
up	ˈʌ p
upbeat	ˈʌ p b ˌi t
upgrade	ˈʌ p ɡ ɹ ˌe ɪ d
upon	ə p ˈɑ n
upper	ˈʌ p ɚ
uppers	ˈʌ p p ɚ z
uproar	ˈʌ p ɹ ˌɔ ɹ
uprooting	ʌ p ɹ ˈu t ɪ ŋ
upset	ʌ p s ˈɛ t
upside	ˈʌ p s ˈa ɪ d
upsides	ʌ p s ˌa ɪ d ɪ z
upstair	ʌ p s t ˈe ɪ ɹ
upstairs	ʌ p s t ˈɛ ɹ z
uranus	j ˈʊ ɹ ə n ə s
urban	ɚ ɹ b ə n
urge	ˈɚ d͡ʒ
us	ˈʌ s
use	j ˈu s
use	j ˈu z
used	j ˈu z d
used	j ˈu s t
useful	j ˈu s f ə l
useless	j ˈu s l ə s
uses	j ˈu z ɪ z
uses	j ˈu z ɪ z
using	j ˈu z ɪ ŋ
usual	j ˈu ʒ u ə l
usually	j ˈu ʒ u ə l i
uv	j ˈu v ˈi
v	v ˈi
vacant	v ˈe ɪ k ə n t
vacation	v e ɪ k ˈe ɪ ʃ ə n
vaguely	v ˈe ɪ ɡ l i
vain	v ˈe ɪ n
valid	v ˈæ l ə d
valley	v ˈæ l i
valleys	v ˈæ l i z
valuable	v ˈæ l j u b ə l
value	v ˈæ l j u
vampire	v ˈæ m p a ɪ ɚ
van	v ˈæ n
vanilla	v ə n ˈɪ l ə
vanished	ˈv æ n ɪ ʃ t
vanity	v ˈæ n ɪ t i
variety	v ɚ ɹ ˈa ɪ j ə t i
vary	v ˈɛ ɹ i
vase	v ʌ z
vast	v ˈæ s t
veer	v ˈɪ ɹ
vege-table	v e ɪ d͡ʒ ə t ˈe ɪ b ə l
vegetable	v ˈɛ d͡ʒ t ə b ə l
vegetables	v ˈɛ d͡ʒ t ə b ə l z
vehicle	v ˈi ɪ k ə l
veil	v ˈe ɪ l
vein	v ˈe ɪ n
veins	v ˈe ɪ n z
velociraptor	v ə l ˈɔ s s ə ɹ ˌæ p t ɚ
velvet	v ˈɛ l v ɪ t
venom	v ˈɛ n ə m
venomous	v ɛ n ə m ə s
venus	v ˈi n ə s
ver	v ˈɛ ɹ i
verdant	v ˈɚ d ə n t
verification	v ˌɛ ɹ ə f ɪ k ˈe ɪ ʃ ə n
verifications	v ˈɛ ɹ ɪ f ɪ k ˈe ɪ ʃ ə n z
vermin	v ˈɚ m ɪ n
version	v ˈɚ ʒ ə n
very	v ˈɛ ɹ ɹ i
vest	v ˈɛ s t
vestigial	v ɛ s t ˈɪ d͡ʒ i ə l
vet	v ˈɛ t
vex	v ˈɛ k s
vibrant	v ˈa ɪ b ɹ ə n t
vic	v ˈɪ k
vicious	v ˈɪ ʃ ə s
viciously	v ˈɪ ʃ ə s l i
victoria	v ɪ k t ˈɔ ɹ ɪ ɑ
video	v ˈɪ d i o ʊ
videos	v ˈɪ d i o ʊ z
view	v j ˈu
views	v j ˈu z
vigorous	v ˈɪ ɡ ɚ ɹ ə s
village	v ˈɪ l ɪ d͡ʒ
villager	v ˈɪ l ɪ d͡ʒ ɚ
villager's	v ˈɪ l ɪ d͡ʒ ɚ z
villagers	v ˈɪ l ɪ d͡ʒ ɚ z
villages	v ˈɪ l ɪ d͡ʒ ɪ z
vin	v ˈɪ n
vine	v ˈa ɪ n
vines	v ˈa ɪ n z
virus	v ˈa ɪ ɹ ə s
viruses	v ˈa ɪ ɹ ə s ɪ z
visibility	v ˌɪ z ɪ b ˈɪ l ɪ t i
vision	v ˈɪ ʒ ə n
visit	v ˈɪ z ɪ t
visiting	v ˈɪ z ɪ t ɪ ŋ
visitor	v ˈɪ z ɪ t ɚ
visitors	v ˈɪ z ˈɪ t ɚ z
visits	v ˈɪ z ɪ t s
vitamin	v ˈa ɪ t ə m ə n
vocal	v ˈo ʊ k l
voice	v ˈɔ ɪ s
voices	v ˈɔ ɪ s ɪ z
void	v ˈɔ ɪ d
volcanic	v ɑ l k ˈæ n ɪ k
volleyball	v ˈɑ l i b ˌɔ l
volume	v ˈɑ l j u m
vomit	v ˈɑ m ə t
vouches	v ˈa ʊ t͡ʃ ɪ z
vow	v ˈa ʊ
vowed	v ˈa ʊ d
vowel	v ˈa ʊ ə l
vowels	v ˈa ʊ ə l z
vows	v ˈa ʊ z
voyage	v ˈɔ ɪ ɪ d͡ʒ
vulnerable	v ˈʌ l n ɚ ə b ə l
vulture	v ˈʌ l t͡ʃ ɚ
vultures	v ˈʌ l t͡ʃ ɚ z
w	d ˈʌ b ə l j ˌu
w-h	d ˈʌ b ə l j ˌu ˈe ɪ t͡ʃ
w-r	d ˈʌ b ə l j ˌu ˈɑ ɹ
wa	w ə z
wade	w ˈe ɪ d
waft	w ˈɑ f t
wafts	w ˈɔ f t s
wag	w ˈæ ɡ
wagged	w ˈæ ɡ d
waggles	w ˈæ ɡ ə l z
wags	w ˈæ ɡ z
wail	w ˈe ɪ l
wailing	w ˈe ɪ l ɪ ŋ
wails	w ˈe ɪ l z
waist	w ˈe ɪ s t
wait	w ˈe ɪ t
waited	w ˈe ɪ t ɪ d
waiting	w ˈe ɪ t ɪ ŋ
waits	w ˈe ɪ t s
wake	w ˈe ɪ k
wakes	w e ɪ k s
waking	w ˈe ɪ k ɪ ŋ
walk	w ˈɔ k
walked	w ˈɔ k t
walking	w ˈɔ k ɪ ŋ
walks	w ˈɔ k s
wall	w ˈɔ l
walls	w ˈɔ l z
wand	w ˈɑ n d
wander	w ˈɔ n d ɚ
wandered	w ˈɑ n d ˈɚ d
wanderers	w ˈɔ n d ɚ ɚ z
wandering	w ˈɔ n d d ɚ ɪ ŋ
wanders	w ˈɔ n d ɚ z
wands	w ˈɑ n d z
want	w ˈɔ n t
wanted	w ˈɔ n t ɪ d
wanting	w ˈɑ n t ɪ ŋ
wants	w ˈɔ n t s
war	w ˈɔ ɹ
ware	w ˈɛ ɹ
wares	w ˈɛ ɹ z
warm	w ˈɔ ɹ m
warmed	w ˈɔ ɹ m d
warmer	w ˈɔ ɹ m ɚ
warming	w ˈɔ ɹ m ɪ ŋ
warms	w ˈɔ ɹ m z
warmth	w ˈɔ ɹ m θ
warn	w ˈɔ ɹ n
warned	w ˈɔ ɹ n d
warns	w ˈɔ ɹ n z
warped	w ˈɔ ɹ p t
warrant	w ˈɔ ɹ ə n t
warrants	w ɔ ɹ ə n t s
warrior	w ˈɔ ɹ i ɚ
wars	w ˈɔ ɹ z
wart	w ˈɔ ɹ t
was	w ə z
wash	w ˈɔ ʃ
washed	w ˈɔ ʃ t
washes	w ˈɔ ʃ ɪ z
washing	w ɑ ʃ ˌi ŋ
wasing	w ɑ ʃ ˌi ŋ
wasn't	w ˈʌ z ə n t
wasnt	w ˈʌ z ə n t
wasp	w ˈɑ s p
wasps	w ˈɑ s p s
waste	w ˈe ɪ s t
wasted	w e ɪ s t ə d
wastewater	w ˈe ɪ s t w ˌɔ t ɚ
watch	w ˈɔ t͡ʃ
watched	w ˈɔ t͡ʃ t
watches	w ˈɔ t͡ʃ ɪ z
watching	w ˈɔ t͡ʃ ɪ ŋ
water	w ˈɔ t ɚ
watercolors	w ˈɔ t ɚ k ˌʌ l ɚ z
watercolours	w ˈe ɪ t ɚ k ə l ɚ z
waterfall	w ˈɔ t ɚ f ˌɔ l
watering	w ɔ t ə i ŋ
watermelon	w ˈɔ t ɚ m ˌɛ l ə n
waters	w ˈɔ t ɚ z
watned	w ˈɔ n t ɪ d
wave	w ˈe ɪ v
waved	w ˈe ɪ v d
waves	w ˈe ɪ v z
waving	w ˈe ɪ v ɪ ŋ
way	w ˈe ɪ
ways	w ˈe ɪ z
we	w ˈi
we'll	w ˈi l
we're	w ˈɪ ɹ
we've	w ˈi v
weak	w ˈi k
weaker	w ˈi k ɚ
weapon	w ˈɛ p ə n
weapons	w ˈɛ p ə n z
weaponsmith	w ˈɛ p ə n s m ˌɪ ð
wear	w ˈɛ ɹ
wearing	w ˈɛ ɹ ɪ ŋ
wears	w ˈɛ ɹ z
weasel	w ˈi z ə l
weather	w ˈɛ ð ɚ
weathered	w ˈɛ ð ɚ d
weave	w ˈi v
weaver	w ˈi v ɚ
weaves	w ˈi v z
weaving	w ˈi v ɪ ŋ
web	w ˈɛ b
webbed	w ˈɛ b d
webs	w ˈɛ b z
website	w ˈɛ b s ˌa ɪ t
websites	w ˈɛ b s ˌa ɪ t s
wedge	w ˈɛ d͡ʒ
wee	w ˈi
weed	w ˈi d
weeds	w ˈi d z
week	w ˈi k
week's	w ˈi k s
weekend	w ˈi k ˌɛ n d
weekends	w ˈi k ˌɛ n d z
weeks	w ˈi k s
weevil	w ˈi v ə l
weigh	w ˈe ɪ
weighed	w ˈe ɪ d
weighs	w ˈe ɪ z
weight	w ˈe ɪ t
weird	w ˈɪ ɹ d
welcome	w ˈɛ l k ə m
well	w ˈɛ l
well-known	w ˈɛ l n ˈo ʊ n
well-liked	w ˈɛ l l ˈa ɪ k t
well-read	w ˈɛ l ɹ ˈi d
welsh	w ˈɛ l ʃ
went	w ˈɛ n t
wept	w ˈɛ p t
were	w ɚ
weren't	w ˈɚ n t
werent	w ɚ ə n t
wet	w ˈɛ t
weve	w i v
whack	w ˈæ k
whale	w ˈe ɪ l
whales	w ˈe ɪ l z
what	w ˈʌ t
what's	w ˈʌ t s
whatever	w ˌʌ t ˈɛ v ɚ
wheat	w ˈi t
wheel	w ˈi l
wheeled	w ˈi l d
wheels	w ˈi l z
when	w ˈɛ n
whenever	w ɛ n ˈɛ v ɚ
where	w ˈɛ ɹ
where's	w ˈɛ ɹ z
whether	w ˈɛ ð ɚ
which	w ˈɪ t͡ʃ
whiff	w ˈɪ f
while	w ˈa ɪ l
whiles	w ˈa ɪ l z
whim	w ˈɪ m
whine	w ˈa ɪ n
whip	w ˈɪ p
whipping	w ˈɪ p ɪ ŋ
whips	w ˈɪ p s
whir	w ˈɪ ɹ
whirring	w ˈɚ ɹ ɪ ŋ
whirs	w ˈɚ z
whisk	w ˈɪ s k
whisker	w ˈɪ s k ɚ
whiskers	w ˈɪ s k ɚ z
whisking	w ˈɪ s k ɪ ŋ
whisper	w ˈɪ s p ɚ
whispered	w ˈɪ s p ɚ d
whispering	w ˈɪ s p ɚ ɹ ɪ ŋ
whispers	w ˈɪ s p ɚ z
whistled	w ˈɪ s ə l d
white	w ˈa ɪ t
whiteboard	w ˈa ɪ t b ˌɔ ɹ d
whites	w ˈa ɪ t s
whizz	w ˈɪ z
whizzes	w ˈɪ z ɪ z
who	h ˈu
who's	h ˈu z
whoa	w ˈo ʊ
whole	h ˈo ʊ l
whom	h ˈu m
whooping	w ˈu p ɪ ŋ
whoosh	w ˈu ʃ
whos	h ˈu z
whose	h ˈu z
whump	w ˈʌ m p
why	w ˈa ɪ
why's	w ˈa ɪ z
wickedness	w ˈɪ k ɪ d n ə s
wide	w ˈa ɪ d
wide-eyed	w ˈa ɪ d ˈa ɪ d
widen	w ˈa ɪ d ə n
wider	w ˈa ɪ d ʌ
width	w ˈɪ t θ
wield	w ˈi l d
wields	w ˈi l d z
wife	w ˈa ɪ f
wiggle	w ˈɪ ɡ ə l
wight	w ˈa ɪ t
wights	w ˈa ɪ t s
wild	w ˈa ɪ l d
wildflower	w a ɪ l d f l a ʊ ə ɹ
wildflowers	w a ɪ l d f l a ʊ ə ɹ z
wildlife	w ˈa ɪ l d l ˌa ɪ f
will	w ˈɪ l
willing	w ˈɪ l ɪ ŋ
wilt	w ˈɪ l t
wilts	w ˈɪ l t s
win	w ˈɪ n
winced	w ˈɪ n s t
wind	w ˈɪ n d
winding	w ˈa ɪ n d ɪ ŋ
windmill	w ˈɪ n d m ˌɪ l
window	w ˈɪ n d o ʊ
windows	w ˈɪ n d o ʊ z
winds	w ˈɪ n d z
wing	w ˈɪ ŋ
winged	w ˈɪ ŋ d
wings	w ˈɪ ŋ z
wingspan	w ˈɪ ŋ s p ˌæ n
wink	w ˈɪ ŋ k
winks	w ˈɪ ŋ k s
winner	w ˈɪ n ɚ
winnie	w ˈɪ n n i
winning	w ˈɪ n ɪ ŋ
wins	w ˈɪ n z
winter	w ˈɪ n t ɚ
wipe	w ˈa ɪ p
wiped	w ˈa ɪ p t
wiping	w ˈa ɪ p ˈɪ ŋ
wire	w ˈa ɪ ɚ
wires	w ˈa ɪ ɚ z
wisdom	w ˈɪ z d ə m
wish	w ˈɪ ʃ
wished	w ˈɪ ʃ t
wishes	w ɪ ʃ ə z
wishing	w ˈɪ ʃ ɪ ŋ
wisp	w ˈɪ s p
wisps	w ˈɪ s p s
wit	w ˈɪ t
witch	w ˈɪ t͡ʃ
with	w ˈɪ θ
within	w ɪ ð ˈɪ n
without	w ɪ ð ˈa ʊ t
withstand	w ɪ θ s t ˈæ n d
witnessed	w ˈɪ t n ɪ s t
wits	w ˈɪ t s
wiwit	w ˈi w ɪ t
wiwit's	w ˈi w ɪ t s
wizard	w ˈɪ z ɚ d
wizards	w ˈɪ z ɚ d z
wld	w ˈa ɪ l d
wobble	w ˈɑ b ə l
woe	w ˈo ʊ
woes	w o ʊ z
woke	w ˈo ʊ k
woken	w ˈo ʊ k ə n
wolf	w ˈʊ l f
wolves	w ˈʊ l v z
woman	w ˈʊ m ə n
woman's	w ˈʊ m ə n z
women	w ˈɪ m ə n
won	w ˈʌ n
won't	w ˈo ʊ n t
wonder	w ˈʌ n d ɚ
wondered	w ˈʌ n d ɚ d
wonderful	w ˈʌ n d ɚ f ə l
wondering	w ˈʌ n d ɚ ɹ ɪ ŋ
wonders	w ˈʌ n d ɚ z
wondrous	w ˈʌ n d ɹ ə s
wont	w ˈɔ n t
wood	w ˈʊ d
wooden	w ˈʊ d ə n
woods	w ˈʊ d z
wool	w ˈʊ l
woollen	w ʊ l ə n
woozle	w ˈʊ z ə l
word	w ˈɚ d
words	w ˈɚ d z
wore	w ˈɔ ɹ
work	w ˈɚ k
worked	w ˈɚ k t
worker	w ˈɚ k ɚ
workers	w ˈɚ k ɚ z
working	w ˈɚ k ɪ ŋ
workmates	w ˈɚ k m ˌe ɪ t z
works	w ˈɚ k s
workshop	w ˈɚ k ʃ ˌɑ p
world	w ˈɚ l d
world's	w ɚ ɹ l d z
worlds	w ˈɚ l d z
worm	w ˈɚ m
worms	w ˈɚ m z
worn	w ˈɔ ɹ n
worried	w ˈɚ ɹ i d
worries	w ˈɚ i z
worry	w ˈɚ ɹ i
worrying	w ˈɚ i ɪ ŋ
worse	w ˈɚ s
worst	w ˈɚ s t
worth	w ˈɚ θ
would	w ˈʊ d
wouldn't	w ˈʊ d ə n t
wouldnt	w ˈʊ d ə n t
wound	w ˈu n d
wounds	w ˈu n d z
woven	w ˈo ʊ v ə n
wow	w ˈa ʊ
wraith	ɹ ˈe ɪ θ
wrangle	ɹ ˈæ ŋ ɡ ə l
wrap	ɹ ˈæ p
wrapped	ɹ ˈæ p t
wrapper	ɹ ˈæ p ɚ
wrappers	ɹ ˈæ p ɚ z
wraps	ɹ ˈæ p s
wrath	ɹ ˈæ θ
wreak	ɹ ˈi k
wreck	ɹ ˈɛ k
wrecked	ɹ ˈɛ k d
wrecking	ɹ ˈɛ k ɪ ŋ
wrecks	ɹ ˈɛ k s
wren	ɹ ˈɛ n
wrench	ɹ ˈɛ n t͡ʃ
wrestle	ɹ ˈɛ s ə l
wrestles	ɹ ˈɛ s ə l z
wrestling	ɹ ˈɛ s l ɪ ŋ
wretched	ɹ ˈɛ t͡ʃ ɪ d
wretches	ɹ ɛ t͡ʃ ə z
wriggled	ɹ ˈɪ ɡ ə l d
wriggling	ɹ ɪ ɡ l i ŋ
wringing	ɹ ˈɪ ŋ ɪ ŋ
wrinkled	ɹ ˈɪ ŋ k ə l d
wrinkles	ɹ ˈɪ ŋ k ə l z
wrist	ɹ ˈɪ s t
wrists	ɹ ˈɪ s t s
write	ɹ ˈa ɪ t
writes	ɹ ˈa ɪ t s
writhing	ɹ ˈa ɪ ð ɪ ŋ
writing	ɹ ˈa ɪ t ɪ ŋ
written	ɹ ˈɪ t ə n
wrong	ɹ ˈɔ ŋ
wrote	ɹ ˈo ʊ t
wrought	ɹ ˈɔ t
wry	ɹ ˈa ɪ
wuh	w ˈʊ
x	ˈɛ k s
x-i	ˈɛ k s ˈa ɪ
y	w ˈa ɪ
yak	j ˈæ k
yanks	j ˈæ ŋ k s
yap	j ˈæ p
yard	j ˈɑ ɹ d
yards	j ˈɑ ɹ d z
yarn	j ˈɑ ɹ n
yawned	j ˈɔ n d
yay	j ˈe ɪ
ye	j ˈi
yea	j ˈe ɪ
yeah	j ˈæ
year	j ˈɪ ɹ
year's	j ˈi ɹ z
years	j ˈɪ ɹ z
yeast	j ˈi s t
yell	j ˈɛ l
yelled	j ˈɛ l d
yelling	j ˈɛ l ɪ ŋ
yellow	j ˈɛ l o ʊ
yellow-brown	j ˈɛ l o ʊ b ɹ ˈa ʊ n
yellows	j ˈɛ l o ʊ z
yells	j ˈɛ l z
yes	j ˈɛ s
yesterday	j ˈɛ s t ɚ d ˌe ɪ
yet	j ˈɛ t
yikes	j ˈa ɪ k s
yip	j ˈɪ p
yips	j ˈɪ p s
yo	j ˈo ʊ
yo-yo	j ˈo ʊ j ˈo ʊ
yoga	j ˈo ʊ ɡ ə
yolk	j ˈo ʊ k
you	j ˈu
you'd	j ˈu d
you'll	j ˈu l
you're	j ˈʊ ɹ
you've	j ˈu v
youd	j ˈu d
young	j ˈʌ ŋ
younger	j ˈʌ ŋ ɡ ɚ
youngest	j ˈʌ ŋ ɡ ɪ s t
your	j ˈʊ ɹ
youre	j ɔ ɹ
yours	j ˈʊ ɹ z
yourself	j ʊ ɹ s ˈɛ l f
yourselves	j ʊ ɹ s ˈɛ l v z
youth	j ˈu θ
yowie	j ˈo ʊ i
yowies	j ˈo ʊ i z
yowl	j ˈa ʊ l
yuck	j ˈʌ k
yum	j ˈʌ m
yummy	j ˈʌ m i
yup	j ˈʌ p
zag	z ˈæ ɡ
zags	z ˈæ ɡ z
zap	z ˈæ p
zara	z ˈɛ ɹ ə
zara's	z ˈɑ ɹ ə z
zebra	z ˈi b ɹ ə
zero	z ˈɪ ɹ ɹ o ʊ
zest	z ˈɛ s t
zh	ʒ ə
zig	z ˈɪ ɡ
zigs	z ˈɪ ɡ z
zing	z ˈɪ ŋ
zip	z ˈɪ p
zipping	z ˈɪ p ɪ ŋ
zips	z ˈɪ p s
zom	z ə m
zom's	z ˈɑ m z
zombie	z ˈɑ m b i
zombies	z ˈɑ m b i z
zoms	z ɑ m z
zoo	z ˈu
zoom	z ˈu m
zoomed	z ˈu m d
zoomed-in	z ˈu m d ˈɪ n
zooming	z u m ɪ ŋ
zooms	z ˈu m z
zoos	z ˈu z
zuri	z ʊ ɹ ˈi
zzz	z ˈʌ
