syrup	s ɪ ɹ ə p
ballot	b æ l ə t
paddle	p æ d ə l
chicken	tʃ ɪ k ə n
apple	æ p ə l
paris	p æ ɹ ə s
gallop	ɡ æ l ə p
parrot	p æ ɹ ə t
tackle	t æ k ə l
wagon	w æ ɡ ə n
barrack	b æ ɹ ə k
battle	b æ t ə l
dabble	d æ b ə l
bullock	b ʊ l ə k
tassel	t æ s ə l
haggle	h æ ɡ ə l
parish	p æ ɹ ɪ ʃ
happen	h æ p ə n
button	b ɐ t ə n
sudden	s ɐ d ə n
cabin	k æ b ə n
